pnt_id,simplexK,residue,residue_pos,coefsum,coefsum_pos,coef_sparsity,coef_sparsity_pos,maxdist,mindist,n_active,n_active_pos
1024,1,9.466743449226275,9.466743449226279,0.957011677153785,0.9570116771537861,0,0,9.553893089294434,9.553893089294434,1,1
1024,2,8.432545149594267,8.43254514959427,0.9739555185203006,0.9739555185203017,0,0,9.755915641784668,9.553893089294434,2,2
1024,3,7.937407463163502,7.937407463163502,0.9819112619811601,0.9819112619811607,0,0,9.771537780761719,9.553893089294434,3,3
1024,4,7.189423139372756,7.189423139372756,0.9954776587244097,0.995477658724411,0,0,9.774605751037598,9.553893089294434,4,4
1024,8,6.715302549163374,6.787980888082621,1.0052220225431374,1.0032001609129675,2,2,10.2297945022583,9.553893089294434,6,6
1024,16,6.150661268215119,6.225220053187226,1.0208035932151933,1.0187343173397527,5,7,10.660027503967285,9.553893089294434,11,9
1024,32,5.339742216951124,6.055968374109966,1.0249018784831831,1.0214019764126905,13,20,11.11590576171875,9.553893089294434,19,12
1024,64,4.102689849932696,5.880146108503642,1.0147611844026807,1.0256225782038357,30,49,11.73902416229248,9.553893089294434,34,15
1024,128,2.2148045531161493,5.683307060056055,1.0063115639519373,1.032820371205711,66,113,12.414542198181152,9.553893089294434,62,15
1025,1,2.437598684160604,2.437598684160604,0.9935708056472259,0.993570805647226,0,0,2.4457523822784424,2.4457523822784424,1,1
1025,2,2.2581683458328015,2.258168345832801,0.9958128383060467,0.9958128383060465,0,0,2.6435070037841797,2.4457523822784424,2,2
1025,3,2.182507154001035,2.182507154001035,0.9961998945806909,0.9961998945806909,0,0,2.7010045051574707,2.4457523822784424,3,3
1025,4,1.823804381218469,1.8238043812184683,0.998854391552366,0.9988543915523649,0,0,2.765069007873535,2.4457523822784424,4,4
1025,8,1.457155649720046,1.5958464900760605,1.0012104307326937,1.0011990852167854,1,1,3.051022529602051,2.4457523822784424,7,7
1025,16,1.2049999269672143,1.4301580313389273,1.002022530691356,1.0018004757553383,4,6,3.299879789352417,2.4457523822784424,12,10
1025,32,0.7228058912277422,1.4177222332507249,1.0012489453291227,1.0021345335693925,13,18,3.602731704711914,2.4457523822784424,19,14
1025,64,0.4381867156082054,1.2814674975242166,1.0002377588537068,1.003586783240312,30,53,3.9756433963775635,2.4457523822784424,34,11
1025,128,0.08354738507483649,1.1983897531725314,0.9999337641109349,1.0045191569325804,70,113,4.435132026672363,2.4457523822784424,58,15
1026,1,9.77694941395869,9.776949413958699,0.9485747757402955,0.9485747757402985,0,0,9.894527435302734,9.894527435302734,1,1
1026,2,8.10061236344807,8.100612363448068,0.9793434033180564,0.9793434033180557,0,0,9.975708961486816,9.894527435302734,2,2
1026,3,7.435958913056898,7.435958913056899,0.9888943828695742,0.9888943828695754,0,0,10.077322006225586,9.894527435302734,3,3
1026,4,7.177736381709177,7.177736381709177,0.9949595597050853,0.9949595597050864,0,0,10.223383903503418,9.894527435302734,4,4
1026,8,6.434104644255821,6.43410464425582,1.0133524717768154,1.0133524717768168,0,0,10.683257102966309,9.894527435302734,8,8
1026,16,5.980331800464857,5.990130759131262,1.0207877128472365,1.021041102443665,4,4,11.262869834899902,9.894527435302734,12,12
1026,32,5.363801655554144,5.734682272738763,1.028521738176794,1.0295116728422775,9,18,11.7273588180542,9.894527435302734,23,14
1026,64,3.9858183061106,5.522636896169473,1.0221790689570063,1.035609626682486,30,44,12.260655403137207,9.894527435302734,34,20
1026,128,2.0924857435671766,5.50405915998481,1.0059653336101786,1.0365348757968307,59,108,12.836433410644531,9.894527435302734,69,20
1027,1,2.735588105721976,2.7355881057219764,0.9980656532430786,0.9980656532430783,0,0,2.736248016357422,2.736248016357422,1,1
1027,2,2.5651460036296787,2.5651460036296783,0.997955476681981,0.9979554766819803,0,0,3.1990315914154053,2.736248016357422,2,2
1027,3,2.4718241063703754,2.4718241063703754,0.9989439471751067,0.9989439471751057,0,0,3.241814613342285,2.736248016357422,3,3
1027,4,2.3865446497157645,2.386544649715766,0.9992500942631863,0.9992500942631852,0,0,3.3034591674804688,2.736248016357422,4,4
1027,8,2.3236736258187665,2.324025741527057,1.0003734562078401,1.0003331116525824,1,1,3.672329902648926,2.736248016357422,7,7
1027,16,1.7800562731961722,2.2125857344203275,1.0011504532933273,1.002804118416509,5,8,4.342673301696777,2.736248016357422,11,8
1027,32,1.1651480573815653,2.101509575318945,1.001554994020759,1.0044919581600023,14,22,4.7620439529418945,2.736248016357422,18,10
1027,64,0.6440192072400089,1.9792753525432265,1.0010218656594008,1.0066398726548227,29,50,5.125868797302246,2.736248016357422,35,14
1027,128,0.07708337821488216,1.9663206630921128,0.9999864223696253,1.006733077925522,71,111,5.660552501678467,2.736248016357422,57,17
1028,1,11.376225193471255,11.376225193471262,0.9099983101925009,0.9099983101925035,0,0,11.686704635620117,11.686704635620117,1,1
1028,2,9.631402476743233,9.63140247674319,0.963303228316014,0.9633032283160157,0,0,11.763758659362793,11.686704635620117,2,2
1028,3,8.725079738674733,8.725079738674731,0.988900880097699,0.9889008800976993,0,0,12.394674301147461,11.686704635620117,3,3
1028,4,8.54029071042016,8.540290710420162,0.9957313445463698,0.995731344546371,0,0,12.620631217956543,11.686704635620117,4,4
1028,8,8.213388145847336,8.213388145847334,1.0044822327309346,1.0044822327309375,0,0,12.951879501342773,11.686704635620117,8,8
1028,16,7.641246513732656,7.817916267424739,1.0223334168677458,1.019604240065773,5,6,13.402693748474121,11.686704635620117,11,10
1028,32,7.192021972193629,7.738203799021271,1.0227753659437664,1.0227232398837018,14,20,14.317426681518555,11.686704635620117,18,12
1028,64,5.970616145156949,7.6238302056797504,1.005167956367786,1.0310076156197179,29,50,14.970712661743164,11.686704635620117,35,14
1028,128,3.7050672743395245,7.371789804030534,0.9996314729339604,1.041317618009586,63,112,15.827038764953613,11.686704635620117,65,16
1029,1,7.918145742428828,7.918145742428829,0.9731107085782091,0.9731107085782099,0,0,7.958424091339111,7.958424091339111,1,1
1029,2,6.119898203086582,6.119898203086582,1.000853837484652,1.0008538374846525,0,0,8.03646469116211,7.958424091339111,2,2
1029,3,5.841668045835527,5.841668045835527,1.0079059451063184,1.0079059451063181,0,0,9.39730453491211,7.958424091339111,3,3
1029,4,5.831662608993469,5.8316626089934696,1.0083174546391631,1.0083174546391624,0,0,9.428901672363281,7.958424091339111,4,4
1029,8,5.0494219503715,5.155985949259032,1.0223406342459906,1.0208830227692611,2,2,9.709453582763672,7.958424091339111,6,6
1029,16,4.514865429115633,5.0538533476742415,1.0248096275566894,1.0241616896434285,5,5,10.177366256713867,7.958424091339111,11,11
1029,32,4.155277202507685,4.896033471317787,1.0269947722810402,1.0285741380172198,10,17,10.685582160949707,7.958424091339111,22,15
1029,64,3.2835249567771334,4.83578593260903,1.0133505661887243,1.0314856809633626,27,48,11.297776222229004,7.958424091339111,37,16
1029,128,1.8733317506773435,4.798045698421889,1.0057404764593616,1.0320188090100946,62,110,11.98119068145752,7.958424091339111,66,18
1030,1,2.9682767781009742,2.9682767781009756,0.9946197831900289,0.9946197831900301,0,0,2.9729795455932617,2.9729795455932617,1,1
1030,2,2.601925509501062,2.6019255095010623,0.9978411653258348,0.9978411653258352,0,0,3.115018129348755,2.9729795455932617,2,2
1030,3,2.1691426589239082,2.1691426589239082,1.001294701310655,1.0012947013106548,0,0,3.1261825561523438,2.9729795455932617,3,3
1030,4,2.1489098614840634,2.148909861484064,1.0011087380658377,1.0011087380658383,0,0,3.1419777870178223,2.9729795455932617,4,4
1030,8,1.8978389152865867,1.8981771188455145,1.0031406364137831,1.0031095349077297,1,1,3.414264678955078,2.9729795455932617,7,7
1030,16,1.6820565108017735,1.8247906954146507,1.0027906299997933,1.0034994436101874,5,5,3.633283853530884,2.9729795455932617,11,11
1030,32,1.111856740398984,1.5860888867895946,1.0027917324938085,1.0044053047576254,16,20,3.882192611694336,2.9729795455932617,16,12
1030,64,0.35715670956592926,1.4727508282309392,0.9999091428954985,1.005234475065606,30,52,4.251195430755615,2.9729795455932617,34,12
1030,128,0.026621117833294926,1.458563128193495,1.0000052676015376,1.0057873957590306,62,110,4.793363571166992,2.9729795455932617,66,18
1031,1,9.265024445426379,9.26502444542638,0.9574466060245646,0.9574466060245663,0,0,9.35405158996582,9.35405158996582,1,1
1031,2,7.0369989535498725,7.0369989535498725,1.0026060636196386,1.0026060636196392,0,0,9.771865844726562,9.35405158996582,2,2
1031,3,6.753495379949696,6.7534953799496975,1.0080861527532976,1.0080861527532976,0,0,10.118133544921875,9.35405158996582,3,3
1031,4,6.061266584329268,6.0612665843292675,1.018882194468786,1.0188821944687871,0,0,10.121973037719727,9.35405158996582,4,4
1031,8,6.0181218669607714,6.020337944808304,1.0217165946330968,1.0217079198236243,1,1,10.863340377807617,9.35405158996582,7,7
1031,16,5.121112582186173,5.207533741107641,1.0370641542206653,1.0372511720719804,4,7,11.61496639251709,9.35405158996582,12,9
1031,32,4.879810525359906,5.20501667869765,1.0318418413468162,1.0378192970869224,14,21,12.506593704223633,9.35405158996582,18,11
1031,64,3.717302323126227,5.1668808633528664,1.0163248221064263,1.041491690919101,27,49,13.529855728149414,9.35405158996582,37,15
1031,128,2.020771569774718,5.15603503211,1.00056027702033,1.0437466034706515,60,111,14.530807495117188,9.35405158996582,68,17
1032,1,11.812985604537909,11.81298560453792,0.9202389730891053,0.9202389730891078,0,0,12.052213668823242,12.052213668823242,1,1
1032,2,10.367863216199844,10.367863216199845,0.968606357558452,0.968606357558454,0,0,13.095330238342285,12.052213668823242,2,2
1032,3,10.233315653360457,10.233315653360458,0.9727727163644985,0.9727727163645,0,0,13.289895057678223,12.052213668823242,3,3
1032,4,9.807764329884245,9.814979284802588,0.982544843109096,0.9825634103031557,1,1,13.304316520690918,12.052213668823242,3,3
1032,8,8.731188612917235,9.045167048365741,1.008818235585379,1.0035504825952377,2,3,13.685205459594727,12.052213668823242,6,5
1032,16,7.919785064575146,8.542511077604793,1.0262451004863524,1.0158960851739907,6,7,14.217616081237793,12.052213668823242,10,9
1032,32,7.043752591897472,8.278512242732313,1.0415021595072718,1.0296869815024854,12,19,14.729909896850586,12.052213668823242,20,13
1032,64,5.604202121617849,8.122981556224993,1.0260355605759033,1.0361619724650935,32,48,15.160721778869629,12.052213668823242,32,16
1032,128,3.9883754023379496,7.952277405006513,1.0129963152760597,1.0426047786647268,62,113,15.64815616607666,12.052213668823242,66,15
1033,1,11.835709939172752,11.835709939172725,0.9259291711139718,0.9259291711139729,0,0,12.042038917541504,12.042038917541504,1,1
1033,2,9.69180475355407,9.691804753554068,0.9850473632001451,0.9850473632001446,0,0,12.233821868896484,12.042038917541504,2,2
1033,3,9.055725252361059,9.055725252361059,0.9954592468252009,0.9954592468251988,0,0,12.258703231811523,12.042038917541504,3,3
1033,4,9.040740512710547,9.040740512710546,0.9953326041699989,0.9953326041699972,0,0,12.390644073486328,12.042038917541504,4,4
1033,8,7.7806892029744095,7.892645189572677,1.0239760509901774,1.0210640596414178,1,1,12.463265419006348,12.042038917541504,7,7
1033,16,7.125151557101658,7.437702763407369,1.0362141523851038,1.0326860200459373,3,9,12.931509971618652,12.042038917541504,13,7
1033,32,6.772716634521563,7.388257455024073,1.0365075672155135,1.0346061664838195,15,23,13.499248504638672,12.042038917541504,17,9
1033,64,5.447023431054536,7.1522607135019935,1.0267476953174344,1.044107168321687,31,49,14.080873489379883,12.042038917541504,33,15
1033,128,2.981348740735242,7.112734691700408,1.0089594405284903,1.0465026347932587,62,111,14.6083984375,12.042038917541504,66,17
1034,1,6.764067159877479,6.76406715987747,0.973399448600362,0.9733994486003641,0,0,6.809986591339111,6.809986591339111,1,1
1034,2,5.778594409816242,5.778594409816244,0.9891228703872226,0.9891228703872244,0,0,7.246452331542969,6.809986591339111,2,2
1034,3,5.438529818606946,5.438529818606945,0.995962337661598,0.9959623376615994,0,0,8.503480911254883,6.809986591339111,3,3
1034,4,5.107511764182,5.107511764181999,1.0047859136109332,1.0047859136109345,0,0,8.5809965133667,6.809986591339111,4,4
1034,8,4.609394621347115,4.780995994154029,1.0102960053629073,1.013259136659289,2,2,9.030867576599121,6.809986591339111,6,6
1034,16,4.16729401481294,4.39279277985821,1.0207732654615336,1.022908219212646,5,7,9.992281913757324,6.809986591339111,11,9
1034,32,3.712467850351675,4.3238759711871255,1.0172293222391564,1.0246496933428277,11,21,10.484439849853516,6.809986591339111,21,11
1034,64,2.815643155688807,4.293186399702588,1.006113844669454,1.0264341520402138,29,51,11.579087257385254,6.809986591339111,35,13
1034,128,1.8476465319729773,4.2775797155403,1.0029490558132181,1.0284087458943625,56,114,12.46025276184082,6.809986591339111,72,14
1035,1,7.8223039309391815,7.822303930939185,0.9677926571102149,0.9677926571102169,0,0,7.88229513168335,7.88229513168335,1,1
1035,2,6.415128133916197,6.415128133916197,1.0007063937661251,1.0007063937661262,0,0,9.647242546081543,7.88229513168335,2,2
1035,3,5.840216978416589,5.840216978416589,1.0144687483561046,1.0144687483561046,0,0,10.06909465789795,7.88229513168335,3,3
1035,4,5.795633818309293,5.795633818309305,1.0156105117143106,1.0156105117143113,0,0,10.385043144226074,7.88229513168335,4,4
1035,8,5.75114746544687,5.777098441008494,1.0152674119219354,1.0166510300780605,2,2,10.978028297424316,7.88229513168335,6,6
1035,16,4.756761751741657,5.72731925093223,1.0162942153965675,1.020633994155608,5,7,11.603837013244629,7.88229513168335,11,9
1035,32,4.142346141240438,5.357202423393847,1.0177948371152232,1.0285607876779803,14,22,12.266197204589844,7.88229513168335,18,10
1035,64,2.935595827281656,5.25974695138961,1.0068638368343605,1.0308268494370676,29,52,13.154709815979004,7.88229513168335,35,12
1035,128,1.875204387283542,5.155375597866501,1.0027717629961534,1.0363082138576964,65,116,13.925885200500488,7.88229513168335,63,12
1036,1,7.341943267274721,7.3419432672747265,0.9706083496318348,0.9706083496318375,0,0,7.394870281219482,7.394870281219482,1,1
1036,2,6.858415566107327,6.858415566107329,0.9874313556045462,0.9874313556045482,0,0,9.022271156311035,7.394870281219482,2,2
1036,3,6.686849066366043,6.686849066366045,0.9924843136006397,0.9924843136006416,0,0,9.032608032226562,7.394870281219482,3,3
1036,4,6.046174005943997,6.046174005944001,1.0064939846687815,1.0064939846687835,0,0,9.284793853759766,7.394870281219482,4,4
1036,8,5.824783508478193,5.824783508478192,1.0124167088598337,1.0124167088598353,0,0,9.49006175994873,7.394870281219482,8,8
1036,16,5.382974408464881,5.4124950347185985,1.02330433015534,1.0238117929682067,4,5,10.13992977142334,7.394870281219482,12,11
1036,32,3.948177327747562,4.6095322537338905,1.0290207227834616,1.0330628656056726,10,17,10.761109352111816,7.394870281219482,22,15
1036,64,3.035380671747587,4.5324447392115665,1.0184328271102838,1.0345714090152223,30,48,11.520546913146973,7.394870281219482,34,16
1036,128,1.909252916476478,4.528185973618067,1.0018724971953588,1.0350861973899943,57,112,12.501370429992676,7.394870281219482,71,16
1037,1,2.8886792388788023,2.8886792388788027,0.9955575373441673,0.9955575373441677,0,0,2.8919708728790283,2.8919708728790283,1,1
1037,2,2.719878135354901,2.719878135354901,0.9975855768270591,0.9975855768270595,0,0,3.2041561603546143,2.8919708728790283,2,2
1037,3,2.5703846838981312,2.5703846838981312,0.9982756170012803,0.9982756170012799,0,0,3.4783835411071777,2.8919708728790283,3,3
1037,4,2.4685724474889676,2.468572447488968,0.9995416071612993,0.9995416071612991,0,0,3.6365151405334473,2.8919708728790283,4,4
1037,8,2.3728309143696533,2.380153277516865,1.00096933420186,1.0009376212327852,1,1,3.6940033435821533,2.8919708728790283,7,7
1037,16,1.8300759062608096,2.1598790996904933,1.0019836754274922,1.0024626377081387,7,8,3.927924156188965,2.8919708728790283,9,8
1037,32,1.3743465585211723,1.9983399768756036,1.003255037215667,1.0043283215726713,13,22,4.187012672424316,2.8919708728790283,19,10
1037,64,0.7564819734432251,1.8261147046983053,1.0017551529683568,1.0054086345767446,29,51,4.6195549964904785,2.8919708728790283,35,13
1037,128,0.04715872871386568,1.8149572338077886,0.9999187406523865,1.0059823917163278,66,114,5.29434871673584,2.8919708728790283,62,14
1038,1,2.3472235204484444,2.3472235204484453,0.9965128313516406,0.9965128313516415,0,0,2.3497872352600098,2.3497872352600098,1,1
1038,2,2.0592090609101703,2.0592090609101703,1.0009104003831886,1.0009104003831892,0,0,2.452369213104248,2.3497872352600098,2,2
1038,3,1.9763508866045405,1.9763508866045398,1.0024147191133912,1.0024147191133919,0,0,2.9455366134643555,2.3497872352600098,3,3
1038,4,1.9301556040419277,1.9301556040419303,1.0034329247847786,1.003432924784779,0,0,3.077242612838745,2.3497872352600098,4,4
1038,8,1.498859187018007,1.8161294391305305,1.002258067279833,1.0059139758536264,3,1,3.5788872241973877,2.3497872352600098,5,7
1038,16,1.3320776472130242,1.8160455135954998,1.003181331991508,1.0059042670424487,6,8,3.9175188541412354,2.3497872352600098,10,8
1038,32,0.8931535850248876,1.8150224647502586,1.0010256972268197,1.0060155729258413,17,23,4.450636863708496,2.3497872352600098,15,9
1038,64,0.46639285785532686,1.7844087333151246,1.000429010377296,1.0067033700901216,27,56,5.059883117675781,2.3497872352600098,37,8
1038,128,0.03278896487276253,1.6959823862033314,1.0000207441598299,1.007731511316761,57,116,5.899737358093262,2.3497872352600098,71,12
1039,1,9.86437210821092,9.86437210821092,0.9504787315015225,0.9504787315015223,0,0,9.978261947631836,9.978261947631836,1,1
1039,2,8.226800630025553,8.226800630025553,0.9876961071553028,0.987696107155303,0,0,10.064684867858887,9.978261947631836,2,2
1039,3,7.5730694197234865,7.5730694197234865,0.998544993721785,0.9985449937217861,0,0,10.139856338500977,9.978261947631836,3,3
1039,4,6.997210176640892,6.997210176640893,1.0009640370060886,1.0009640370060873,0,0,10.43428897857666,9.978261947631836,4,4
1039,8,6.745291812114079,6.809990794090382,1.003200445707543,1.0037598963928445,1,3,10.670836448669434,9.978261947631836,7,5
1039,16,6.418841042981679,6.668585776695719,1.0088696143437488,1.005789614673656,5,9,10.877889633178711,9.978261947631836,11,7
1039,32,6.094392607432027,6.6339611504313485,1.0117297638191096,1.0077675351870998,13,22,11.112100601196289,9.978261947631836,19,10
1039,64,5.0497634946389915,6.581194473047864,1.0005558190187633,1.0090942114092465,32,52,11.317423820495605,9.978261947631836,32,12
1039,128,3.26659675575433,6.442223147180884,1.0044195657298776,1.0167592240892238,68,112,11.560089111328125,9.978261947631836,60,16
1040,1,2.7804241156467335,2.780424115646733,0.9975140898013557,0.9975140898013555,0,0,2.781513214111328,2.781513214111328,1,1
1040,2,2.4098869305224317,2.4098869305224313,0.9994912249329293,0.999491224932928,0,0,2.829432964324951,2.781513214111328,2,2
1040,3,2.32173269145908,2.32173269145908,0.9997767352614627,0.9997767352614617,0,0,2.9501447677612305,2.781513214111328,3,3
1040,4,2.1054522720710853,2.1054522720710858,1.0004484080503513,1.0004484080503502,0,0,3.015087366104126,2.781513214111328,4,4
1040,8,2.068817572816988,2.076315616181195,1.001201338353723,1.0011441916455892,3,3,3.1854193210601807,2.781513214111328,5,5
1040,16,1.733463248685787,1.8805614954358867,1.0007032245073297,1.0014566524192392,7,8,3.5030503273010254,2.781513214111328,9,8
1040,32,1.0015520027995646,1.7942668742886019,1.0011203461765672,1.0022592998644475,14,23,3.8538119792938232,2.781513214111328,18,9
1040,64,0.27583455927558614,1.5504496021300556,1.0004292990810508,1.0038695744632276,28,52,4.484182834625244,2.781513214111328,36,12
1040,128,0.020677836782031913,1.5491062129254678,0.9999991880509409,1.0038777178115605,65,117,5.405880928039551,2.781513214111328,63,11
1041,1,6.728465508766848,6.728465508766854,0.9717050713096864,0.9717050713096894,0,0,6.781593322753906,6.781593322753906,1,1
1041,2,6.190066210604356,6.190066210604356,0.9846764574490103,0.9846764574490127,0,0,8.153946876525879,6.781593322753906,2,2
1041,3,6.046667870953361,6.046667870953362,0.9879039929986899,0.9879039929986918,0,0,8.58470630645752,6.781593322753906,3,3
1041,4,5.155787112529424,5.155787112529423,1.0019066639662966,1.0019066639662983,0,0,8.655780792236328,6.781593322753906,4,4
1041,8,4.420574557809602,4.445498485781501,1.013993785768755,1.0138642678228715,2,3,9.454094886779785,6.781593322753906,6,5
1041,16,4.268116600645039,4.323862132257095,1.0183000021086852,1.0183600816169471,6,8,10.036362648010254,6.781593322753906,10,8
1041,32,4.016624617267527,4.170273500375303,1.0251589504396073,1.026087152765658,12,16,10.526838302612305,6.781593322753906,20,16
1041,64,3.435148174315557,4.10806328535823,1.0218366452341965,1.028859908658762,27,42,11.153152465820312,6.781593322753906,37,22
1041,128,1.8418062099154822,4.07475798705041,1.0016488355986515,1.0301727656806456,65,107,11.926473617553711,6.781593322753906,63,21
1042,1,6.806238546445008,6.80623854644501,0.9699773078301068,0.9699773078301089,0,0,6.866689682006836,6.866689682006836,1,1
1042,2,6.61435224452378,6.614352244523783,0.9773066919987081,0.9773066919987103,0,0,8.605928421020508,6.866689682006836,2,2
1042,3,5.932372923678504,5.932372923678505,0.9944176130329363,0.9944176130329379,0,0,8.68696403503418,6.866689682006836,3,3
1042,4,5.435317709891763,5.435317709891763,1.0039279009422277,1.003927900942229,0,0,8.743592262268066,6.866689682006836,4,4
1042,8,4.976164817761339,4.976164817761339,1.0146042672027633,1.0146042672027642,0,0,9.511743545532227,6.866689682006836,8,8
1042,16,4.557179937887433,4.882369416241201,1.0129668546625485,1.0166635603196617,3,4,10.744423866271973,6.866689682006836,13,12
1042,32,3.7388044796290094,4.313119121706932,1.018538057157137,1.0280010453496025,13,21,11.510172843933105,6.866689682006836,19,11
1042,64,2.853183694597336,4.291905011931265,1.009743803829062,1.0303808876051397,24,50,12.374837875366211,6.866689682006836,40,14
1042,128,1.830673137162251,4.225947514834704,1.005253602305428,1.0333972526159922,59,113,13.243732452392578,6.866689682006836,69,15
1043,1,7.739618236139508,7.739618236139511,0.9642933647186827,0.9642933647186842,0,0,7.814964294433594,7.814964294433594,1,1
1043,2,6.638681478105454,6.638681478105455,0.983754337765764,0.983754337765765,0,0,7.859703540802002,7.814964294433594,2,2
1043,3,5.937041288849023,5.937041288849024,0.9946220502618961,0.994622050261897,0,0,7.908378601074219,7.814964294433594,3,3
1043,4,5.827151376525557,5.827151376525557,0.9959826417611753,0.995982641761176,0,0,8.127760887145996,7.814964294433594,4,4
1043,8,4.748123474421596,4.809225948469172,1.0120625944302633,1.0112682754104751,1,1,8.658623695373535,7.814964294433594,7,7
1043,16,4.5644784568673025,4.610334659861253,1.0162959338557855,1.016378644140452,4,6,9.199651718139648,7.814964294433594,12,10
1043,32,3.6881003073728826,4.482007551331594,1.012569514065257,1.019406977555594,14,21,9.86003589630127,7.814964294433594,18,11
1043,64,2.8573931043990086,4.357406132671862,1.0067854142013584,1.0233846404847535,27,47,10.493721008300781,7.814964294433594,37,17
1043,128,1.4070098512341966,4.29610569247081,1.001432674519745,1.0244108924879745,65,109,11.169063568115234,7.814964294433594,63,19
1044,1,12.2343841760171,12.234384176017087,0.8944356311589569,0.8944356311589582,0,0,12.645941734313965,12.645941734313965,1,1
1044,2,11.300687944240872,11.300687944240874,0.9272014204273437,0.9272014204273448,0,0,12.76633358001709,12.645941734313965,2,2
1044,3,10.153255054400395,10.153255054400393,0.9579256099215174,0.9579256099215168,0,0,12.824650764465332,12.645941734313965,3,3
1044,4,9.692049173035034,9.692049173035034,0.967260365280252,0.9672603652802517,0,0,12.84290885925293,12.645941734313965,4,4
1044,8,9.045112936281669,9.073048132306434,0.9872026057930832,0.9869123938130813,3,3,13.129741668701172,12.645941734313965,5,5
1044,16,8.321420376210838,8.76749468543927,1.0016471595932626,0.998010936358533,5,7,13.36055850982666,12.645941734313965,11,9
1044,32,7.285485115246564,8.4354290523761,1.0152034862638177,1.0107461475423003,9,19,13.810281753540039,12.645941734313965,23,13
1044,64,6.39488754515553,8.405474135940759,1.006710425987757,1.0126968693588374,33,50,14.11423397064209,12.645941734313965,31,14
1044,128,3.840055089659976,8.20929063216437,1.0086681884840494,1.0220693245253276,64,112,14.427138328552246,12.645941734313965,64,16
1045,1,6.943401426560206,6.943401426560204,0.9822228203958518,0.9822228203958533,0,0,6.964654445648193,6.964654445648193,1,1
1045,2,6.0074173939027995,6.007417393902801,0.994076994951981,0.9940769949519834,0,0,7.295760154724121,6.964654445648193,2,2
1045,3,5.720717019416948,5.720717019416948,0.9997318549773346,0.9997318549773357,0,0,7.469842910766602,6.964654445648193,3,3
1045,4,5.118521735652975,5.118521735652974,1.0066126401111322,1.0066126401111333,0,0,7.739452362060547,6.964654445648193,4,4
1045,8,4.418361687013616,4.542704903485074,1.016260845988576,1.01542307295227,2,3,8.480061531066895,6.964654445648193,6,5
1045,16,3.737177256845451,4.089535813698045,1.0209256537657532,1.0238638939671194,5,8,9.250774383544922,6.964654445648193,11,8
1045,32,2.891405850115097,4.036842279162743,1.0115321127951526,1.0265667226520279,12,22,9.920540809631348,6.964654445648193,20,10
1045,64,2.013212122751983,4.013135701301921,1.0062554122137395,1.0278307530751996,29,52,10.747557640075684,6.964654445648193,35,12
1045,128,1.0286417842894138,3.9720210418238633,1.0013876089295801,1.0296493551519061,64,114,11.472097396850586,6.964654445648193,64,14
1046,1,6.491595273325155,6.491595273325121,0.9771596198742692,0.9771596198742717,0,0,6.5282135009765625,6.5282135009765625,1,1
1046,2,5.169246251986894,5.1692462519868885,0.9906224449569243,0.9906224449569261,0,0,6.6746087074279785,6.5282135009765625,2,2
1046,3,4.455280815102199,4.455280815102199,1.000875595714236,1.0008755957142368,0,0,7.212239742279053,6.5282135009765625,3,3
1046,4,4.339654241502102,4.339654241502101,1.0026698866542383,1.0026698866542396,0,0,7.441784381866455,6.5282135009765625,4,4
1046,8,3.589958570136262,3.5961180966815993,1.0119266467041,1.012262823115092,1,1,7.935056209564209,6.5282135009765625,7,7
1046,16,3.4852716419177017,3.5653746472817702,1.0123919670977786,1.0135609522174185,4,5,8.782469749450684,6.5282135009765625,12,11
1046,32,3.0533616515355537,3.501438624838577,1.009658232195006,1.0168436193535442,16,19,9.665010452270508,6.5282135009765625,16,13
1046,64,2.3753442041758794,3.4820370533334937,1.0028771068465838,1.0184492138666905,31,47,10.444405555725098,6.5282135009765625,33,17
1046,128,1.331651421888795,3.4796486679404977,1.0008379000040573,1.0188425757514352,61,111,11.127642631530762,6.5282135009765625,67,17
1047,1,8.089247755544188,8.08924775554419,0.9635410284669508,0.9635410284669523,0,0,8.16053295135498,8.16053295135498,1,1
1047,2,6.791596056441236,6.791596056441235,0.9897095147777997,0.9897095147777998,0,0,9.106415748596191,8.16053295135498,2,2
1047,3,6.441505046667695,6.441505046667695,0.9962279118744322,0.9962279118744328,0,0,9.463046073913574,8.16053295135498,3,3
1047,4,6.439126399235552,6.439126399235553,0.996538051535263,0.9965380515352631,0,0,9.60877513885498,8.16053295135498,4,4
1047,8,6.058358457305552,6.2608736363923425,1.0014974493595505,1.002087090879558,3,3,10.955412864685059,8.16053295135498,5,5
1047,16,5.520773171299546,5.801324635087941,1.0161130685661648,1.0154169913318096,8,9,11.826534271240234,8.16053295135498,8,7
1047,32,4.454427988254337,5.626512216208654,1.0147018364341558,1.0228926012533608,12,22,12.512735366821289,8.16053295135498,20,10
1047,64,3.085128104189485,5.38544095683915,1.010672550285127,1.031996860753835,29,54,13.094544410705566,8.16053295135498,35,10
1047,128,2.2544162697791634,5.314885666635968,1.0037035424061185,1.038069913719768,68,114,13.984732627868652,8.16053295135498,60,14
1048,1,7.67618979156497,7.676189791564973,0.9624638548349083,0.9624638548349094,0,0,7.757710933685303,7.757710933685303,1,1
1048,2,6.630091239257512,6.630091239257513,0.9805991074853465,0.9805991074853473,0,0,8.030057907104492,7.757710933685303,2,2
1048,3,5.985368218001714,5.985368218001712,0.9918197121764526,0.9918197121764533,0,0,8.04629135131836,7.757710933685303,3,3
1048,4,5.873008182497674,5.873008182497674,0.9948857106992595,0.9948857106992597,0,0,8.597923278808594,7.757710933685303,4,4
1048,8,4.698690204364386,4.740772772678885,1.0141795389546333,1.0134002493002399,1,1,9.150764465332031,7.757710933685303,7,7
1048,16,4.069674161033713,4.237798524723002,1.018909132177703,1.0216219372824482,6,8,9.699719429016113,7.757710933685303,10,8
1048,32,3.4218037064193823,4.120506309846095,1.0160661760079948,1.024623929970865,12,22,10.730610847473145,7.757710933685303,20,10
1048,64,2.357421528760514,4.115560817771175,1.005691002060635,1.0251938606430828,33,52,11.62730884552002,7.757710933685303,31,12
1048,128,1.3489825490689735,4.106049881267985,1.0029430782155817,1.0255025182158595,66,115,12.312339782714844,7.757710933685303,62,13
1049,1,11.107227215184636,11.107227215184638,0.9260047942188347,0.9260047942188359,0,0,11.32363224029541,11.32363224029541,1,1
1049,2,9.294736319080679,9.294736319080679,0.9705878005261179,0.9705878005261184,0,0,11.78634262084961,11.32363224029541,2,2
1049,3,8.690441030304516,8.690441030304518,0.9868073253486498,0.9868073253486505,0,0,11.802700996398926,11.32363224029541,3,3
1049,4,8.61642723197331,8.616427231973312,0.9896827530261989,0.9896827530262003,0,0,12.095922470092773,11.32363224029541,4,4
1049,8,8.306041317205212,8.382827754004254,0.9995703135702663,0.9985082585357083,1,1,12.870035171508789,11.32363224029541,7,7
1049,16,6.787660515136574,7.068597136176517,1.0384435156518839,1.0377788478098988,4,8,13.491497039794922,11.32363224029541,12,8
1049,32,5.98762688597763,6.982407159815757,1.0349466155466676,1.0411766858436227,15,22,14.143893241882324,11.32363224029541,17,10
1049,64,4.901433674205546,6.889220619202234,1.0277818873483495,1.048231226766169,31,53,14.686304092407227,11.32363224029541,33,11
1049,128,3.0118083547268775,6.852114591267879,1.007503288143726,1.0510585646642665,60,116,15.489398956298828,11.32363224029541,68,12
1050,1,11.809125774839869,11.809125774839876,0.9253746347089236,0.9253746347089258,0,0,12.008720397949219,12.008720397949219,1,1
1050,2,9.091611468607042,9.091611468607042,0.993841301497848,0.9938413014978476,0,0,12.301532745361328,12.008720397949219,2,2
1050,3,9.077603689434175,9.077603689434175,0.9947229728041423,0.9947229728041419,0,0,12.845968246459961,12.008720397949219,3,3
1050,4,8.158701073636033,8.158701073636035,1.0165410701569466,1.0165410701569457,0,0,13.007282257080078,12.008720397949219,4,4
1050,8,7.670237808419509,7.676220204118159,1.0318310072215373,1.0319348057859719,2,2,13.317609786987305,12.008720397949219,6,6
1050,16,6.626542372626892,6.775554515701564,1.0580189970171474,1.0560557327825777,4,4,14.033516883850098,12.008720397949219,12,12
1050,32,6.277535096300216,6.678826100928174,1.0558974846133438,1.058400286507441,15,16,14.46512508392334,12.008720397949219,17,16
1050,64,5.525820650697593,6.556502176630542,1.052672459305034,1.0618539290515476,29,46,15.030088424682617,12.008720397949219,35,18
1050,128,3.9092979768691234,6.508794910225297,1.0315665122986328,1.0629278664213007,64,108,15.451525688171387,12.008720397949219,64,20
1051,1,8.48894757405199,8.488947574051995,0.9541115619547302,0.9541115619547326,0,0,8.599974632263184,8.599974632263184,1,1
1051,2,5.7381026673091835,5.738102667309184,1.0003441473538452,1.0003441473538468,0,0,9.027356147766113,8.599974632263184,2,2
1051,3,5.687120546894394,5.687120546894393,1.0027896477162395,1.002789647716242,0,0,9.542313575744629,8.599974632263184,3,3
1051,4,5.5826593959380055,5.5826593959380055,1.0053596434085141,1.0053596434085157,0,0,10.177704811096191,8.599974632263184,4,4
1051,8,5.296791160225937,5.334471776288606,1.0132557479313058,1.0134824737543087,1,1,10.628958702087402,8.599974632263184,7,7
1051,16,5.144400833559749,5.272567158685416,1.0173492087866327,1.0163861843496702,4,6,11.230705261230469,8.599974632263184,12,10
1051,32,4.433040530525739,5.15563870226824,1.0203814354644323,1.0210947032374413,11,17,11.882083892822266,8.599974632263184,21,15
1051,64,3.3794215701183,5.027368487376862,1.0178418067903523,1.0277614412335006,29,47,12.993339538574219,8.599974632263184,35,17
1051,128,2.4003955347686197,5.003378286771062,1.0102201145314424,1.0298641234542436,63,111,13.889317512512207,8.599974632263184,65,17
1052,1,11.790458128878116,11.79045812887809,0.9082701682955509,0.9082701682955542,0,0,12.098983764648438,12.098983764648438,1,1
1052,2,11.11039674484793,11.110396744847936,0.9369560921343532,0.9369560921343552,0,0,12.847224235534668,12.098983764648438,2,2
1052,3,9.15374333927358,9.153743339273582,0.9835812971308231,0.9835812971308251,0,0,13.035599708557129,12.098983764648438,3,3
1052,4,9.007005729910093,9.007005729910093,0.9902735706449736,0.9902735706449746,0,0,13.836512565612793,12.098983764648438,4,4
1052,8,8.718395336817707,8.820026905358711,0.9965725982784344,0.9983472503600751,2,2,14.25652027130127,12.098983764648438,6,6
1052,16,8.152949838300744,8.743635491744493,1.009435509800845,1.0039796025467245,8,9,14.62923526763916,12.098983764648438,8,7
1052,32,6.970861477690499,8.56441523064674,1.0228843294353795,1.0121205331848657,14,23,15.18394660949707,12.098983764648438,18,9
1052,64,5.650713548854713,8.197510429029496,1.0280012961588254,1.0316205875962716,26,52,15.823887825012207,12.098983764648438,38,12
1052,128,3.507434950934797,7.954758331038106,1.009142997500608,1.037931312543067,63,113,16.205425262451172,12.098983764648438,65,15
1053,1,9.7259031665767,9.725903166576703,0.9469493933885944,0.9469493933885965,0,0,9.853130340576172,9.853130340576172,1,1
1053,2,8.619836065646197,8.6198360656462,0.9748562903776901,0.9748562903776914,0,0,10.46615219116211,9.853130340576172,2,2
1053,3,7.034230848835598,7.034230848835599,1.0083539865774873,1.008353986577487,0,0,10.560500144958496,9.853130340576172,3,3
1053,4,6.040172153602525,6.040172153602525,1.0252009791148866,1.0252009791148846,0,0,10.906996726989746,9.853130340576172,4,4
1053,8,5.683202279972946,5.706818122556163,1.033250061573493,1.033643107860502,1,1,11.771195411682129,9.853130340576172,7,7
1053,16,5.432543526187537,5.4951041619099374,1.039078657993728,1.0404241079973673,6,6,12.099740028381348,9.853130340576172,10,10
1053,32,4.915161797199276,5.20832167749565,1.0450365545871343,1.0495483162672377,11,15,12.864048957824707,9.853130340576172,21,17
1053,64,3.862367603923682,5.1478596359033135,1.033314465108073,1.052597632429264,25,47,13.455314636230469,9.853130340576172,39,17
1053,128,2.328785424649574,5.0667888290767955,1.0135240470577909,1.0547342375060504,62,109,14.383329391479492,9.853130340576172,66,19
1054,1,4.027822748115418,4.027822748115418,0.9903088118498344,0.9903088118498347,0,0,4.039036273956299,4.039036273956299,1,1
1054,2,3.523533846382768,3.5235338463827675,0.9943296711987168,0.9943296711987171,0,0,4.060166835784912,4.039036273956299,2,2
1054,3,3.405845751715789,3.4058457517157876,0.9951844955719684,0.9951844955719675,0,0,4.251336097717285,4.039036273956299,3,3
1054,4,3.3377393588810977,3.338563115066084,0.9964728132082004,0.9964256193392476,1,1,4.285318374633789,4.039036273956299,3,3
1054,8,2.818382700666257,2.8629755316560797,1.0007456829109966,1.0009580220267777,2,2,4.479519367218018,4.039036273956299,6,6
1054,16,2.4454365173714714,2.5929599964124366,1.0041759277240312,1.0028936179993062,6,10,4.780536651611328,4.039036273956299,10,6
1054,32,2.1252332073848716,2.516910726453514,1.0054860096440965,1.0035690527788224,14,22,4.940774917602539,4.039036273956299,18,10
1054,64,1.2484585145189246,2.4124085880733097,1.0024038038667613,1.004734117935702,33,54,5.174489974975586,4.039036273956299,31,10
1054,128,0.20735675417988872,2.3984547485744567,0.9998991513457689,1.005140849602556,63,115,5.498360633850098,4.039036273956299,65,13
1055,1,8.56503174889106,8.565031748891064,0.9566361865587781,0.9566361865587797,0,0,8.665059089660645,8.665059089660645,1,1
1055,2,7.349248469745325,7.349248469745326,0.9785769506346467,0.9785769506346484,0,0,8.925344467163086,8.665059089660645,2,2
1055,3,6.518753401012415,6.518753401012415,0.9945918703360674,0.9945918703360681,0,0,9.176802635192871,8.665059089660645,3,3
1055,4,6.459526659217523,6.459526659217523,0.9962634378580743,0.9962634378580747,0,0,9.62059211730957,8.665059089660645,4,4
1055,8,5.772535318879231,5.838761245077131,1.012460882524594,1.0126152053755182,2,2,10.134957313537598,8.665059089660645,6,6
1055,16,4.794447328797436,5.204267133525862,1.0254553618651023,1.0226667413164698,7,9,10.398070335388184,8.665059089660645,9,7
1055,32,4.1928725195399945,4.7968529464664895,1.035887367362649,1.0333936760005378,12,21,10.847698211669922,8.665059089660645,20,11
1055,64,3.3943608974791495,4.76878125503108,1.0231755236239413,1.034992410160021,33,52,11.370929718017578,8.665059089660645,31,12
1055,128,1.846991434199072,4.603307667343458,1.009160084825224,1.0378440888166165,55,115,11.86053466796875,8.665059089660645,73,13
1056,1,8.246710933508998,8.246710933509002,0.9648511936495894,0.9648511936495917,0,0,8.313129425048828,8.313129425048828,1,1
1056,2,6.814318975116598,6.814318975116598,0.9942163444326622,0.9942163444326639,0,0,8.859182357788086,8.313129425048828,2,2
1056,3,6.05131329427829,6.05131329427829,1.002114510832628,1.0021145108326264,0,0,8.979783058166504,8.313129425048828,3,3
1056,4,6.0473042780668145,6.0473042780668145,1.0023980665181558,1.0023980665181544,0,0,9.851457595825195,8.313129425048828,4,4
1056,8,5.399072377735133,5.463550619155749,1.0124250320048973,1.012757492385703,2,2,10.380773544311523,8.313129425048828,6,6
1056,16,4.910635932883637,5.393521078875374,1.0140145335446162,1.0147783576199425,6,8,11.184557914733887,8.313129425048828,10,8
1056,32,4.159014773360519,5.200581706537045,1.0169567789638307,1.0208394845010842,15,22,11.585001945495605,8.313129425048828,17,10
1056,64,3.5278858141160754,4.766188671450307,1.013243721711997,1.0315522241037876,32,49,12.119935035705566,8.313129425048828,32,15
1056,128,2.2502990390148847,4.657222060642533,1.0036612869982515,1.0360195400921277,62,111,12.696996688842773,8.313129425048828,66,17
1057,1,6.920681488740995,6.920681488740997,0.9688409850738322,0.9688409850738339,0,0,6.984224796295166,6.984224796295166,1,1
1057,2,5.6161777028184305,5.616177702818431,0.9887508679277712,0.988750867927773,0,0,7.050169944763184,6.984224796295166,2,2
1057,3,5.19915973965807,5.199159739658071,0.9951986910884509,0.9951986910884519,0,0,7.1479926109313965,6.984224796295166,3,3
1057,4,5.172500157976208,5.172500157976209,0.9950119125882653,0.9950119125882657,0,0,7.406387805938721,6.984224796295166,4,4
1057,8,5.049963890963748,5.06742316611917,0.9979145211720568,0.9984766129337534,2,2,8.324560165405273,6.984224796295166,6,6
1057,16,4.344294969219375,4.770299869844111,1.0045620362960617,1.0065845513629321,6,6,8.683834075927734,6.984224796295166,10,10
1057,32,3.547450828057974,4.397866220882174,1.011878818250122,1.0159504739388572,12,18,9.188077926635742,6.984224796295166,20,14
1057,64,2.528715273668338,4.116768651435228,1.0097410105295543,1.02219875017723,32,51,9.90744400024414,6.984224796295166,32,13
1057,128,1.3199915107320317,4.062732016558333,1.0044024031109455,1.0254657735743884,56,108,10.573956489562988,6.984224796295166,72,20
1058,1,5.824296362766456,5.824296362766456,0.9816616562697683,0.9816616562697692,0,0,5.850793361663818,5.850793361663818,1,1
1058,2,5.1564839739681,5.1564839739681005,0.9900783243078944,0.9900783243078948,0,0,5.99263334274292,5.850793361663818,2,2
1058,3,4.125639650613752,4.125639650613752,0.9996414395002171,0.9996414395002169,0,0,6.0009613037109375,5.850793361663818,3,3
1058,4,3.745262442772376,3.7452624427723764,1.0037665427838522,1.0037665427838516,0,0,6.0433220863342285,5.850793361663818,4,4
1058,8,2.8744406247532996,2.874541409123288,1.0126266527704046,1.0126264696870368,1,1,6.790285110473633,5.850793361663818,7,7
1058,16,2.5603969054190063,2.746752888845427,1.0138146608128529,1.0150288906234168,5,5,7.329840660095215,5.850793361663818,11,11
1058,32,2.0237118415243414,2.6399750320949305,1.0130016058140576,1.0177759650815144,12,19,7.634941101074219,5.850793361663818,20,13
1058,64,1.4451111069359845,2.6193856129943867,1.00650759209098,1.0185014077953483,31,48,8.333636283874512,5.850793361663818,33,16
1058,128,0.6282287934564681,2.5962156251196844,1.0005098481247574,1.0198857467531963,64,111,8.949995994567871,5.850793361663818,64,17
1059,1,8.434618367467724,8.43461836746773,0.9628317217765758,0.9628317217765776,0,0,8.507336616516113,8.507336616516113,1,1
1059,2,6.3456886359216975,6.345688635921698,0.9987356289832586,0.9987356289832596,0,0,8.670327186584473,8.507336616516113,2,2
1059,3,5.5254044768969255,5.525404476896925,1.0098353310801267,1.0098353310801285,0,0,8.957306861877441,8.507336616516113,3,3
1059,4,5.330041653185146,5.330041653185145,1.0125237581757525,1.0125237581757531,0,0,9.174361228942871,8.507336616516113,4,4
1059,8,4.665862111411489,4.670166072067547,1.0224030753724627,1.0228410331768596,1,1,9.985220909118652,8.507336616516113,7,7
1059,16,4.324013626759756,4.639660368394511,1.0243123186588607,1.0247767103536303,2,8,10.636273384094238,8.507336616516113,14,8
1059,32,3.9654244813412567,4.630482117007163,1.020045781754163,1.0263043692640728,12,19,11.582986831665039,8.507336616516113,20,13
1059,64,3.0728976054736847,4.441772440688727,1.0133565431992109,1.0331433988283543,32,54,12.192140579223633,8.507336616516113,32,10
1059,128,1.9481035507116662,4.422286553349733,1.0052577380979577,1.0339663383771955,58,114,13.203956604003906,8.507336616516113,70,14
1060,1,11.965769723519134,11.965769723519124,0.9091872398086172,0.9091872398086206,0,0,12.272560119628906,12.272560119628906,1,1
1060,2,10.78493550083092,10.784935500830926,0.94636165605087,0.9463616560508721,0,0,12.608661651611328,12.272560119628906,2,2
1060,3,10.71966111579626,10.71966111579626,0.9480827047788969,0.9480827047788979,0,0,12.695578575134277,12.272560119628906,3,3
1060,4,9.162017935338232,9.1772646664603,0.9966330199292233,0.9959903626371813,1,1,13.460787773132324,12.272560119628906,3,3
1060,8,8.927316679426207,8.958671314017538,1.0068950485002848,1.0056817020945261,2,2,14.128199577331543,12.272560119628906,6,6
1060,16,7.858026229741863,8.697948215028635,1.0287992746011265,1.0169497493707924,4,8,14.874391555786133,12.272560119628906,12,8
1060,32,6.647826645446594,8.504255939722734,1.032526888896176,1.025371057893389,15,22,15.399731636047363,12.272560119628906,17,10
1060,64,4.933684161572997,8.341796660107605,1.0183258824717656,1.038234717257326,31,51,16.286617279052734,12.272560119628906,33,13
1060,128,3.3351840744065826,8.232987658658649,1.0023786486518793,1.0439223995261704,58,114,17.262006759643555,12.272560119628906,70,14
1061,1,9.586782011433154,9.586782011433154,0.9324723338845418,0.9324723338845425,0,0,9.790279388427734,9.790279388427734,1,1
1061,2,9.069685171288961,9.069685171288965,0.9489391819569089,0.9489391819569093,0,0,10.977803230285645,9.790279388427734,2,2
1061,3,8.172596271347496,8.172596271347496,0.9724357301994941,0.9724357301994944,0,0,11.1307373046875,9.790279388427734,3,3
1061,4,7.903360997538694,7.907379059270031,0.9786208991678074,0.9786548810695813,1,1,11.180137634277344,9.790279388427734,3,3
1061,8,6.820631158599779,6.929682440615633,1.0088546530068778,1.0067576309351915,2,2,11.945917129516602,9.790279388427734,6,6
1061,16,6.241816736396277,6.803500109347506,1.019488218233714,1.0114868643386026,4,8,13.137430191040039,9.790279388427734,12,8
1061,32,5.453326984201844,6.8030651929541435,1.0256145868650295,1.0119408628648041,11,22,13.595258712768555,9.790279388427734,21,10
1061,64,4.143092702139672,6.725226810138,1.020569727897322,1.0179341325183886,29,52,14.14620590209961,9.790279388427734,35,12
1061,128,2.628385749257434,6.664269047716057,1.0111874053537728,1.0241078730493127,62,112,14.851479530334473,9.790279388427734,66,16
1062,1,9.009258460268464,9.009258460268468,0.9459405024311136,0.9459405024311145,0,0,9.159014701843262,9.159014701843262,1,1
1062,2,6.842514217624474,6.842514217624475,0.9920769911780458,0.992076991178047,0,0,9.619344711303711,9.159014701843262,2,2
1062,3,6.336783553597708,6.336783553597707,1.0005923181477927,1.0005923181477914,0,0,9.73334789276123,9.159014701843262,3,3
1062,4,6.254447829225239,6.25444782922524,1.0028127216365388,1.0028127216365377,0,0,9.858804702758789,9.159014701843262,4,4
1062,8,6.177734125471218,6.226369522015084,1.002735286109023,1.0035754406985435,2,2,10.04507827758789,9.159014701843262,6,6
1062,16,5.741377689134917,6.019478222325325,1.0077018397492654,1.0083968939703214,7,8,10.163267135620117,9.159014701843262,9,8
1062,32,5.298217819191445,5.95291206341965,1.0153527682519452,1.0109672831038674,15,20,10.469721794128418,9.159014701843262,17,12
1062,64,4.3174572540733385,5.916051272875697,1.0106139206041609,1.0127879948751741,26,48,10.87801456451416,9.159014701843262,38,16
1062,128,2.3439812546569345,5.788232117936969,0.9982505176962551,1.0163561303117326,66,116,11.273497581481934,9.159014701843262,62,12
1063,1,6.148476121821921,6.148476121821922,0.9762819084931433,0.9762819084931437,0,0,6.18978214263916,6.18978214263916,1,1
1063,2,4.358645857377255,4.358645857377255,0.9999345211343151,0.9999345211343149,0,0,6.825423717498779,6.18978214263916,2,2
1063,3,3.854173314447035,3.854173314447036,1.0036754527987064,1.0036754527987055,0,0,7.043017387390137,6.18978214263916,3,3
1063,4,3.83912107867399,3.8541733144470354,1.0033194766481546,1.0036754527987055,1,1,7.457078456878662,6.18978214263916,3,3
1063,8,3.8273085606995148,3.8503339757106807,1.0041373052066025,1.0042691022251489,2,2,7.773212909698486,6.18978214263916,6,6
1063,16,3.5406019508915114,3.6610979226857485,1.0102033944151454,1.0101079771808408,7,8,8.058767318725586,6.18978214263916,9,8
1063,32,2.7089898216107473,3.585000785597751,1.0095702308296732,1.0131844854131002,13,22,8.572630882263184,6.18978214263916,19,10
1063,64,2.0791358853372963,3.475580493603457,1.0094724399249695,1.0147073397052175,27,53,9.199094772338867,6.18978214263916,37,11
1063,128,1.0379893058322904,3.3435370645984683,1.0027841681978602,1.0172893513361347,60,116,9.929497718811035,6.18978214263916,68,12
1064,1,10.31930939508414,10.319309395084145,0.941358527379044,0.941358527379046,0,0,10.465015411376953,10.465015411376953,1,1
1064,2,7.229889808947897,7.229889808947895,1.003907603330506,1.0039076033305068,0,0,10.638174057006836,10.465015411376953,2,2
1064,3,7.143490915899662,7.143490915899662,1.005954791512431,1.0059547915124323,0,0,10.97972583770752,10.465015411376953,3,3
1064,4,7.014296700972878,7.014296700972878,1.0087339429682867,1.0087339429682873,0,0,11.265880584716797,10.465015411376953,4,4
1064,8,6.073647680763385,6.13571007848208,1.0236176360853906,1.0241747266980468,1,1,11.60157585144043,10.465015411376953,7,7
1064,16,5.988358520015738,6.052467260729872,1.026581935904054,1.0272024434078064,5,5,11.757896423339844,10.465015411376953,11,11
1064,32,5.475223664377472,5.748548009487038,1.0355825235752363,1.0383405827174321,11,16,12.71908187866211,10.465015411376953,21,16
1064,64,3.50392685727375,5.6423203164913,1.0146520495155547,1.0418717154799964,31,45,13.399283409118652,10.465015411376953,33,19
1064,128,2.3168088465646495,5.619971059059458,1.005366274261473,1.0441855559800528,61,107,14.171442031860352,10.465015411376953,67,21
1065,1,8.88575412476944,8.885754124769441,0.9527011608429553,0.9527011608429574,0,0,8.99742317199707,8.99742317199707,1,1
1065,2,6.732250761444242,6.732250761444242,0.9924235921333937,0.9924235921333953,0,0,9.43835735321045,8.99742317199707,2,2
1065,3,6.595928506366809,6.59592850636681,0.996671091177034,0.9966710911770351,0,0,10.573315620422363,8.99742317199707,3,3
1065,4,6.236659063756987,6.236659063756986,1.005938599651016,1.0059385996510166,0,0,10.588569641113281,8.99742317199707,4,4
1065,8,5.868717721917092,5.869250910159142,1.012628572275524,1.0127183442568157,1,1,11.060304641723633,8.99742317199707,7,7
1065,16,5.500254752330885,5.517621790089951,1.0262190694986844,1.026974419288508,4,5,11.47658634185791,8.99742317199707,12,11
1065,32,4.692035884308476,5.194143096300375,1.028578579591388,1.0346002986939242,12,17,12.004993438720703,8.99742317199707,20,15
1065,64,3.697691213400349,5.181228320057402,1.0208629007045311,1.0357374535536725,33,46,12.901928901672363,8.99742317199707,31,18
1065,128,2.25507734905082,5.080520888916104,1.007306697141321,1.0433788002114903,58,110,13.833194732666016,8.99742317199707,70,18
1066,1,8.863965585400033,8.863965585400035,0.9615540569513269,0.9615540569513277,0,0,8.93961238861084,8.93961238861084,1,1
1066,2,7.7426844151766625,7.742684415176661,0.9820513261857804,0.98205132618578,0,0,9.307390213012695,8.93961238861084,2,2
1066,3,7.3026830747244205,7.3026830747244205,0.9908111736090361,0.9908111736090366,0,0,9.4979887008667,8.93961238861084,3,3
1066,4,7.3002505549421315,7.3026830747244205,0.9908465571902343,0.9908111736090366,1,1,9.578474044799805,8.93961238861084,3,3
1066,8,6.518241136333423,6.556340335921255,1.0070210791288092,1.0065735756749912,2,2,9.932056427001953,8.93961238861084,6,6
1066,16,6.078947555047477,6.379788414112338,1.0100281618382116,1.0092338718886245,5,7,10.442183494567871,8.93961238861084,11,9
1066,32,5.226445453274651,6.177910137036211,1.0167386241516574,1.017241376184757,12,20,11.157267570495605,8.93961238861084,20,12
1066,64,3.8569005341833726,6.157450058575775,1.0063961490676847,1.0200487290539955,31,49,11.655574798583984,8.93961238861084,33,15
1066,128,2.4732875839761057,6.035756781318648,1.0066036798984803,1.0290371344342406,56,109,12.398681640625,8.93961238861084,72,19
1067,1,8.344648335591874,8.344648335591875,0.9672257368221193,0.96722573682212,0,0,8.401373863220215,8.401373863220215,1,1
1067,2,7.03208659470838,7.032086594708381,0.984747552071507,0.9847475520715081,0,0,8.70892333984375,8.401373863220215,2,2
1067,3,6.26895027767458,6.26895027767458,0.9983341896010337,0.998334189601034,0,0,8.821860313415527,8.401373863220215,3,3
1067,4,5.686824120448047,5.686824120448047,1.0085582408420528,1.0085582408420526,0,0,8.993622779846191,8.401373863220215,4,4
1067,8,5.563209632538967,5.581958348996637,1.0117891420612781,1.0113643415014044,1,1,9.514832496643066,8.401373863220215,7,7
1067,16,4.917792760480644,5.0050630493247805,1.023506380328731,1.023643445060188,4,5,9.948553085327148,8.401373863220215,12,11
1067,32,4.582878330920879,4.871515717479205,1.0256720720436565,1.0279325097618337,10,18,10.639322280883789,8.401373863220215,22,14
1067,64,3.131607507750496,4.74921152537816,1.012520832634576,1.0310341046447509,32,45,11.186983108520508,8.401373863220215,32,19
1067,128,1.8142221293304792,4.74590771547779,1.003387967289352,1.0316949997796812,65,106,11.754528999328613,8.401373863220215,63,22
1068,1,9.365811352852276,9.365811352852276,0.9425458908353203,0.9425458908353201,0,0,9.527300834655762,9.527300834655762,1,1
1068,2,8.461679535634142,8.46167953563414,0.9610792372963304,0.9610792372963302,0,0,9.561630249023438,9.527300834655762,2,2
1068,3,6.86991815040249,6.869918150402488,0.9974744044385215,0.99747440443852,0,0,9.84493350982666,9.527300834655762,3,3
1068,4,6.810765667692567,6.810765667692566,0.9989195170622107,0.9989195170622094,0,0,10.024270057678223,9.527300834655762,4,4
1068,8,6.542230945106921,6.548263241634146,1.0021230878158893,1.0025012826672772,1,1,10.2695951461792,9.527300834655762,7,7
1068,16,6.09774715716634,6.1842019486646755,1.011898015480647,1.0115637663732364,5,7,10.529807090759277,9.527300834655762,11,9
1068,32,5.493686586918225,6.0758899030474645,1.0220605746644869,1.0168242242819172,12,19,10.857844352722168,9.527300834655762,20,13
1068,64,4.295826563269721,5.8136717253939585,1.0289293378192363,1.0280490483639768,32,49,11.187735557556152,9.527300834655762,32,15
1068,128,2.6496503250451484,5.73522296987322,1.0080244332146802,1.0290895142393524,69,111,11.617583274841309,9.527300834655762,59,17
1069,1,8.86874251236665,8.868742512366651,0.9509737937959194,0.9509737937959205,0,0,8.987486839294434,8.987486839294434,1,1
1069,2,8.092347589095219,8.092347589095219,0.9759136458437123,0.9759136458437117,0,0,10.952563285827637,8.987486839294434,2,2
1069,3,7.548001732248943,7.5480017322489426,0.9920579190141109,0.9920579190141109,0,0,10.992227554321289,8.987486839294434,3,3
1069,4,7.3840733514793815,7.384073351479382,0.9961451802307753,0.996145180230775,0,0,11.143661499023438,8.987486839294434,4,4
1069,8,6.6013205023639,6.646136181759273,1.0168919540995758,1.017799348638405,1,1,12.045083045959473,8.987486839294434,7,7
1069,16,5.418446647089608,5.854427998413457,1.0406007912819866,1.0392623767961529,5,7,12.586614608764648,8.987486839294434,11,9
1069,32,4.715442266190868,5.67223597212097,1.0342577089875304,1.0476298437033889,12,20,13.54006576538086,8.987486839294434,20,12
1069,64,3.584224184301029,5.5008061886648285,1.018334683780886,1.0543591583488992,31,47,14.28915786743164,8.987486839294434,33,17
1069,128,2.4542688723876327,5.461810973459904,1.010753751745792,1.0564806359605123,64,109,15.153216361999512,8.987486839294434,64,19
1070,1,10.72628201701715,10.72628201701715,0.9157775280824549,0.915777528082455,0,0,11.011661529541016,11.011661529541016,1,1
1070,2,8.935584592344714,8.935584592344718,0.97661750780013,0.9766175078001305,0,0,13.467854499816895,11.011661529541016,2,2
1070,3,8.554186375776569,8.554186375776569,0.9909656789023937,0.9909656789023935,0,0,13.488933563232422,11.011661529541016,3,3
1070,4,8.030962103062778,8.030962103062778,1.0086526777595597,1.0086526777595595,0,0,13.520965576171875,11.011661529541016,4,4
1070,8,7.642321167185257,7.686125325954144,1.0159573352896014,1.0172473841859353,1,1,14.18660831451416,11.011661529541016,7,7
1070,16,7.244539561036809,7.5151406135525,1.0232230775747808,1.0256356842543197,5,6,14.74935245513916,11.011661529541016,11,10
1070,32,6.110085223049838,7.300011119969004,1.0398315271391312,1.0376835298244147,12,18,15.448728561401367,11.011661529541016,20,14
1070,64,4.972706380654421,7.130042255350801,1.03119228905359,1.048524575903871,26,47,16.163110733032227,11.011661529541016,38,17
1070,128,2.9687907583221604,7.028836844741897,1.008937553272713,1.0534455363786488,63,113,16.966760635375977,11.011661529541016,65,15
1071,1,6.900910776069283,6.90091077606925,0.9806643253865902,0.980664325386592,0,0,6.925934314727783,6.925934314727783,1,1
1071,2,5.834031699670197,5.834031699670196,0.9942167982241379,0.9942167982241373,0,0,7.088759899139404,6.925934314727783,2,2
1071,3,4.585592143367029,4.585592143367029,1.008473938643343,1.0084739386433426,0,0,7.098415851593018,6.925934314727783,3,3
1071,4,4.325516437268624,4.325516437268625,1.0114925019002934,1.0114925019002927,0,0,7.139106273651123,6.925934314727783,4,4
1071,8,4.012720214118431,4.065729815549891,1.0149412674867277,1.0148660362056594,2,2,7.552940368652344,6.925934314727783,6,6
1071,16,3.713613271583779,3.766121984703546,1.0181037364693486,1.0190122393489744,4,6,8.221583366394043,6.925934314727783,12,10
1071,32,3.062082337851004,3.713850221740661,1.0168211999438033,1.021768446683496,14,19,8.60575008392334,6.925934314727783,18,13
1071,64,2.1492877848398355,3.67209245084577,1.0089708519874623,1.0227651713092216,33,48,9.02262020111084,6.925934314727783,31,16
1071,128,1.3050226845212238,3.6507194953133992,1.0039914596469255,1.0244581932836063,63,107,9.595681190490723,6.925934314727783,65,21
1072,1,9.205986144067813,9.205986144067813,0.9548770566687513,0.9548770566687518,0,0,9.306595802307129,9.306595802307129,1,1
1072,2,8.309077709328156,8.309077709328154,0.9738063482627133,0.9738063482627132,0,0,9.345412254333496,9.306595802307129,2,2
1072,3,7.5590197090319045,7.559019709031905,0.9841072358997127,0.984107235899713,0,0,9.850045204162598,9.306595802307129,3,3
1072,4,6.849464415950861,6.849464415950861,0.9949491704802143,0.9949491704802147,0,0,9.863369941711426,9.306595802307129,4,4
1072,8,6.481027982544348,6.495893271380007,1.0030998534716957,1.0030920491447042,2,2,10.144715309143066,9.306595802307129,6,6
1072,16,6.169486598131022,6.232943296109528,1.008970977490605,1.0086293698731252,5,7,10.425399780273438,9.306595802307129,11,9
1072,32,5.293583128491029,5.843025021865918,1.020098227339552,1.0194311436769363,11,20,10.952838897705078,9.306595802307129,21,12
1072,64,3.7011396528005336,5.695284682132932,1.0115796197980187,1.026613432867797,29,49,11.515316009521484,9.306595802307129,35,15
1072,128,1.7380209160683409,5.589024356724237,1.0043583391672635,1.0315266094042554,59,111,12.280014038085938,9.306595802307129,69,17
1073,1,11.171734063097366,11.17173406309737,0.9245135021896419,0.9245135021896442,0,0,11.397028923034668,11.397028923034668,1,1
1073,2,9.51757025149713,9.51757025149712,0.9708529073646393,0.9708529073646415,0,0,12.34337043762207,11.397028923034668,2,2
1073,3,8.009406261854727,8.009406261854727,1.004370337462675,1.0043703374626762,0,0,12.38924503326416,11.397028923034668,3,3
1073,4,7.996375437961493,7.996375437961493,1.005560042262519,1.0055600422625204,0,0,13.170527458190918,11.397028923034668,4,4
1073,8,7.864847109901733,7.990140843824636,1.0022857676882249,1.006379590322399,2,2,13.809453010559082,11.397028923034668,6,6
1073,16,7.536784580416546,7.8826618575053535,1.0111954802855012,1.0134918022046822,8,9,14.415803909301758,11.397028923034668,8,7
1073,32,6.695329751017936,7.613911745679686,1.0303285084043867,1.0286189242194304,15,22,14.977533340454102,11.397028923034668,17,10
1073,64,4.895477816839704,7.607997983697581,1.0191735451606425,1.0302967542161354,29,51,15.803165435791016,11.397028923034668,35,13
1073,128,3.713449095824223,7.491399334603508,1.0155670912755699,1.038124222722819,60,114,16.34977912902832,11.397028923034668,68,14
1074,1,11.204133159714466,11.204133159714427,0.9193267179286989,0.9193267179287026,0,0,11.446619987487793,11.446619987487793,1,1
1074,2,10.2264829010765,10.226482901076505,0.9489691986485773,0.9489691986485798,0,0,12.309989929199219,11.446619987487793,2,2
1074,3,8.951000662668738,8.951000662668742,0.9828363506139184,0.9828363506139208,0,0,12.457653045654297,11.446619987487793,3,3
1074,4,8.851594267350764,8.851594267350766,0.9873718383517592,0.9873718383517622,0,0,12.686810493469238,11.446619987487793,4,4
1074,8,8.043983770368227,8.084921970333049,1.0092915583967912,1.0086955320970916,1,1,13.352537155151367,11.446619987487793,7,7
1074,16,7.137474824264514,7.537180992778915,1.0291040515218493,1.0221516271544557,6,8,13.747601509094238,11.446619987487793,10,8
1074,32,6.247394668609507,7.326251614857605,1.0352890013873648,1.0303184742927398,13,22,14.126699447631836,11.446619987487793,19,10
1074,64,4.6394899537506635,7.181533263022738,1.0311249011647243,1.0362185572231208,30,52,14.783212661743164,11.446619987487793,34,12
1074,128,2.9761611703812503,7.071702933225227,1.0160625378168784,1.0437487173801872,59,113,15.365025520324707,11.446619987487793,69,15
1075,1,2.176278852881914,2.176278852881914,0.9947538499702557,0.9947538499702542,0,0,2.1824281215667725,2.1824281215667725,1,1
1075,2,1.9057414843879972,1.9057414843879958,0.9973812790652921,0.9973812790652906,0,0,2.5190799236297607,2.1824281215667725,2,2
1075,3,1.5857047800862736,1.585704780086284,0.999326413500031,0.9993264135000293,0,0,2.5209479331970215,2.1824281215667725,3,3
1075,4,1.332976669159651,1.3329766691596512,0.9994782818650634,0.9994782818650634,0,0,2.675661563873291,2.1824281215667725,4,4
1075,8,1.1694539054369828,1.191423301030727,0.9995359408642344,1.00016741728979,1,1,3.1564855575561523,2.1824281215667725,7,7
1075,16,0.9237417480068602,1.0014787378081307,1.0010794282121052,1.002003349882688,6,7,3.7087535858154297,2.1824281215667725,10,9
1075,32,0.6609898036047573,0.840048838955329,1.0021136595704025,1.0023326378350692,14,20,4.13317346572876,2.1824281215667725,18,12
1075,64,0.34799028462521375,0.8362382137491051,1.0006539628369868,1.0023899388738713,28,52,4.59191370010376,2.1824281215667725,36,12
1075,128,0.01857479027089871,0.8126433696174008,1.0000159083124214,1.002881386075966,67,114,5.14546537399292,2.1824281215667725,61,14
1076,1,9.998109215525828,9.998109215525785,0.935836780010726,0.9358367800107277,0,0,10.180347442626953,10.180347442626953,1,1
1076,2,8.409046545968156,8.409046545968156,0.9714723186769133,0.9714723186769139,0,0,10.30043888092041,10.180347442626953,2,2
1076,3,8.016395181277773,8.016395181277773,0.9818813975842995,0.9818813975843006,0,0,10.359175682067871,10.180347442626953,3,3
1076,4,7.787599655992932,7.787599655992931,0.9860223805202876,0.9860223805202873,0,0,10.398377418518066,10.180347442626953,4,4
1076,8,6.19409909305144,6.332669462736828,1.0157108254229554,1.014733505981173,2,2,11.254321098327637,10.180347442626953,6,6
1076,16,5.923131132253346,5.994057780750072,1.026048295499244,1.0247916686729588,5,6,12.049327850341797,10.180347442626953,11,10
1076,32,5.18525654884322,5.752391456162977,1.0221436242849493,1.0314141058159818,14,19,13.147784233093262,10.180347442626953,18,13
1076,64,3.732409135099328,5.6050814068039285,1.014185973404505,1.0383300298468763,31,51,14.039252281188965,10.180347442626953,33,13
1076,128,2.6419417381712282,5.593919387405193,1.0127715727867008,1.0406658012302163,60,112,14.759300231933594,10.180347442626953,68,16
1077,1,6.164076704820069,6.164076704820069,0.9785682527905651,0.9785682527905651,0,0,6.198651313781738,6.198651313781738,1,1
1077,2,5.504716012396523,5.504716012396523,0.98877004641637,0.9887700464163693,0,0,6.535464286804199,6.198651313781738,2,2
1077,3,5.004193255348753,5.004193255348754,0.9977137861321386,0.9977137861321387,0,0,7.295266628265381,6.198651313781738,3,3
1077,4,4.436080835762809,4.4360808357628105,1.006090184683885,1.0060901846838832,0,0,7.411494255065918,6.198651313781738,4,4
1077,8,3.7565183288337765,3.7565183288337765,1.0127844834594133,1.0127844834594133,0,0,8.026446342468262,6.198651313781738,8,8
1077,16,3.7085206272941162,3.740045629589232,1.0122496960458354,1.0137529234214882,4,5,8.369368553161621,6.198651313781738,12,11
1077,32,3.272953591120155,3.546493876358688,1.0134012932693397,1.0179056178465409,15,20,8.791603088378906,6.198651313781738,17,12
1077,64,2.5551818902629413,3.506543031259353,1.007805923711531,1.0203590630336852,29,49,9.300395011901855,6.198651313781738,35,15
1077,128,1.3451282839337775,3.446051270118835,1.0018905625527172,1.0220098764699534,62,109,9.83324909210205,6.198651313781738,66,19
1078,1,6.948552062330445,6.94855206233045,0.9643486323016672,0.964348632301669,0,0,7.032222270965576,7.032222270965576,1,1
1078,2,5.908338488141633,5.908338488141634,0.9891349263470145,0.9891349263470146,0,0,8.640273094177246,7.032222270965576,2,2
1078,3,5.809317764728405,5.809317764728406,0.9924528776314715,0.9924528776314716,0,0,8.97169017791748,7.032222270965576,3,3
1078,4,5.47582949284331,5.47582949284331,0.998313898691619,0.9983138986916202,0,0,9.033978462219238,7.032222270965576,4,4
1078,8,5.09376040935868,5.417874187081422,1.0002457637744453,1.000559103392182,2,2,9.515573501586914,7.032222270965576,6,6
1078,16,4.909180689015113,5.316032565703982,1.0026657780408588,1.0053321199276577,5,7,10.065610885620117,7.032222270965576,11,9
1078,32,4.343911238813045,5.272939531791009,1.0051841731951576,1.0064581131694676,14,22,10.645881652832031,7.032222270965576,18,10
1078,64,3.252636109424394,5.178292243866301,1.0094964633337247,1.0129758386173542,28,52,11.343626022338867,7.032222270965576,36,12
1078,128,1.7883647688424191,4.99258633255922,1.002812117312076,1.0169206245085214,62,116,12.09492301940918,7.032222270965576,66,12
1079,1,9.916523167067515,9.91652316706752,0.9409036018990995,0.9409036018991024,0,0,10.069989204406738,10.069989204406738,1,1
1079,2,9.083613724875374,9.083613724875372,0.9633697771736842,0.9633697771736851,0,0,10.159171104431152,10.069989204406738,2,2
1079,3,8.478221953869193,8.478221953869191,0.9762002639546677,0.9762002639546683,0,0,10.255001068115234,10.069989204406738,3,3
1079,4,8.409359000565619,8.40935900056562,0.9780941734204367,0.9780941734204386,0,0,10.433321952819824,10.069989204406738,4,4
1079,8,7.603814353931088,7.6306685386474,0.9975859171045403,0.9976326589672352,2,2,11.457483291625977,10.069989204406738,6,6
1079,16,6.367619628926585,6.684896256346598,1.0254030892750277,1.0214054996147375,2,6,12.075590133666992,10.069989204406738,14,10
1079,32,5.8784108829887565,6.501914170013796,1.0312997706743945,1.0292365067632507,10,18,12.735137939453125,10.069989204406738,22,14
1079,64,4.547233513516005,6.376856710053329,1.0215907503080146,1.036907270453574,28,47,13.260273933410645,10.069989204406738,36,17
1079,128,2.4316202121806976,6.297050854927561,1.0040823751334735,1.0421730016867081,63,108,13.865538597106934,10.069989204406738,65,20
1080,1,6.880967744242822,6.880967744242823,0.9769039333800178,0.9769039333800185,0,0,6.916169166564941,6.916169166564941,1,1
1080,2,5.826540457926117,5.826540457926116,0.9913933367928953,0.9913933367928953,0,0,7.499444484710693,6.916169166564941,2,2
1080,3,5.057352532489013,5.057352532489013,1.0029958539197212,1.0029958539197228,0,0,7.625420093536377,6.916169166564941,3,3
1080,4,4.63058633388693,4.630586333886928,1.0098049380739815,1.0098049380739833,0,0,7.641948699951172,6.916169166564941,4,4
1080,8,4.599812904279164,4.603137400388566,1.0108162958154692,1.0108555556070715,2,2,8.043353080749512,6.916169166564941,6,6
1080,16,3.953300932972349,3.9882975251026083,1.0210911259266824,1.020673775808766,4,3,8.628521919250488,6.916169166564941,12,13
1080,32,3.649613578950686,3.920061235994451,1.021896335153179,1.023315500372072,13,16,8.963783264160156,6.916169166564941,19,16
1080,64,2.517786509666457,3.876293672911212,1.0116727373784349,1.0245625833622114,31,47,9.53940486907959,6.916169166564941,33,17
1080,128,1.6168184459670099,3.826532865317026,1.0047535032874206,1.026460348591482,64,109,10.175825119018555,6.916169166564941,64,19
1081,1,7.392723591676321,7.392723591676321,0.9730412810402217,0.9730412810402226,0,0,7.437576770782471,7.437576770782471,1,1
1081,2,5.67354693171958,5.67354693171958,1.0014958022956628,1.0014958022956633,0,0,7.830389499664307,7.437576770782471,2,2
1081,3,5.54290200676456,5.542902006764559,1.0035193160590912,1.0035193160590916,0,0,7.917674541473389,7.437576770782471,3,3
1081,4,5.212786666948252,5.212786666948251,1.0065982693212512,1.0065982693212525,0,0,8.14646053314209,7.437576770782471,4,4
1081,8,4.930001604088835,4.965027885817604,1.011210588428214,1.011060056607928,2,2,8.394661903381348,7.437576770782471,6,6
1081,16,4.050228103939325,4.465815755530344,1.0213970390517346,1.0204836911760018,4,9,9.081461906433105,7.437576770782471,12,7
1081,32,3.51158658621418,4.394819123330526,1.0184944834380925,1.0224743225924597,11,20,9.462106704711914,7.437576770782471,21,12
1081,64,2.4697901915464215,4.2912407510406565,1.0068505037536477,1.0244960923711184,30,52,10.091056823730469,7.437576770782471,34,12
1081,128,1.045453754827571,4.28953458012708,1.0011818895323306,1.0247655373662028,67,114,10.874305725097656,7.437576770782471,61,14
1082,1,9.677431199346923,9.67743119934691,0.9422177462126917,0.9422177462126933,0,0,9.835378646850586,9.835378646850586,1,1
1082,2,7.6491701627212025,7.649170162721203,0.9828834400497329,0.9828834400497339,0,0,10.000077247619629,9.835378646850586,2,2
1082,3,6.908119425367683,6.9081194253676825,0.9988743586914126,0.9988743586914134,0,0,10.175447463989258,9.835378646850586,3,3
1082,4,6.796639288988496,6.796639288988496,1.0008038942573767,1.0008038942573778,0,0,10.26626968383789,9.835378646850586,4,4
1082,8,6.019360720628136,6.019360720628132,1.0175921810639252,1.0175921810639266,0,0,10.502918243408203,9.835378646850586,8,8
1082,16,5.665686991824818,5.725207409297002,1.028460591962061,1.027632128331558,4,3,11.473892211914062,9.835378646850586,12,13
1082,32,4.76455187815386,5.722781770270853,1.0214904932016637,1.0281140921216538,14,17,11.954514503479004,9.835378646850586,18,15
1082,64,3.5275509682175525,5.681072939744822,1.0162930928455558,1.031744777178363,29,45,12.350008010864258,9.835378646850586,35,19
1082,128,2.111141755790455,5.491975020550536,1.0056105627091552,1.0382931438991436,62,107,12.856599807739258,9.835378646850586,66,21
1083,1,2.623965461138359,2.623965461138361,0.994890200798732,0.9948902007987335,0,0,2.6287336349487305,2.6287336349487305,1,1
1083,2,2.459559250509055,2.4595592505090558,0.9963547153921752,0.9963547153921766,0,0,2.925766944885254,2.6287336349487305,2,2
1083,3,1.9267459239762108,1.9267459239762112,0.9989032251625394,0.9989032251625405,0,0,2.962573289871216,2.6287336349487305,3,3
1083,4,1.8739138514670173,1.8739138514670168,0.9994488650161146,0.9994488650161157,0,0,2.971013307571411,2.6287336349487305,4,4
1083,8,1.6035441588939117,1.6067855740396764,1.0008168522282106,1.0008597996997293,2,1,3.32175874710083,2.6287336349487305,6,7
1083,16,1.3991629872691078,1.4814516977277072,1.0018900102846848,1.0020114966874476,7,8,3.6756441593170166,2.6287336349487305,9,8
1083,32,1.0688226189512597,1.4806028599334897,1.0001454326232933,1.002021787681045,14,23,4.096550941467285,2.6287336349487305,18,9
1083,64,0.5135304178525715,1.4345490727914443,1.000629866572881,1.0029877165831655,35,55,4.518301486968994,2.6287336349487305,29,9
1083,128,0.02591155947149101,1.394705611052895,0.999992087717406,1.0041660412739466,62,112,5.090698719024658,2.6287336349487305,66,16
1084,1,7.893866699359397,7.893866699359397,0.9662681049605323,0.9662681049605334,0,0,7.956507682800293,7.956507682800293,1,1
1084,2,6.797746197324468,6.797746197324468,0.9873501568904346,0.9873501568904339,0,0,8.099553108215332,7.956507682800293,2,2
1084,3,5.919582971022049,5.919582971022048,1.002453699010943,1.002453699010942,0,0,8.604026794433594,7.956507682800293,3,3
1084,4,5.660440834521981,5.660440834521982,1.0068404247434142,1.006840424743412,0,0,8.617664337158203,7.956507682800293,4,4
1084,8,5.2854894165717,5.473517315722383,1.011814588873502,1.0110040430700553,2,3,9.331989288330078,7.956507682800293,6,5
1084,16,4.253542916438773,4.541493387654237,1.0252237155546542,1.0281191141916004,6,8,10.002007484436035,7.956507682800293,10,8
1084,32,3.678098022405826,4.224741699849021,1.0294214756819706,1.03609655778827,11,16,10.882953643798828,7.956507682800293,21,16
1084,64,2.569164941570107,4.1422327441694575,1.0128796672953209,1.0409952531307356,30,44,11.88875961303711,7.956507682800293,34,20
1084,128,1.5384304628916505,4.125284358270076,1.0030739098000843,1.0424029095598413,66,107,12.899397850036621,7.956507682800293,62,21
1085,1,7.0933081881418625,7.0933081881418625,0.9706734807078281,0.9706734807078278,0,0,7.147584915161133,7.147584915161133,1,1
1085,2,6.373097633691176,6.373097633691176,0.9859919974004558,0.985991997400455,0,0,8.502473831176758,7.147584915161133,2,2
1085,3,5.6434832684326315,5.6434832684326315,0.9964679168136693,0.9964679168136688,0,0,8.648656845092773,7.147584915161133,3,3
1085,4,5.612273626527047,5.612273626527047,0.9974601781149792,0.9974601781149786,0,0,8.713251113891602,7.147584915161133,4,4
1085,8,5.122188547546483,5.139314403787786,1.0082112788226405,1.0079646545453769,2,2,8.989855766296387,7.147584915161133,6,6
1085,16,4.678479492335357,4.9470077804311625,1.01229070830549,1.0123205089532368,4,7,9.463597297668457,7.147584915161133,12,9
1085,32,3.589395842024129,4.797667023338665,1.0088593861077404,1.0145619857319206,15,19,9.97649097442627,7.147584915161133,17,13
1085,64,2.5599497143180256,4.500400373598876,1.0095418081568936,1.0229224111016886,28,48,10.627391815185547,7.147584915161133,36,16
1085,128,1.3255300587295702,4.49719746157605,1.0029531395863391,1.0233072620575376,58,109,11.27889347076416,7.147584915161133,70,19
1086,1,7.683497782860219,7.683497782860224,0.963909753812048,0.9639097538120499,0,0,7.759772300720215,7.759772300720215,1,1
1086,2,7.195186739198898,7.195186739198903,0.9750759423870563,0.9750759423870585,0,0,8.38132381439209,7.759772300720215,2,2
1086,3,6.6530603320438395,6.653060332043841,0.9859795651427545,0.9859795651427563,0,0,8.575387954711914,7.759772300720215,3,3
1086,4,5.551783410057765,5.551783410057765,1.0025108057121417,1.0025108057121428,0,0,8.76301097869873,7.759772300720215,4,4
1086,8,5.11519247825571,5.272171941700018,1.0086653897209263,1.0077745437213312,3,3,9.09110164642334,7.759772300720215,5,5
1086,16,4.719223652454517,5.1402699778892424,1.0073460661734321,1.0098903795489291,7,10,9.672591209411621,7.759772300720215,9,6
1086,32,4.024619561386087,5.013194958532993,1.0093290300414688,1.0156092319490264,13,22,10.316605567932129,7.759772300720215,19,10
1086,64,2.9458728605360136,4.930125854493531,1.0085133867306655,1.0196187914239272,31,49,10.825835227966309,7.759772300720215,33,15
1086,128,1.555185585031849,4.714858664031643,1.001490159074019,1.0253341162528717,57,115,11.53283405303955,7.759772300720215,71,13
1087,1,7.488105823151706,7.488105823151709,0.9663918228185536,0.9663918228185548,0,0,7.556563854217529,7.556563854217529,1,1
1087,2,6.497505790739702,6.497505790739702,0.9873448058239145,0.9873448058239156,0,0,9.374359130859375,7.556563854217529,2,2
1087,3,5.881992194735159,5.881992194735158,1.0031488603604717,1.003148860360471,0,0,9.61025619506836,7.556563854217529,3,3
1087,4,5.86540492410577,5.86540492410577,1.0042231869268683,1.004223186926868,0,0,9.695261001586914,7.556563854217529,4,4
1087,8,5.613048673567968,5.689248466874209,1.0075129716164757,1.0080578842170695,2,2,10.107026100158691,7.556563854217529,6,6
1087,16,5.159893921976322,5.524461566774775,1.012782376177778,1.0114264569714357,6,6,10.685166358947754,7.556563854217529,10,10
1087,32,4.392464235001788,5.4708762831261675,1.0160527916303885,1.014039382093757,14,19,11.2511625289917,7.556563854217529,18,13
1087,64,3.4086399647034935,5.348844448398258,1.0099025610794068,1.0195427259268528,33,49,11.818360328674316,7.556563854217529,31,15
1087,128,1.9519347945767445,5.182327158398733,1.0017148161872709,1.0270240479675312,65,107,12.598645210266113,7.556563854217529,63,21
1088,1,7.901164217904478,7.901164217904481,0.9633121418984146,0.9633121418984156,0,0,7.977602958679199,7.977602958679199,1,1
1088,2,5.872991738443092,5.872991738443093,0.9972537872462748,0.997253787246275,0,0,8.200974464416504,7.977602958679199,2,2
1088,3,5.856215704629854,5.856215704629854,0.9979178393102709,0.9979178393102716,0,0,8.795629501342773,7.977602958679199,3,3
1088,4,5.751062297691722,5.751062297691722,0.9999569799950351,0.9999569799950354,0,0,8.795913696289062,7.977602958679199,4,4
1088,8,5.321276018349049,5.363486396070828,1.007656317662667,1.0073624493967268,1,1,9.047221183776855,7.977602958679199,7,7
1088,16,4.521460316002888,4.795059644641771,1.021399233324766,1.0186739555387776,3,5,9.621935844421387,7.977602958679199,13,11
1088,32,3.8548078324492807,4.7155456822402595,1.0145735677702743,1.0205397815041515,16,21,9.899394989013672,7.977602958679199,16,11
1088,64,2.993552775387426,4.667688840409861,1.0093311549856159,1.021665602960049,34,52,10.430502891540527,7.977602958679199,30,12
1088,128,1.7300268258967038,4.640218880884191,1.0031626059914944,1.022551558052005,64,116,11.022146224975586,7.977602958679199,64,12
1089,1,9.385652041978656,9.38565204197866,0.9491900841398195,0.9491900841398215,0,0,9.507914543151855,9.507914543151855,1,1
1089,2,7.804280270893083,7.804280270893085,0.9852962926146296,0.9852962926146305,0,0,10.645146369934082,9.507914543151855,2,2
1089,3,7.652552508456176,7.652552508456176,0.9886895899493867,0.9886895899493882,0,0,10.69674301147461,9.507914543151855,3,3
1089,4,7.209867468404605,7.209997096771919,0.999791194108637,0.9997744893610068,1,1,10.885342597961426,9.507914543151855,3,3
1089,8,6.315588311696661,6.358437007158608,1.0178779833115827,1.0172056772803095,2,2,11.339832305908203,9.507914543151855,6,6
1089,16,5.607717004427012,5.761850247019804,1.0332684786243616,1.0325868207682594,3,4,11.856130599975586,9.507914543151855,13,12
1089,32,5.036722531942024,5.69443710449464,1.0244521487610496,1.0358049419297515,14,19,12.586841583251953,9.507914543151855,18,13
1089,64,3.7114888388404355,5.473099195500787,1.0166151896088886,1.042195175703543,31,44,13.14793586730957,9.507914543151855,33,20
1089,128,2.059169639424324,5.453945017902422,1.0028475594586432,1.0437484844888771,59,110,13.770668983459473,9.507914543151855,69,18
1090,1,6.251676494616762,6.251676494616752,0.9798294212574699,0.9798294212574709,0,0,6.280979156494141,6.280979156494141,1,1
1090,2,5.758697832843942,5.758697832843942,0.9900311300158,0.9900311300158009,0,0,7.588854789733887,6.280979156494141,2,2
1090,3,5.7519273547068455,5.751927354706847,0.9903283914321808,0.9903283914321807,0,0,7.634964466094971,6.280979156494141,3,3
1090,4,5.531661008380829,5.532029136717196,0.994780949594498,0.9948088580980534,1,1,7.794109344482422,6.280979156494141,3,3
1090,8,5.1764741034409605,5.347424818010533,1.0000861158299763,1.0002498638022113,3,3,7.917356014251709,6.280979156494141,5,5
1090,16,4.1562632357025935,4.5380244025739245,1.0115485687263683,1.0126655534466138,4,8,8.649518013000488,6.280979156494141,12,8
1090,32,3.1637226618669216,4.296379361173,1.0117306601534868,1.0178616374706613,14,20,9.277031898498535,6.280979156494141,18,12
1090,64,2.323599653658491,4.228748875735424,1.003841643255721,1.0205015968682738,30,49,10.199116706848145,6.280979156494141,34,15
1090,128,1.321089042008954,4.209178000942664,1.0024020635320605,1.0215468160161023,66,116,10.913137435913086,6.280979156494141,62,12
1091,1,7.649440108799269,7.649440108799274,0.9595835177060211,0.9595835177060233,0,0,7.74707555770874,7.74707555770874,1,1
1091,2,6.89021790097275,6.890217900972751,0.9695441536190903,0.9695441536190911,0,0,7.924804210662842,7.74707555770874,2,2
1091,3,6.200998385050918,6.200998385050918,0.9855581724637184,0.9855581724637186,0,0,8.997896194458008,7.74707555770874,3,3
1091,4,5.119646160963099,5.119646160963099,1.0043620893553065,1.0043620893553058,0,0,9.09788703918457,7.74707555770874,4,4
1091,8,5.0711927509257055,5.073791884342899,1.0065004562892768,1.0067533438453504,2,2,9.432065963745117,7.74707555770874,6,6
1091,16,4.3541228190552275,4.815492532539964,1.0104351417695046,1.0127078571881354,5,9,10.389426231384277,7.74707555770874,11,7
1091,32,3.652594095432822,4.804820864403736,1.0072774549510468,1.0137304937509632,16,23,10.965394020080566,7.74707555770874,16,9
1091,64,2.920846209532806,4.798173624291639,1.004117636628769,1.0145209336644903,32,53,11.993553161621094,7.74707555770874,32,11
1091,128,2.0557633898564283,4.798173624291639,0.9999599054758828,1.0145209336644907,59,117,12.777032852172852,7.74707555770874,69,11
1092,1,8.460855261520196,8.460855261520196,0.9632031687395844,0.9632031687395848,0,0,8.533729553222656,8.533729553222656,1,1
1092,2,7.577058439128359,7.577058439128362,0.9789953611968127,0.9789953611968142,0,0,9.167278289794922,8.533729553222656,2,2
1092,3,7.540091030273009,7.540091030273012,0.9804426314421649,0.9804426314421665,0,0,10.0592622756958,8.533729553222656,3,3
1092,4,7.457648018869386,7.4576480188693886,0.9832787951454534,0.9832787951454547,0,0,10.629307746887207,8.533729553222656,4,4
1092,8,6.728476307415605,6.75625451091211,1.0039448393540973,1.0035619019572999,1,1,11.091104507446289,8.533729553222656,7,7
1092,16,6.116184249112723,6.528261921023846,1.002197042149763,1.0103878630656145,8,7,11.895578384399414,8.533729553222656,8,9
1092,32,5.168270742662333,6.323070599650264,1.010521663879165,1.0182981687675685,13,20,12.27304744720459,8.533729553222656,19,12
1092,64,3.6793036560074857,6.10015341486091,1.0056466952387588,1.026968249772755,29,50,12.679107666015625,8.533729553222656,35,14
1092,128,2.0135852139245323,5.82020989751463,1.0016590624226995,1.0379405459014994,64,111,13.088016510009766,8.533729553222656,64,17
1093,1,9.195358355992376,9.195358355992381,0.950982726576717,0.9509827265767188,0,0,9.311647415161133,9.311647415161133,1,1
1093,2,7.368068049465527,7.368068049465527,0.9888343470217209,0.9888343470217227,0,0,9.577597618103027,9.311647415161133,2,2
1093,3,6.065640356506041,6.06564035650604,1.010372082953575,1.0103720829535754,0,0,9.667110443115234,9.311647415161133,3,3
1093,4,5.918910553577861,5.91891055357786,1.013388948841764,1.0133889488417642,0,0,9.982619285583496,9.311647415161133,4,4
1093,8,5.453162122893923,5.453162122893923,1.020309849346394,1.0203098493463938,0,0,10.280609130859375,9.311647415161133,8,8
1093,16,5.347413021258358,5.403149361913419,1.0214120274828966,1.0221476213372975,4,3,10.62684154510498,9.311647415161133,12,13
1093,32,4.490062595026697,5.186147978179293,1.0212447439450982,1.0282444567959659,15,20,11.195670127868652,9.311647415161133,17,12
1093,64,3.747032191739425,5.133646237610214,1.014406708953524,1.0312763485276677,31,48,11.815095901489258,9.311647415161133,33,16
1093,128,2.0097948864998534,4.946655989600354,1.003844766377695,1.0370925110412077,66,111,12.482218742370605,9.311647415161133,62,17
1094,1,6.136156868592834,6.136156868592838,0.9763113983325091,0.9763113983325127,0,0,6.177164554595947,6.177164554595947,1,1
1094,2,5.410349100954291,5.410349100954293,0.9906386151733433,0.9906386151733462,0,0,7.392548084259033,6.177164554595947,2,2
1094,3,5.238050658653447,5.238050658653448,0.9923136277504638,0.9923136277504662,0,0,7.52626371383667,6.177164554595947,3,3
1094,4,4.683066066514241,4.683066066514241,1.0011345338416355,1.001134533841637,0,0,7.640017986297607,6.177164554595947,4,4
1094,8,4.311440533723958,4.3114405337239665,1.0103952315588196,1.0103952315588203,0,0,8.32438850402832,6.177164554595947,8,8
1094,16,3.555848120141243,4.138298241623261,1.013013713501699,1.013173369155077,5,7,8.899282455444336,6.177164554595947,11,9
1094,32,2.82497531718358,3.8994733173120752,1.0097346371109936,1.0156962008435275,12,22,9.645344734191895,6.177164554595947,20,10
1094,64,2.36986505068485,3.790642134779257,1.0105236643619004,1.0201676190324878,32,51,10.592119216918945,6.177164554595947,32,13
1094,128,1.4275374399330047,3.769828767722239,0.9996425272014824,1.0222670690325555,63,112,11.546205520629883,6.177164554595947,65,16
1095,1,7.39727853397522,7.397278533975221,0.9688662143868689,0.9688662143868707,0,0,7.45782995223999,7.45782995223999,1,1
1095,2,5.904092684822586,5.904092684822585,0.9966952728886207,0.9966952728886214,0,0,7.767312526702881,7.45782995223999,2,2
1095,3,5.555550795647795,5.555550795647795,1.0031929291445003,1.0031929291445003,0,0,8.48311710357666,7.45782995223999,3,3
1095,4,4.857136748211432,4.857136748211432,1.0162825371821462,1.016282537182147,0,0,8.605433464050293,7.45782995223999,4,4
1095,8,4.541092473346567,4.580418298866271,1.0192940179512702,1.020490699960389,3,2,9.152678489685059,7.45782995223999,5,6
1095,16,4.133817067877854,4.47950010779232,1.0206143045539298,1.025218950435578,6,8,9.626172065734863,7.45782995223999,10,8
1095,32,3.7996345041962005,4.352160426561141,1.021109214884152,1.027505649694412,13,20,10.496113777160645,7.45782995223999,19,12
1095,64,3.008129307652885,4.3199947591840555,1.012602235482603,1.0290325945277292,34,49,11.00682544708252,7.45782995223999,30,15
1095,128,1.7282452218666806,4.307581135772631,1.0036365674052734,1.0305593478296213,58,114,12.050976753234863,7.45782995223999,70,14
1096,1,8.56764755368166,8.567647553681665,0.9629651680098026,0.9629651680098048,0,0,8.639165878295898,8.639165878295898,1,1
1096,2,7.268593733275752,7.268593733275756,0.9844662780333274,0.9844662780333286,0,0,9.091217041015625,8.639165878295898,2,2
1096,3,6.982786452455717,6.982786452455717,0.9891211223373699,0.9891211223373708,0,0,9.09583568572998,8.639165878295898,3,3
1096,4,6.960681235807651,6.960681235807652,0.990125831546554,0.9901258315465546,0,0,10.204691886901855,8.639165878295898,4,4
1096,8,5.866626308279524,5.891215130949902,1.0181704721623286,1.019200031387617,1,1,10.798831939697266,8.639165878295898,7,7
1096,16,5.31757601640807,5.5127118395311046,1.0286712576266885,1.0315929583091554,3,5,12.174707412719727,8.639165878295898,13,11
1096,32,4.418987932461488,5.497142169886538,1.0243673548123846,1.0334778298840892,10,17,12.875225067138672,8.639165878295898,22,15
1096,64,2.867268172437491,5.450870293714532,1.0040282662426074,1.0344499687085875,33,50,13.470096588134766,8.639165878295898,31,14
1096,128,1.803433025541289,5.4327228468501145,0.9999695335693048,1.0367287497072257,62,111,14.113618850708008,8.639165878295898,66,17
1097,1,3.1055131474928563,3.105513147492857,0.9939806955811346,0.993980695581135,0,0,3.1111485958099365,3.1111485958099365,1,1
1097,2,2.406975182147892,2.406975182147892,0.9991602941973657,0.9991602941973659,0,0,3.4597933292388916,3.1111485958099365,2,2
1097,3,2.046076099340856,2.046076099340856,1.0012732078993702,1.0012732078993702,0,0,3.4603092670440674,3.1111485958099365,3,3
1097,4,2.003449923356086,2.003449923356086,1.0011371071713913,1.0011371071713921,0,0,3.5997307300567627,3.1111485958099365,4,4
1097,8,1.5119303174280052,1.5126342158229729,1.0034185693113287,1.0034574647800127,1,2,3.954531669616699,3.1111485958099365,7,6
1097,16,1.3545574615534233,1.5023331872273678,1.0039524543138787,1.0039660277150748,5,8,4.46075963973999,3.1111485958099365,11,8
1097,32,1.046190202904354,1.4570620418063047,1.0031272041482047,1.0051159684664435,12,21,4.705104351043701,3.1111485958099365,20,11
1097,64,0.6812359935234195,1.450847802295746,1.000906272670159,1.0053345654141395,32,50,5.08554744720459,3.1111485958099365,32,14
1097,128,0.03657154820432579,1.4381364210365832,0.9999849985659066,1.0055517235853606,65,111,5.569210529327393,3.1111485958099365,63,17
1098,1,7.735937492190074,7.735937492190071,0.9575894039558698,0.957589403955871,0,0,7.841360092163086,7.841360092163086,1,1
1098,2,6.565761804085134,6.565761804085132,0.9805380248512567,0.9805380248512563,0,0,7.937609672546387,7.841360092163086,2,2
1098,3,6.173048117020323,6.173048117020324,0.988931488176152,0.9889314881761528,0,0,7.978639125823975,7.841360092163086,3,3
1098,4,5.446279019485885,5.446279019485885,0.9992837651824995,0.9992837651824997,0,0,8.157257080078125,7.841360092163086,4,4
1098,8,4.971828159076917,5.026285980476134,1.0074125929436355,1.0059282145492203,2,2,8.57126235961914,7.841360092163086,6,6
1098,16,4.191208513513035,4.260021668113252,1.0205652380786439,1.018434099802504,2,6,9.107851028442383,7.841360092163086,14,10
1098,32,3.6708573893222094,4.240147493033361,1.0178676973941447,1.0197531891302536,13,18,9.770636558532715,7.841360092163086,19,14
1098,64,2.6944866771871943,4.144628000590117,1.0074951328900048,1.0234127735109588,34,47,10.279322624206543,7.841360092163086,30,17
1098,128,1.488273152577815,4.103384150948574,1.0036792424580843,1.0250473564382427,62,111,10.953059196472168,7.841360092163086,66,17
1099,1,6.986277256707975,6.986277256707978,0.9750998281295912,0.9750998281295925,0,0,7.026128768920898,7.026128768920898,1,1
1099,2,5.720788506385869,5.720788506385867,0.9929447440673138,0.9929447440673146,0,0,7.478762149810791,7.026128768920898,2,2
1099,3,5.059783460189879,5.0597834601898795,1.0059719085406922,1.0059719085406922,0,0,8.146767616271973,7.026128768920898,3,3
1099,4,5.032783309036545,5.0597834601898795,1.005507969618378,1.0059719085406922,1,1,8.203608512878418,7.026128768920898,3,3
1099,8,4.268580033800353,4.305371862979017,1.015463016293297,1.0161032493457813,1,1,8.360881805419922,7.026128768920898,7,7
1099,16,4.114963790855736,4.279950837225553,1.015313728340355,1.017279746589018,4,6,8.957804679870605,7.026128768920898,12,10
1099,32,3.541232563637831,4.109678677771015,1.0158827082921065,1.0208828559714345,13,20,9.673042297363281,7.026128768920898,19,12
1099,64,2.56228235247322,4.098206063548441,1.009169901233981,1.0224121951779241,26,50,10.368176460266113,7.026128768920898,38,14
1099,128,1.272812028480289,4.03178316190588,1.000835381492874,1.0245484436138048,67,113,11.145143508911133,7.026128768920898,61,15
1100,1,6.18322576896229,6.183225768962296,0.9731783893492676,0.9731783893492706,0,0,6.236793518066406,6.236793518066406,1,1
1100,2,5.700883597323559,5.700883597323563,0.9819691348343319,0.9819691348343346,0,0,6.586277484893799,6.236793518066406,2,2
1100,3,4.577161658377098,4.577161658377099,0.9948699929388947,0.9948699929388967,0,0,7.0208353996276855,6.236793518066406,3,3
1100,4,4.564875850773223,4.564875850773224,0.9953194570942466,0.9953194570942481,0,0,7.062788963317871,6.236793518066406,4,4
1100,8,4.079429940009328,4.123962977409373,1.0021810214615061,1.002643604093791,1,2,7.780661582946777,6.236793518066406,7,6
1100,16,3.131809953076428,3.3187078357843824,1.0113015759987412,1.0133428556744712,8,8,8.532624244689941,6.236793518066406,8,8
1100,32,2.798911528112864,3.305782573883257,1.0086916225316256,1.0144373841367822,15,22,9.083925247192383,6.236793518066406,17,10
1100,64,2.1603216052081797,3.184637158594664,1.0099236134447571,1.0172898930503207,30,53,9.61925220489502,6.236793518066406,34,11
1100,128,1.3072529096784578,3.179906821918983,1.0015096345625722,1.0175151413826589,66,115,10.44551944732666,6.236793518066406,62,13
1101,1,13.418118768271787,13.418118768271793,0.8754650669292704,0.8754650669292721,0,0,13.928653717041016,13.928653717041016,1,1
1101,2,12.399778333639974,12.399778333639958,0.912324601746308,0.9123246017463094,0,0,14.421669960021973,13.928653717041016,2,2
1101,3,12.250536406976254,12.250536406976254,0.9165042813662588,0.9165042813662595,0,0,14.554342269897461,13.928653717041016,3,3
1101,4,11.73825453472018,11.738254534720179,0.9364814764213427,0.9364814764213423,0,0,15.15904426574707,13.928653717041016,4,4
1101,8,9.791307308689932,9.913264950473812,1.0087658044003938,1.0037587617811,2,2,15.944470405578613,13.928653717041016,6,6
1101,16,8.859541402177232,9.190698944588977,1.0431174841615034,1.0340027677292802,5,6,16.658761978149414,13.928653717041016,11,10
1101,32,8.00736240426712,8.760071660759412,1.0485160977573025,1.0609733497911389,13,19,17.398601531982422,13.928653717041016,19,13
1101,64,6.325114908997163,8.520021572014908,1.04263600116289,1.0709269927972058,31,48,18.11713981628418,13.928653717041016,33,16
1101,128,4.048029459036588,8.494475991177246,1.0202940087718249,1.0748497330427784,60,106,18.808040618896484,13.928653717041016,68,22
1102,1,11.680123207783256,11.680123207783256,0.9285669091571869,0.9285669091571908,0,0,11.865124702453613,11.865124702453613,1,1
1102,2,9.605460479118838,9.60546047911884,0.9788187355473947,0.9788187355473955,0,0,12.011571884155273,11.865124702453613,2,2
1102,3,8.771526393901237,8.771526393901237,1.0036411026101852,1.0036411026101866,0,0,12.446619033813477,11.865124702453613,3,3
1102,4,8.544536102897608,8.544536102897608,1.0102097317670107,1.0102097317670111,0,0,12.671173095703125,11.865124702453613,4,4
1102,8,7.95845626574449,8.026767845551431,1.0247587039009418,1.0254284085809275,2,2,13.468660354614258,11.865124702453613,6,6
1102,16,6.778824528396005,7.686154918909619,1.0426075709507185,1.0389787809408877,5,5,14.336567878723145,11.865124702453613,11,11
1102,32,6.037579416922247,7.108506124262498,1.056377043784599,1.0565100397450464,11,19,14.789847373962402,11.865124702453613,21,13
1102,64,5.153194560359579,7.07659987827111,1.0472013609825912,1.0605308614378586,28,51,15.549603462219238,11.865124702453613,36,13
1102,128,3.2829175117966485,7.076599878271112,1.0100585410283953,1.060530861437857,63,115,16.461896896362305,11.865124702453613,65,13
1103,1,6.983864154603923,6.983864154603925,0.979989782655597,0.9799897826555973,0,0,7.009904861450195,7.009904861450195,1,1
1103,2,6.52784595401649,6.52784595401649,0.987433892238637,0.9874338922386372,0,0,7.192285537719727,7.009904861450195,2,2
1103,3,5.466515619758339,5.466515619758341,1.0041580622485609,1.0041580622485595,0,0,7.936280250549316,7.009904861450195,3,3
1103,4,5.364654671988937,5.364654671988937,1.0065402661084448,1.0065402661084446,0,0,8.078537940979004,7.009904861450195,4,4
1103,8,5.134176127823766,5.254596193545524,1.0085749007912579,1.0095542441020928,2,2,8.467937469482422,7.009904861450195,6,6
1103,16,4.473805930760189,4.8667182254101835,1.0136786558647326,1.0161766409594257,7,9,8.949307441711426,7.009904861450195,9,7
1103,32,3.9885610095317077,4.811709081181896,1.013236616779617,1.0197567308259605,16,20,9.830466270446777,7.009904861450195,16,12
1103,64,2.4161394679947663,4.702415138249245,1.0033355081765114,1.0201988398667674,32,54,10.462924003601074,7.009904861450195,32,10
1103,128,1.7147476946404219,4.674217000131492,1.0013857331464338,1.0220042355838403,63,114,11.154304504394531,7.009904861450195,65,14
1104,1,4.780438378195105,4.780438378195106,0.9903265772776961,0.9903265772776971,0,0,4.7894368171691895,4.7894368171691895,1,1
1104,2,4.205251836243768,4.205251836243767,0.9952886519328064,0.9952886519328069,0,0,4.890337944030762,4.7894368171691895,2,2
1104,3,3.436720692289613,3.4367206922896174,1.0017197408773988,1.0017197408773997,0,0,5.200964450836182,4.7894368171691895,3,3
1104,4,3.436720303396115,3.4367206922896174,1.001720128065434,1.0017197408773995,1,1,5.2078094482421875,4.7894368171691895,3,3
1104,8,3.0753117133807235,3.0837170220711796,1.0028056377101322,1.0026936348636424,2,3,5.491601467132568,4.7894368171691895,6,5
1104,16,2.6133796533721507,2.7997348818657204,1.0077924524498472,1.00769678404414,6,7,6.228386878967285,4.7894368171691895,10,9
1104,32,1.9494037001836668,2.7868447366611364,1.0050444331394952,1.0087414028257329,13,19,7.002065181732178,4.7894368171691895,19,13
1104,64,1.0874452931071006,2.717418744134475,1.0007303471951352,1.011086377277573,30,49,7.725096225738525,4.7894368171691895,34,15
1104,128,0.5836188989196416,2.67815804353317,1.0006184301276118,1.0117374054221488,66,114,8.583259582519531,4.7894368171691895,62,14
1105,1,7.167860356644002,7.167860356644005,0.9650787314218533,0.9650787314218547,0,0,7.244414329528809,7.244414329528809,1,1
1105,2,6.225879044608999,6.225879044608999,0.9816710523555399,0.9816710523555403,0,0,7.285740375518799,7.244414329528809,2,2
1105,3,6.043983907883947,6.0439839078839475,0.986095828157122,0.9860958281571224,0,0,8.418424606323242,7.244414329528809,3,3
1105,4,5.557514057533999,5.557514057533999,0.9957131599143931,0.9957131599143937,0,0,8.486336708068848,7.244414329528809,4,4
1105,8,5.324750914767132,5.340065224757245,1.0033590927653795,1.0024876960429239,1,1,8.736405372619629,7.244414329528809,7,7
1105,16,4.567756366390815,4.814158996958786,1.0106870399110541,1.012844465575329,7,8,8.978428840637207,7.244414329528809,9,8
1105,32,3.857027216530261,4.721245862793117,1.0125454349278413,1.0160722923240222,15,19,9.859328269958496,7.244414329528809,17,13
1105,64,3.0365406603895617,4.692201025295252,1.005923558258349,1.0182500147968359,30,48,10.593159675598145,7.244414329528809,34,16
1105,128,1.8082452120950645,4.658783482267248,0.999575476283311,1.019899490970133,66,111,11.420406341552734,7.244414329528809,62,17
1106,1,8.903815362688862,8.903815362688862,0.9525843628387768,0.9525843628387793,0,0,9.016616821289062,9.016616821289062,1,1
1106,2,7.700981955809155,7.700981955809156,0.9793790386892107,0.9793790386892123,0,0,9.433138847351074,9.016616821289062,2,2
1106,3,7.20638221649808,7.206382216498081,0.9884877370106566,0.9884877370106571,0,0,9.465970993041992,9.016616821289062,3,3
1106,4,6.582625819028372,6.582625819028371,1.0043506747431312,1.0043506747431312,0,0,9.984313011169434,9.016616821289062,4,4
1106,8,5.367099514812244,5.369499596710079,1.0241142058309467,1.024271042090518,1,1,10.357155799865723,9.016616821289062,7,7
1106,16,4.854831022408739,5.157432741762883,1.0269589887681378,1.0308599620829215,4,6,11.087041854858398,9.016616821289062,12,10
1106,32,4.369530935545003,5.029174723358634,1.0265903495295476,1.0346896376356438,12,19,11.704058647155762,9.016616821289062,20,13
1106,64,3.09550158617112,5.022272910646921,1.0119030674044218,1.0356283699493853,28,50,12.404739379882812,9.016616821289062,36,14
1106,128,2.000820106170469,5.022272910646921,1.0025472479904223,1.0356283699493856,69,114,13.380281448364258,9.016616821289062,59,14
1107,1,11.84657441904376,11.846574419043739,0.9050285873118697,0.9050285873118715,0,0,12.175666809082031,12.175666809082031,1,1
1107,2,10.346470128724928,10.346470128724928,0.9605383543343154,0.9605383543343164,0,0,13.15277099609375,12.175666809082031,2,2
1107,3,10.006425713265614,10.006425713265612,0.9699272852322186,0.9699272852322189,0,0,13.278884887695312,12.175666809082031,3,3
1107,4,10.006294661558945,10.006294661558945,0.9699819623961375,0.9699819623961381,0,0,13.435778617858887,12.175666809082031,4,4
1107,8,8.199265012050791,8.329719858652362,1.018873753731176,1.0180376591323181,2,3,13.79964542388916,12.175666809082031,6,5
1107,16,7.245000625971708,7.363231820522697,1.039426361148554,1.0407153037740056,5,8,14.23263931274414,12.175666809082031,11,8
1107,32,5.959773944804578,7.196411732608351,1.0425641108339025,1.0482579975348412,15,19,14.622268676757812,12.175666809082031,17,13
1107,64,4.511719420905837,7.016724491928071,1.0357565120695016,1.0554900926541861,31,50,14.99853229522705,12.175666809082031,33,14
1107,128,2.523607447137174,6.97946047089317,1.0108754943726028,1.0566733746662043,62,115,15.468276977539062,12.175666809082031,66,13
1108,1,6.40025375859532,6.400253758595322,0.9799589543704698,0.9799589543704718,0,0,6.428121089935303,6.428121089935303,1,1
1108,2,5.321851174725779,5.321851174725779,0.9973109144571968,0.9973109144571991,0,0,7.676431179046631,6.428121089935303,2,2
1108,3,4.750421775864023,4.750421775864022,1.0062811067946553,1.0062811067946578,0,0,7.79042387008667,6.428121089935303,3,3
1108,4,4.710132022025605,4.710132022025604,1.0065644697661704,1.0065644697661724,0,0,7.911406993865967,6.428121089935303,4,4
1108,8,4.093092617091061,4.276513837870459,1.0139746491650614,1.0127972292881937,2,3,8.723930358886719,6.428121089935303,6,5
1108,16,3.7357819048443788,4.156353052555518,1.0179062368763634,1.0169470224932597,3,7,9.13370418548584,6.428121089935303,13,9
1108,32,3.52107732052432,4.004873853872509,1.0185339238245261,1.0230663425252495,13,17,9.603699684143066,6.428121089935303,19,15
1108,64,2.5628364191356465,3.8976104825921265,1.0064508710697169,1.024978348620655,31,47,10.221562385559082,6.428121089935303,33,17
1108,128,1.3002035140900097,3.8768096328676607,1.0017574170448813,1.0260879974064943,66,110,11.082588195800781,6.428121089935303,62,18
1109,1,10.388147689486729,10.388147689486727,0.9331329311724921,0.9331329311724949,0,0,10.57034683227539,10.57034683227539,1,1
1109,2,8.068585003838104,8.068585003838106,0.9859931391915102,0.98599313919151,0,0,10.801734924316406,10.57034683227539,2,2
1109,3,7.574619658747293,7.574619658747294,1.001019800004734,1.001019800004734,0,0,11.104392051696777,10.57034683227539,3,3
1109,4,7.308977699535293,7.308977699535294,1.0048333631210329,1.0048333631210322,0,0,11.126862525939941,10.57034683227539,4,4
1109,8,6.959208590334564,6.992127066641858,1.0146128688484646,1.0138380812280272,1,1,11.861807823181152,10.57034683227539,7,7
1109,16,6.331373198433589,6.749881356189715,1.031344322871917,1.0225599831468728,4,4,12.612390518188477,10.57034683227539,12,12
1109,32,5.651493253108923,6.749812689276274,1.023596894665056,1.0226490548911682,14,20,13.364583969116211,10.57034683227539,18,12
1109,64,4.605514351627781,6.5520238425860375,1.0277786447171504,1.0373099279463327,30,48,14.176084518432617,10.57034683227539,34,16
1109,128,2.5540887903889904,6.248933155620632,1.009025924478775,1.0493663925865944,58,112,14.801867485046387,10.57034683227539,70,16
1110,1,6.0782965128889375,6.078296512888941,0.9763492537570311,0.976349253757033,0,0,6.120584011077881,6.120584011077881,1,1
1110,2,5.334065771354915,5.334065771354886,0.9875984934781015,0.987598493478103,0,0,6.926766872406006,6.120584011077881,2,2
1110,3,5.146814701795116,5.146814701795118,0.9926352845430024,0.992635284543004,0,0,7.236859321594238,6.120584011077881,3,3
1110,4,5.101843384136997,5.101843384136998,0.9933623669599805,0.9933623669599814,0,0,7.243978500366211,6.120584011077881,4,4
1110,8,4.009495771928079,4.063953556418615,1.0078690522525595,1.0079916776113138,2,2,8.136890411376953,6.120584011077881,6,6
1110,16,3.422076499194698,3.917561061421829,1.0140320909073752,1.0133309007971767,5,8,8.547118186950684,6.120584011077881,11,8
1110,32,2.5649575511325953,3.8403165586333556,1.008175340359393,1.0148479603576988,16,23,9.016797065734863,6.120584011077881,16,9
1110,64,1.6621140642240935,3.601329992010631,1.0017496995126687,1.019180538259202,33,51,9.725556373596191,6.120584011077881,31,13
1110,128,0.8949956419040289,3.6006240607628204,0.999548042394308,1.0194010226191408,61,113,10.617104530334473,6.120584011077881,67,15
1111,1,7.746833739509513,7.746833739509515,0.9647561759593872,0.9647561759593883,0,0,7.819418907165527,7.819418907165527,1,1
1111,2,6.303525541846012,6.303525541846014,0.9885184071336071,0.9885184071336077,0,0,7.876249313354492,7.819418907165527,2,2
1111,3,5.6951349448088395,5.6951349448088395,0.9967297368718179,0.9967297368718182,0,0,7.878533840179443,7.819418907165527,3,3
1111,4,5.411701205221758,5.411701205221757,0.9997114431440628,0.9997114431440627,0,0,7.924041748046875,7.819418907165527,4,4
1111,8,4.857245017082226,4.865695120328661,1.0063423603852901,1.006104528143385,2,2,8.089770317077637,7.819418907165527,6,6
1111,16,4.5137885305115795,4.539260164384269,1.0134178171157746,1.0133119379549962,3,3,8.61036491394043,7.819418907165527,13,13
1111,32,3.8170000591801156,4.237420891451917,1.0167890830196469,1.0187201160791788,12,21,9.097509384155273,7.819418907165527,20,11
1111,64,3.1421753232230802,4.128982792625943,1.007635352497604,1.0224533640602982,29,46,9.590500831604004,7.819418907165527,35,18
1111,128,1.6131012939940712,4.015026853860788,1.0051902142647844,1.026587697727253,56,108,10.259418487548828,7.819418907165527,72,20
1112,1,10.721137227208793,10.721137227208795,0.9404169986794766,0.940416998679478,0,0,10.868566513061523,10.868566513061523,1,1
1112,2,9.937322213608445,9.937322213608443,0.9608217166854114,0.9608217166854118,0,0,11.180109024047852,10.868566513061523,2,2
1112,3,9.625474734185621,9.625474734185621,0.965406352338492,0.9654063523384924,0,0,11.187697410583496,10.868566513061523,3,3
1112,4,9.356327928377059,9.356327928377057,0.9722884859441616,0.9722884859441612,0,0,11.26419734954834,10.868566513061523,4,4
1112,8,8.254598867664962,8.322090332898627,0.9995271576249325,0.9979352549576184,1,2,11.428529739379883,10.868566513061523,7,6
1112,16,7.306895947097057,8.025282563576607,1.0071165784589684,1.001780476603531,8,8,11.751028060913086,10.868566513061523,8,8
1112,32,6.601053063658709,7.891568667605847,1.0215815284252292,1.0062085156556317,13,19,12.079519271850586,10.868566513061523,19,13
1112,64,4.524778872121717,7.10762058575995,1.023358453111421,1.0273544878456657,33,52,12.624390602111816,10.868566513061523,31,12
1112,128,2.9391929149218026,6.104422954185779,1.0136878428035727,1.0548467523475678,58,115,13.19536304473877,10.868566513061523,70,13
1113,1,9.303959489753776,9.303959489753776,0.9473351412613662,0.9473351412613684,0,0,9.433374404907227,9.433374404907227,1,1
1113,2,7.948589259737664,7.948589259737665,0.9757199161492545,0.9757199161492561,0,0,9.832527160644531,9.433374404907227,2,2
1113,3,7.256446173507484,7.256446173507484,0.9922235279944147,0.9922235279944169,0,0,10.3316011428833,9.433374404907227,3,3
1113,4,6.492450929452702,6.4924509294527,1.0070260143335352,1.0070260143335363,0,0,10.52765941619873,9.433374404907227,4,4
1113,8,6.163162448673992,6.163181599222847,1.0147684733992124,1.014775132138681,1,1,10.920958518981934,9.433374404907227,7,7
1113,16,5.592527250623954,5.703869131260097,1.0259862623261715,1.0255222136617135,2,5,11.56041431427002,9.433374404907227,14,11
1113,32,4.688993988706226,5.683908501470301,1.0282347313380056,1.027174459656883,15,18,12.463586807250977,9.433374404907227,17,14
1113,64,3.556220037526474,5.683864916510027,1.0136105917402625,1.0271851836405919,31,49,13.034646034240723,9.433374404907227,33,15
1113,128,2.295252629163288,5.6114527963345955,1.0080329873587743,1.0322973061002167,64,112,13.771315574645996,9.433374404907227,64,16
1114,1,9.690970813438176,9.690970813438181,0.9458421976256777,0.945842197625681,0,0,9.826482772827148,9.826482772827148,1,1
1114,2,7.48793486586303,7.487934865863032,0.9900737667433808,0.9900737667433823,0,0,10.270515441894531,9.826482772827148,2,2
1114,3,6.966442365025523,6.966442365025523,0.9991850596037812,0.9991850596037821,0,0,10.525053977966309,9.826482772827148,3,3
1114,4,6.87670332599065,6.87670332599065,1.0019719187354217,1.0019719187354232,0,0,10.715729713439941,9.826482772827148,4,4
1114,8,6.140127042025121,6.157946999435902,1.0146596294511943,1.015627546121299,1,1,11.32934284210205,9.826482772827148,7,7
1114,16,5.605859754006553,5.8912676150669885,1.024299964159906,1.0267285279746279,6,7,11.92996883392334,9.826482772827148,10,9
1114,32,4.828922685010609,5.6756905839735206,1.024037365992302,1.0351991199987345,14,20,12.406940460205078,9.826482772827148,18,12
1114,64,4.0609590099265285,5.598612892262364,1.0187038543967084,1.0392589669733976,32,49,13.038556098937988,9.826482772827148,32,15
1114,128,2.451717527712701,5.5125680133574155,1.010224762218075,1.044898952454763,62,112,13.585553169250488,9.826482772827148,66,16
1115,1,8.029814271719454,8.02981427171946,0.9584559133900519,0.9584559133900533,0,0,8.127799034118652,8.127799034118652,1,1
1115,2,7.568193684200619,7.56819368420062,0.9695126982682352,0.9695126982682354,0,0,9.12785816192627,8.127799034118652,2,2
1115,3,6.370704403371058,6.370704403371058,0.9968042441752006,0.996804244175201,0,0,9.211167335510254,8.127799034118652,3,3
1115,4,6.195400089643246,6.195400089643247,0.9999742424194957,0.999974242419497,0,0,9.23019027709961,8.127799034118652,4,4
1115,8,4.946737933564815,4.9500352940921495,1.020772967798871,1.020691327227882,1,1,9.745589256286621,8.127799034118652,7,7
1115,16,4.57561187986735,4.702598900462116,1.0256870254688504,1.0271691280086466,5,6,10.1499662399292,8.127799034118652,11,10
1115,32,4.198814228770729,4.611912843948504,1.0286598690729951,1.0298072687507571,9,16,10.734185218811035,8.127799034118652,23,16
1115,64,3.2787901444176017,4.585825514927456,1.0212971952788836,1.0311221292723243,29,44,11.327695846557617,8.127799034118652,35,20
1115,128,2.0673276629372026,4.483259951098023,1.0075900343859043,1.0357531139984983,57,103,11.877961158752441,8.127799034118652,71,25
1116,1,7.2422734860758835,7.242273486075883,0.9757248255741005,0.9757248255741002,0,0,7.278807163238525,7.278807163238525,1,1
1116,2,6.648227586696797,6.648227586696797,0.9855275091505376,0.9855275091505374,0,0,8.112841606140137,7.278807163238525,2,2
1116,3,6.194744965362322,6.1947449653623226,0.9903229133738098,0.9903229133738103,0,0,8.179832458496094,7.278807163238525,3,3
1116,4,5.912615862956255,5.912615862956255,0.9960842877273511,0.9960842877273511,0,0,8.787980079650879,7.278807163238525,4,4
1116,8,5.400931316556954,5.412931412778288,1.0052765818654041,1.0053615926871446,1,1,8.993852615356445,7.278807163238525,7,7
1116,16,4.789170640008809,5.0219783561955476,1.0144622675818016,1.01133472188697,4,7,9.261200904846191,7.278807163238525,12,9
1116,32,3.992873949403312,4.827323017082689,1.0191882484352746,1.0164642890741882,13,23,9.785444259643555,7.278807163238525,19,9
1116,64,2.968577728819511,4.799896440223302,1.0101874641518025,1.0182004645880776,29,51,10.319843292236328,7.278807163238525,35,13
1116,128,1.730285814325506,4.665554062377904,1.0063690606725653,1.02443686531696,55,113,10.759267807006836,7.278807163238525,73,15
1117,1,5.315308989378191,5.315308989378192,0.9839494244652275,0.983949424465228,0,0,5.337743282318115,5.337743282318115,1,1
1117,2,4.180759690844448,4.180759690844448,0.9934067321181284,0.9934067321181286,0,0,5.397517204284668,5.337743282318115,2,2
1117,3,4.138536978695069,4.138536978695068,0.9944044328109456,0.9944044328109454,0,0,6.141427040100098,5.337743282318115,3,3
1117,4,4.029549955062449,4.029549955062448,0.9971780405954569,0.997178040595456,0,0,6.629545211791992,5.337743282318115,4,4
1117,8,3.792947500013795,3.91292450127301,0.9977172409389633,0.9995219588369633,2,3,7.0280680656433105,5.337743282318115,6,5
1117,16,3.067071464759895,3.358574185019095,1.0033799600162294,1.0075857322331974,8,9,7.54982328414917,5.337743282318115,8,7
1117,32,2.219611851600573,3.1208052656940435,1.0060961171996574,1.011562254477088,14,23,8.326391220092773,5.337743282318115,18,9
1117,64,1.299458875107428,3.1080456561129504,0.99981420621274,1.0126342084345663,37,52,9.381882667541504,5.337743282318115,27,12
1117,128,0.8169608796417621,3.0809130252991346,0.9998610613130962,1.0149907608431508,66,116,10.494555473327637,5.337743282318115,62,12
1118,1,9.846280416181665,9.84628041618167,0.948014455407001,0.9480144554070028,0,0,9.963627815246582,9.963627815246582,1,1
1118,2,8.97670971210147,8.976709712101473,0.969685212467021,0.969685212467022,0,0,10.533226013183594,9.963627815246582,2,2
1118,3,8.679927299112105,8.679927299112107,0.9782827017298379,0.9782827017298391,0,0,10.881197929382324,9.963627815246582,3,3
1118,4,8.553930402479844,8.553930402479848,0.9807282406211166,0.9807282406211184,0,0,11.001852035522461,9.963627815246582,4,4
1118,8,7.867784257420093,7.867784257420093,0.9954826364907762,0.9954826364907774,0,0,11.457353591918945,9.963627815246582,8,8
1118,16,7.247272144088205,7.318990649734287,1.0124771008993907,1.0119806267937053,5,5,11.857781410217285,9.963627815246582,11,11
1118,32,6.354352905328361,7.240190291528485,1.0129555977830234,1.0138891470679776,14,17,12.593148231506348,9.963627815246582,18,15
1118,64,4.594578545581191,6.8837699538623704,1.0130176406018494,1.0285757436518435,32,47,13.206314086914062,9.963627815246582,32,17
1118,128,2.5311710027297583,6.764427901377626,1.0058365549864412,1.0343163105247204,64,110,13.90018081665039,9.963627815246582,64,18
1119,1,10.616755105906774,10.61675510590678,0.9255762329452878,0.9255762329452893,0,0,10.853479385375977,10.853479385375977,1,1
1119,2,9.849397022832918,9.84939702283292,0.9511164869292426,0.9511164869292422,0,0,11.741941452026367,10.853479385375977,2,2
1119,3,9.614907579621754,9.614907579621756,0.957590195126635,0.9575901951266359,0,0,11.939939498901367,10.853479385375977,3,3
1119,4,9.613839406586624,9.614907579621756,0.9573887659938476,0.9575901951266359,1,1,12.030916213989258,10.853479385375977,3,3
1119,8,8.020792797818665,8.051061903620008,1.0011136682971047,1.0018582096117319,2,2,12.846844673156738,10.853479385375977,6,6
1119,16,7.064211734596479,7.973305092403799,1.0047036870686057,1.0058246189783082,5,10,14.025015830993652,10.853479385375977,11,6
1119,32,5.975723353550031,7.8491520986182275,1.0130938341788471,1.0155419538466632,16,24,14.623363494873047,10.853479385375977,16,8
1119,64,4.135201374410993,7.778557000615743,1.0114331128289733,1.0202270928605435,31,55,15.230841636657715,10.853479385375977,33,9
1119,128,2.7431963109682562,7.6990454022357,1.0116603784424518,1.027791090021644,58,116,16.146629333496094,10.853479385375977,70,12
1120,1,8.949787139300819,8.94978713930082,0.9512765802916592,0.9512765802916597,0,0,9.06723690032959,9.06723690032959,1,1
1120,2,7.453877779811891,7.45387777981189,0.9790749529956336,0.9790749529956333,0,0,9.245416641235352,9.06723690032959,2,2
1120,3,7.335500738610788,7.335500738610787,0.9815982174814771,0.9815982174814759,0,0,9.332053184509277,9.06723690032959,3,3
1120,4,6.8365590647074646,6.836559064707463,0.9897310694429051,0.9897310694429036,0,0,9.473825454711914,9.06723690032959,4,4
1120,8,6.395886599169172,6.396807218166338,0.9999399656992576,1.0001018561576471,1,1,10.104124069213867,9.06723690032959,7,7
1120,16,6.190468103323911,6.35777402522483,1.003835682925931,1.0022980523363767,4,6,10.683830261230469,9.06723690032959,12,10
1120,32,4.948733326593614,5.978417071655698,1.0193205794492817,1.01608631086011,12,20,11.266987800598145,9.06723690032959,20,12
1120,64,3.54375535542014,5.656509993627669,1.0174204318804316,1.0249310828676421,32,46,11.898567199707031,9.06723690032959,32,18
1120,128,1.9483122059233147,5.585356720357347,1.0069223280716142,1.0275551097800435,61,106,12.419169425964355,9.06723690032959,67,22
1121,1,9.056216670826473,9.056216670826478,0.9573204357330745,0.9573204357330761,0,0,9.145923614501953,9.145923614501953,1,1
1121,2,8.65379530637084,8.653795306370844,0.9660257890003586,0.9660257890003598,0,0,9.396929740905762,9.145923614501953,2,2
1121,3,7.974230639322289,7.974230639322266,0.977854606563437,0.9778546065634388,0,0,9.438383102416992,9.145923614501953,3,3
1121,4,7.305526771152476,7.31293751053412,0.9929812061786276,0.9928632326867999,1,1,9.846619606018066,9.145923614501953,3,3
1121,8,6.7653305496699385,6.807785209114187,1.0035390154682733,1.004027811091266,2,1,10.34755802154541,9.145923614501953,6,7
1121,16,5.913301125899896,6.15860352730401,1.0135297703747308,1.0147282692502348,5,7,11.076769828796387,9.145923614501953,11,9
1121,32,4.680845601443736,6.131327685413979,1.0136199082328303,1.0172167920461228,12,20,11.789566040039062,9.145923614501953,20,12
1121,64,3.57491134991501,5.697984863981286,1.0122405374785357,1.030333554479873,29,57,12.543784141540527,9.145923614501953,35,7
1121,128,1.8903708315917054,5.385924122802856,1.0034868526844032,1.0359742123708824,66,115,13.418497085571289,9.145923614501953,62,13
1122,1,5.925996273239216,5.9259962732392175,0.9843854357519288,0.9843854357519298,0,0,5.945356369018555,5.945356369018555,1,1
1122,2,4.855311654330369,4.855311654330369,0.9973019478733278,0.9973019478733283,0,0,6.27365779876709,5.945356369018555,2,2
1122,3,4.598265032274444,4.598265032274443,1.0005171494648384,1.0005171494648388,0,0,6.281647682189941,5.945356369018555,3,3
1122,4,4.342653714402555,4.342653714402555,1.003704107041803,1.003704107041803,0,0,6.368314743041992,5.945356369018555,4,4
1122,8,3.3625885211411672,3.5937394781616927,1.0131378571869982,1.0131069648246953,2,2,7.550999641418457,5.945356369018555,6,6
1122,16,2.9520888124219065,3.46867339650056,1.0124162895914792,1.0159371061301636,4,7,8.487835884094238,5.945356369018555,12,9
1122,32,2.332207069243716,3.4229526583016456,1.0109088740922048,1.0182372223774956,12,21,9.054476737976074,5.945356369018555,20,11
1122,64,1.7288003421853364,3.218986429767751,1.0062686234961753,1.0223023916418112,31,51,9.909750938415527,5.945356369018555,33,13
1122,128,0.8131711098137401,3.21898642976775,1.0012402419390367,1.0223023916418112,62,115,10.558921813964844,5.945356369018555,66,13
1123,1,7.285273081162951,7.285273081162955,0.9619957473840542,0.9619957473840575,0,0,7.372483730316162,7.372483730316162,1,1
1123,2,5.9854989556228,5.9854989556228,0.9868360237291461,0.9868360237291488,0,0,7.546524524688721,7.372483730316162,2,2
1123,3,5.934830646738926,5.934830646738926,0.9893981875845359,0.9893981875845383,0,0,8.478226661682129,7.372483730316162,3,3
1123,4,5.312852497203071,5.312852497203071,1.0006636741575332,1.0006636741575345,0,0,8.676280975341797,7.372483730316162,4,4
1123,8,5.015470472782876,5.015470472782875,1.0097438624987567,1.0097438624987578,0,0,9.83954906463623,7.372483730316162,8,8
1123,16,4.469938296725839,4.627789645946478,1.015833315987705,1.016013900137945,3,5,10.43351936340332,7.372483730316162,13,11
1123,32,3.877426308417396,4.4882616091066625,1.018206171204045,1.023569738222391,15,19,11.174995422363281,7.372483730316162,17,13
1123,64,2.909266210060903,4.425288218222134,1.006824332784956,1.025551710661614,31,49,12.02167797088623,7.372483730316162,33,15
1123,128,2.029626137648135,4.396266991664054,1.0009786962494394,1.0281067568554632,67,112,12.953313827514648,7.372483730316162,61,16
1124,1,10.26190124045711,10.261901240457107,0.9358174005406305,0.935817400540631,0,0,10.440393447875977,10.440393447875977,1,1
1124,2,8.65217285414164,8.652172854141641,0.9797234716418473,0.979723471641848,0,0,10.7560396194458,10.440393447875977,2,2
1124,3,7.633558276053258,7.63355827605326,0.9971780200809035,0.9971780200809033,0,0,10.843756675720215,10.440393447875977,3,3
1124,4,7.61332971537909,7.63355827605326,0.9974573099546851,0.9971780200809033,1,1,11.071389198303223,10.440393447875977,3,3
1124,8,7.451614479868521,7.530449964045723,1.0018537367156508,0.9997092206980156,1,1,11.376219749450684,10.440393447875977,7,7
1124,16,6.8847482666375015,7.025585842939016,1.0113066202994188,1.0090590825291463,5,6,11.547048568725586,10.440393447875977,11,10
1124,32,6.3924909944106,6.780138183698223,1.0135572487534847,1.0129762411956926,13,18,11.820054054260254,10.440393447875977,19,14
1124,64,4.951996309292475,6.594109162232057,1.0268753479606425,1.0218032968986477,32,45,12.064586639404297,10.440393447875977,32,19
1124,128,2.8647121193882614,6.4385435799756925,1.0114050274975663,1.0243157620271743,66,110,12.378490447998047,10.440393447875977,62,18
1125,1,10.250938893283559,10.25093889328356,0.9363653101008356,0.9363653101008369,0,0,10.42887020111084,10.42887020111084,1,1
1125,2,9.373168680462388,9.373168680462387,0.9597079235825379,0.9597079235825381,0,0,11.143153190612793,10.42887020111084,2,2
1125,3,8.492856420104014,8.492856420104014,0.9871137143454631,0.9871137143454625,0,0,11.81477165222168,10.42887020111084,3,3
1125,4,8.22916261289668,8.229162612896681,0.9966957621780463,0.9966957621780468,0,0,12.215200424194336,10.42887020111084,4,4
1125,8,7.75566600696762,7.842370528673492,1.0045503843871442,1.0072415111758193,2,2,12.7696533203125,10.42887020111084,6,6
1125,16,7.4675741863995215,7.748235206385231,1.0036753660508033,1.0105292293565677,6,7,13.095942497253418,10.42887020111084,10,9
1125,32,6.400086855354504,7.6233640566372705,1.012858654289393,1.021127429623823,12,20,13.545928955078125,10.42887020111084,20,12
1125,64,4.772382939590398,7.330203648915832,1.0124359148176107,1.0262063895652218,32,50,14.156439781188965,10.42887020111084,32,14
1125,128,3.006746195493537,6.991053898298238,1.0108291424721363,1.0429019412869385,64,114,14.551745414733887,10.42887020111084,64,14
1126,1,8.617700472519145,8.617700472519147,0.9615052098642463,0.9615052098642473,0,0,8.694648742675781,8.694648742675781,1,1
1126,2,6.959169838597077,6.959169838597077,0.9921794762506251,0.9921794762506242,0,0,8.962794303894043,8.694648742675781,2,2
1126,3,6.75305660760951,6.75305660760951,0.9958213836557971,0.9958213836557959,0,0,9.14367389678955,8.694648742675781,3,3
1126,4,6.470280957077677,6.470280957077677,0.9991194747499107,0.9991194747499107,0,0,9.211939811706543,8.694648742675781,4,4
1126,8,5.1871001047596454,5.1930007781387,1.0225834378706342,1.0225173035511823,1,2,9.909379959106445,8.694648742675781,7,6
1126,16,4.987258765836808,5.111242408793918,1.0267384296541677,1.0248350836960938,5,8,10.287365913391113,8.694648742675781,11,8
1126,32,4.481828568104514,5.072817508375585,1.0275857035349882,1.0261919552109322,11,21,10.840678215026855,8.694648742675781,21,11
1126,64,3.3325128402307134,5.055658954063567,1.0159820958540777,1.0277677551695477,32,51,11.627297401428223,8.694648742675781,32,13
1126,128,2.098415249225124,5.047080245153476,1.0047194017871202,1.0290554914471013,67,110,12.202359199523926,8.694648742675781,61,18
1127,1,8.014996214900227,8.014996214900226,0.9673728939109915,0.9673728939109922,0,0,8.074821472167969,8.074821472167969,1,1
1127,2,6.980208011321576,6.980208011321576,0.98667915531425,0.9866791553142511,0,0,8.879565238952637,8.074821472167969,2,2
1127,3,6.855334794208121,6.8553347942081215,0.990145000497397,0.9901450004973983,0,0,9.110319137573242,8.074821472167969,3,3
1127,4,6.576307154555225,6.576307154555225,0.9963659663547886,0.996365966354789,0,0,9.335034370422363,8.074821472167969,4,4
1127,8,5.386663914426372,5.437585469535958,1.0137938129332897,1.014109216958253,2,2,10.489073753356934,8.074821472167969,6,6
1127,16,4.787764224705697,5.043446298763343,1.0220957076555972,1.023791391404374,6,7,10.934977531433105,8.074821472167969,10,9
1127,32,4.32039142904333,4.930236538478142,1.0256355755463349,1.0306160554033656,13,21,11.904537200927734,8.074821472167969,19,11
1127,64,3.3028542835753236,4.9192347743632325,1.0152299277776857,1.0318239806595175,28,52,12.69240665435791,8.074821472167969,36,12
1127,128,1.583883167754962,4.881643084231047,1.0018352529447077,1.034561034077448,59,113,13.392329216003418,8.074821472167969,69,15
1128,1,13.413376865868154,13.413376865868173,0.8891407516355135,0.8891407516355186,0,0,13.811907768249512,13.811907768249512,1,1
1128,2,11.553604049581304,11.553604049581285,0.9546608464263076,0.9546608464263117,0,0,14.865633964538574,13.811907768249512,2,2
1128,3,11.023795264068863,11.023795264068864,0.9755307026784972,0.9755307026785005,0,0,15.55482006072998,13.811907768249512,3,3
1128,4,10.778957694325191,10.778957694325191,0.9835752511901517,0.9835752511901557,0,0,15.737767219543457,13.811907768249512,4,4
1128,8,9.664508198657858,9.66458149652997,1.029267056756757,1.0293729628422315,1,1,16.127946853637695,13.811907768249512,7,7
1128,16,8.574758681535421,8.663653538688363,1.0564352328420217,1.0561108521692315,5,5,16.599788665771484,13.811907768249512,11,11
1128,32,7.642427805085388,8.408702748564632,1.0579449636535907,1.0681272069023038,14,17,17.14837646484375,13.811907768249512,18,15
1128,64,5.831472470185754,8.050075027882603,1.0501615704970249,1.0771557504540292,30,46,17.61411476135254,13.811907768249512,34,18
1128,128,3.973927083731408,7.9467350812832995,1.0400324618609211,1.0852720907010935,63,110,18.0473575592041,13.811907768249512,65,18
1129,1,3.2967624419117647,3.2967624419117647,0.9940512200674949,0.9940512200674951,0,0,3.301851272583008,3.301851272583008,1,1
1129,2,2.763593114481874,2.7635931144818744,0.9979954702939178,0.997995470293918,0,0,3.626081705093384,3.301851272583008,2,2
1129,3,2.5653640446345727,2.5653640446345727,0.9990708542506306,0.9990708542506299,0,0,3.653179168701172,3.301851272583008,3,3
1129,4,2.378749801316569,2.3796283435414534,0.9998800612638877,0.9998903772899342,1,1,3.704167366027832,3.301851272583008,3,3
1129,8,2.17328435656492,2.196396662221933,1.0014930740169825,1.0013241147264376,3,3,4.126461029052734,3.301851272583008,5,5
1129,16,2.0389982029738105,2.103451095309809,1.0025093969059047,1.0023531093548281,7,8,4.415623188018799,3.301851272583008,9,8
1129,32,1.4408975074943766,2.005818018852847,1.0030531910356348,1.003142759873284,12,22,4.823129177093506,3.301851272583008,20,10
1129,64,0.8379027779808143,1.96758351242196,1.0010646326267563,1.0038382753378086,36,53,5.481466293334961,3.301851272583008,28,11
1129,128,0.18182096224328642,1.9024540114724358,1.0000642768758856,1.0060690778790438,61,113,6.16864013671875,3.301851272583008,67,15
1130,1,8.031384178634472,8.031384178634474,0.9614364142373275,0.9614364142373278,0,0,8.114545822143555,8.114545822143555,1,1
1130,2,7.375243581769226,7.375243581769225,0.9740979527700253,0.9740979527700244,0,0,8.84002685546875,8.114545822143555,2,2
1130,3,6.658062266761853,6.658062266761853,0.9889923751906753,0.9889923751906746,0,0,8.893484115600586,8.114545822143555,3,3
1130,4,6.558672416963615,6.558672416963615,0.9911530626325445,0.9911530626325441,0,0,8.913228034973145,8.114545822143555,4,4
1130,8,6.055429126742215,6.063139081273622,0.9994001668387087,0.9997247720416175,1,1,9.413721084594727,8.114545822143555,7,7
1130,16,4.830100768415264,5.212953803208524,1.0204232342292472,1.0175357536672347,7,8,10.381807327270508,8.114545822143555,9,8
1130,32,3.9738632078491434,4.917674826592988,1.0167216240772574,1.0255064302842993,15,21,10.887377738952637,8.114545822143555,17,11
1130,64,3.2053752881250688,4.632375652264233,1.0135919659978512,1.031115336526486,26,49,11.586803436279297,8.114545822143555,38,15
1130,128,1.6277049022417065,4.582849575273268,1.0034642157425386,1.0343035251017145,60,113,12.465926170349121,8.114545822143555,68,15
1131,1,11.804469072194578,11.804469072194589,0.9232866339671407,0.9232866339671437,0,0,12.020987510681152,12.020987510681152,1,1
1131,2,10.292437312773062,10.292437312773066,0.9657448963303787,0.965744896330381,0,0,12.34656047821045,12.020987510681152,2,2
1131,3,9.62734616211093,9.627346162110932,0.9811611988374094,0.9811611988374117,0,0,12.354182243347168,12.020987510681152,3,3
1131,4,9.372858024910425,9.372858024910427,0.9887297048426532,0.9887297048426557,0,0,12.620652198791504,12.020987510681152,4,4
1131,8,8.903715967895462,8.912406829367555,0.9990772080595927,0.9998829080935161,1,1,13.431238174438477,12.020987510681152,7,7
1131,16,8.505484012752888,8.849317958551271,1.0039227946995053,1.0019038811301002,4,6,13.720892906188965,12.020987510681152,12,10
1131,32,7.521287216061544,8.458978644714866,1.0179983630403417,1.017382051817883,12,18,14.158513069152832,12.020987510681152,20,14
1131,64,5.4877743348982895,8.180078308282372,1.022323621771222,1.0236785214012665,33,50,14.403111457824707,12.020987510681152,31,14
1131,128,3.659448640726529,8.110500591306359,1.0076998460307531,1.026942068412909,65,112,14.909464836120605,12.020987510681152,63,16
1132,1,8.696464344374753,8.696464344374757,0.9520624024348431,0.9520624024348445,0,0,8.813220977783203,8.813220977783203,1,1
1132,2,7.120729933605859,7.12072993360586,0.9874844029082419,0.9874844029082419,0,0,9.664430618286133,8.813220977783203,2,2
1132,3,6.997877956048933,6.997877956048933,0.9893633205125076,0.9893633205125077,0,0,9.75094985961914,8.813220977783203,3,3
1132,4,6.345917751823319,6.345917751823319,1.0009135265958717,1.0009135265958715,0,0,9.848531723022461,8.813220977783203,4,4
1132,8,5.430776229497031,5.5367370042226876,1.018566590287696,1.0181117333476637,1,1,10.404245376586914,8.813220977783203,7,7
1132,16,4.991651881588004,5.209994735425492,1.0273408439140765,1.025751871470551,5,5,10.832416534423828,8.813220977783203,11,11
1132,32,4.5643928854649305,4.866196931895131,1.0330376062308617,1.036995146200928,12,15,11.620869636535645,8.813220977783203,20,17
1132,64,3.384173749732438,4.826109522601687,1.025253056224648,1.0379493000517996,32,46,12.353754997253418,8.813220977783203,32,18
1132,128,2.201052333724601,4.790647125652408,1.0067247300911144,1.0410043859704474,57,104,13.26846694946289,8.813220977783203,71,24
1133,1,6.042540379947151,6.042540379947151,0.9809329609263981,0.9809329609263985,0,0,6.070557117462158,6.070557117462158,1,1
1133,2,4.809427035027571,4.809427035027571,0.996507630537023,0.9965076305370226,0,0,6.13752555847168,6.070557117462158,2,2
1133,3,3.952935030246973,3.9529350302469735,1.0067042397034935,1.0067042397034935,0,0,6.341440677642822,6.070557117462158,3,3
1133,4,3.85934206449207,3.8593420644920693,1.0077235952509338,1.0077235952509336,0,0,6.597813606262207,6.070557117462158,4,4
1133,8,2.7711014937180924,2.8409334200993834,1.0143132754932602,1.0140638931856099,1,1,6.878145694732666,6.070557117462158,7,7
1133,16,2.56138510224497,2.70546357863188,1.0154078294393054,1.0173320741455218,6,6,7.418941974639893,6.070557117462158,10,10
1133,32,2.270618767299319,2.687647301929576,1.0114055285776267,1.0178093402754977,15,20,7.826587677001953,6.070557117462158,17,12
1133,64,1.6438641904000986,2.6629307846196992,1.0066802803214268,1.0191221359967446,31,51,8.281169891357422,6.070557117462158,33,13
1133,128,1.033086467949694,2.642300773911972,1.0028269098681903,1.02035154230721,61,113,8.894623756408691,6.070557117462158,67,15
1134,1,9.040741492786324,9.040741492786326,0.9487852782755452,0.9487852782755488,0,0,9.169676780700684,9.169676780700684,1,1
1134,2,7.225316901777517,7.225316901777519,0.9842839132527488,0.9842839132527506,0,0,9.189921379089355,9.169676780700684,2,2
1134,3,6.820917225250617,6.820917225250617,0.9926735939327906,0.992673593932792,0,0,9.246467590332031,9.169676780700684,3,3
1134,4,6.335958874601687,6.335958874601687,1.0017021723056196,1.0017021723056208,0,0,9.596418380737305,9.169676780700684,4,4
1134,8,5.6264809924200065,5.626480992420006,1.0147586021984605,1.0147586021984605,0,0,10.17153549194336,9.169676780700684,8,8
1134,16,5.20226772898389,5.368822201478396,1.0210983909606142,1.021495934082109,6,6,10.975172996520996,9.169676780700684,10,10
1134,32,4.465756410383221,5.221381539140802,1.030979069727977,1.027059821327818,10,19,11.245209693908691,9.169676780700684,22,13
1134,64,3.3054247655027966,4.985158517500256,1.0211433189487193,1.0345224630286816,30,47,11.706673622131348,9.169676780700684,34,17
1134,128,2.228432040094741,4.890790352407247,1.012194427469634,1.0380335733796244,63,108,12.30350112915039,9.169676780700684,65,20
1135,1,8.6782459033191,8.678245903319107,0.9602161014739857,0.9602161014739878,0,0,8.761738777160645,8.761738777160645,1,1
1135,2,6.2825176997600805,6.282517699760081,1.0011867430988381,1.0011867430988395,0,0,9.288453102111816,8.761738777160645,2,2
1135,3,5.98428008354079,5.984280083540789,1.0072028193305724,1.0072028193305735,0,0,9.600859642028809,8.761738777160645,3,3
1135,4,5.766476325466679,5.766476325466678,1.0125791402629867,1.012579140262988,0,0,9.92103385925293,8.761738777160645,4,4
1135,8,5.217812549657263,5.220907462681643,1.0223764160256879,1.0223489221988111,1,1,10.28739070892334,8.761738777160645,7,7
1135,16,4.7957584814697904,5.096394393418058,1.0264514481946125,1.0262944026804717,3,6,10.945023536682129,8.761738777160645,13,10
1135,32,4.4598069125602935,5.062844716658493,1.0182442467519501,1.0270410222207857,14,18,11.349006652832031,8.761738777160645,18,14
1135,64,3.628592632407836,5.013402465662012,1.0133978286953131,1.0286833471494572,33,47,11.912598609924316,8.761738777160645,31,17
1135,128,2.0506121959247983,4.99613125673445,1.007552306822459,1.0295319565891594,67,111,12.460844993591309,8.761738777160645,61,17
1136,1,4.53133009838875,4.531330098388751,0.9826313429401505,0.9826313429401509,0,0,4.563534736633301,4.563534736633301,1,1
1136,2,4.018934394090575,4.018934394090576,0.9903433942976073,0.990343394297607,0,0,4.750367641448975,4.563534736633301,2,2
1136,3,3.821400416563316,3.821400416563316,0.9933366579754671,0.9933366579754668,0,0,4.762956142425537,4.563534736633301,3,3
1136,4,3.7143787050038233,3.714378705003823,0.9938742628514199,0.9938742628514196,0,0,4.925271511077881,4.563534736633301,4,4
1136,8,2.864965297544787,2.9500593777695854,1.0042488460085441,1.0030230833325193,1,2,5.1602396965026855,4.563534736633301,7,6
1136,16,2.0402939089583083,2.3449346374509195,1.0074808682797767,1.0075384958677551,6,7,5.684513092041016,4.563534736633301,10,9
1136,32,1.563549862750068,2.1668715889489256,1.0073039258123806,1.008862895527982,16,23,6.064409255981445,4.563534736633301,16,9
1136,64,0.8682414931598338,2.1668715889489256,1.0028128558242235,1.008862895527982,30,55,6.533149242401123,4.563534736633301,34,9
1136,128,0.1711695428314598,2.165944583917222,0.999852255087367,1.0089734764876168,62,118,6.992706775665283,4.563534736633301,66,10
1137,1,2.083390448405426,2.0833904484054258,0.9985804604063772,0.9985804604063765,0,0,2.0838570594787598,2.0838570594787598,1,1
1137,2,1.9190202742357627,1.9190202742357627,0.99914368889969,0.9991436888996901,0,0,2.5092267990112305,2.0838570594787598,2,2
1137,3,1.7646557256139082,1.7646557256139082,0.9990633607091648,0.9990633607091648,0,0,2.619901418685913,2.0838570594787598,3,3
1137,4,1.7378512121726615,1.7378512121726615,0.9993225491058249,0.9993225491058251,0,0,2.8714723587036133,2.0838570594787598,4,4
1137,8,1.7175631731579686,1.7376915302364975,0.9993016490092074,0.999350027736701,3,3,3.213768482208252,2.0838570594787598,5,5
1137,16,1.3543517446935194,1.7150626642370492,1.0001736301024755,0.9997357695698458,8,9,3.4499199390411377,2.0838570594787598,8,7
1137,32,0.8242947574778573,1.6264722099500561,1.0000170122465752,1.0010186396692238,13,22,3.83227801322937,2.0838570594787598,19,10
1137,64,0.4448264139576809,1.5494932800082473,1.00015986198479,1.001653958326974,31,54,4.442492485046387,2.0838570594787598,33,10
1137,128,0.0149436454251241,1.5277146039114338,0.9999985945425887,1.0023548448229922,63,115,5.097267150878906,2.0838570594787598,65,13
1138,1,9.181380142616566,9.18138014261657,0.943564816830104,0.943564816830105,0,0,9.341267585754395,9.341267585754395,1,1
1138,2,8.187913280835886,8.18791328083589,0.9573631793979828,0.9573631793979838,0,0,9.695931434631348,9.341267585754395,2,2
1138,3,8.077017740608431,8.077017740608431,0.9615912180720149,0.9615912180720154,0,0,9.874923706054688,9.341267585754395,3,3
1138,4,7.651679248807911,7.651679248807914,0.9761535700380726,0.976153570038074,0,0,9.904309272766113,9.341267585754395,4,4
1138,8,7.042740559911123,7.112896558936518,0.9882944443601477,0.9888158171025095,1,2,10.176042556762695,9.341267585754395,7,6
1138,16,6.112987755919669,6.348410745390493,1.0102176055064627,1.0099366929871243,5,5,10.96444034576416,9.341267585754395,11,11
1138,32,5.5961025515011205,6.058317452280906,1.0206683864694797,1.0252560734035934,13,14,11.47529411315918,9.341267585754395,19,18
1138,64,4.826445723350192,6.036967860993002,1.0140886021596756,1.0264630580289682,29,41,11.92800521850586,9.341267585754395,35,23
1138,128,3.24213167947557,5.780047454236028,1.0046549093261095,1.0343297553821418,67,105,12.265020370483398,9.341267585754395,61,23
1139,1,3.383568742985905,3.3835687429859087,0.9941000174426587,0.9941000174426613,0,0,3.388482093811035,3.388482093811035,1,1
1139,2,2.9211770254411795,2.9211770254411804,0.9975913323484689,0.9975913323484709,0,0,3.422424554824829,3.388482093811035,2,2
1139,3,2.7625201716184113,2.762520171618412,0.9997503487605033,0.9997503487605057,0,0,3.6988577842712402,3.388482093811035,3,3
1139,4,2.504194604624663,2.504194604624662,1.001909526008018,1.001909526008021,0,0,3.70115065574646,3.388482093811035,4,4
1139,8,2.3074494429989607,2.465281567397136,1.0027292499120968,1.0024697175735873,3,3,4.293870449066162,3.388482093811035,5,5
1139,16,2.074390030283824,2.3335950625902737,1.0031629947178209,1.0037116121620067,6,7,4.562080383300781,3.388482093811035,10,9
1139,32,1.5704591922209676,2.1647835931885275,1.0024077481521436,1.00523270652998,17,23,4.917827606201172,3.388482093811035,15,9
1139,64,0.7581241770331351,2.122061724121636,1.0015398281997079,1.006512216980767,28,50,5.362990856170654,3.388482093811035,36,14
1139,128,0.14477364706324414,2.0427104838427383,1.000168141977165,1.0072296898013402,57,116,6.122757434844971,3.388482093811035,71,12
1140,1,5.5345159287579,5.5345159287579,0.9956953301559356,0.9956953301559358,0,0,5.536012649536133,5.536012649536133,1,1
1140,2,4.280953139631651,4.2809531396316505,1.0096184937570152,1.0096184937570156,0,0,6.313471794128418,5.536012649536133,2,2
1140,3,3.848716276162739,3.8487162761627376,1.0146827347526286,1.014682734752629,0,0,6.5959272384643555,5.536012649536133,3,3
1140,4,3.6709585775195266,3.670958577519529,1.0162532022980495,1.0162532022980497,0,0,6.762689113616943,5.536012649536133,4,4
1140,8,3.2332478889488168,3.233247888948812,1.0219454598590776,1.0219454598590771,0,0,7.051109313964844,5.536012649536133,8,8
1140,16,2.849971378576867,3.0553012218615527,1.0211894187569124,1.0226012086723575,3,5,7.987198829650879,5.536012649536133,13,11
1140,32,2.6075856254638636,3.042586749133889,1.0167751718845577,1.023419641171924,13,18,8.639138221740723,5.536012649536133,19,14
1140,64,1.714144406808755,3.0313022233824514,1.003646283782864,1.024085527255468,34,48,9.447172164916992,5.536012649536133,30,16
1140,128,0.8987288039041603,3.0313022233824527,1.0015285437167674,1.0240855272554676,66,112,10.577820777893066,5.536012649536133,62,16
1141,1,6.454157696118647,6.45415769611865,0.9752817156227934,0.975281715622795,0,0,6.498168468475342,6.498168468475342,1,1
1141,2,4.905399019731645,4.905399019731645,0.9956074590386395,0.9956074590386406,0,0,6.574317455291748,6.498168468475342,2,2
1141,3,4.666342631286934,4.666342631286935,0.9980523724861337,0.9980523724861345,0,0,6.608752250671387,6.498168468475342,3,3
1141,4,4.087278197360778,4.087278197360779,1.0021660979649767,1.0021660979649756,0,0,6.6443939208984375,6.498168468475342,4,4
1141,8,3.3300069184408545,3.3401655669408647,1.0121695720597237,1.0120484111306636,1,1,7.05495548248291,6.498168468475342,7,7
1141,16,3.060984785208629,3.2679449574695663,1.013262656830026,1.0130782179039362,5,6,7.4419965744018555,6.498168468475342,11,10
1141,32,2.6703436517733694,3.0753054229511974,1.0148464017857948,1.0165038321084734,11,20,8.085457801818848,6.498168468475342,21,12
1141,64,2.0810592380701927,2.98099670596436,1.0099336203959037,1.019513846656507,30,46,8.554070472717285,6.498168468475342,34,18
1141,128,0.9153155870888564,2.9008849307571984,1.000641190760251,1.022237540607264,66,104,9.374829292297363,6.498168468475342,62,24
1142,1,6.691191996233312,6.6911919962333135,0.9742064972752283,0.9742064972752303,0,0,6.735994815826416,6.735994815826416,1,1
1142,2,5.068480929430989,5.068480929430989,0.9981532267748454,0.9981532267748471,0,0,8.235407829284668,6.735994815826416,2,2
1142,3,4.9204373892658815,4.920437389265881,1.0029328826673307,1.0029328826673325,0,0,9.246742248535156,6.735994815826416,3,3
1142,4,4.9168181238890485,4.916818123889048,1.0032165743909842,1.0032165743909864,0,0,9.428911209106445,6.735994815826416,4,4
1142,8,4.762559702447977,4.7639150226666,1.0101013835402128,1.010143087644952,1,1,10.013724327087402,6.735994815826416,7,7
1142,16,4.605931712458186,4.672022906606947,1.0160500129376842,1.0153959177217282,6,6,10.510302543640137,6.735994815826416,10,10
1142,32,4.037502715370478,4.6670779862224965,1.0107034313933116,1.0160725414986613,16,19,11.035820960998535,6.735994815826416,16,13
1142,64,2.9962430388407486,4.5915485381416,1.009060879267654,1.0196626254664858,29,50,11.739850044250488,6.735994815826416,35,14
1142,128,1.930285213214012,4.5758132239495195,1.0014284472413755,1.0217563666991574,58,113,12.493210792541504,6.735994815826416,70,15
1143,1,10.081769799308521,10.081769799308514,0.9366241743698522,0.9366241743698557,0,0,10.258979797363281,10.258979797363281,1,1
1143,2,8.84080571146563,8.840805711465634,0.9651394764333636,0.9651394764333658,0,0,11.082351684570312,10.258979797363281,2,2
1143,3,8.318081253610925,8.318081253610927,0.9762506725946543,0.9762506725946551,0,0,11.394208908081055,10.258979797363281,3,3
1143,4,8.136817332415918,8.136817332415891,0.9811880518614142,0.981188051861416,0,0,11.940003395080566,10.258979797363281,4,4
1143,8,7.754921511904149,7.927052456453854,0.994609284566952,0.9937649270335056,1,1,12.290515899658203,10.258979797363281,7,7
1143,16,6.276300953699375,7.378908637941781,1.018715288404306,1.0114298103959696,3,6,13.016714096069336,10.258979797363281,13,10
1143,32,5.48786291822032,6.9464541740498635,1.0261948958106741,1.023915335497788,14,24,13.555634498596191,10.258979797363281,18,8
1143,64,4.918972006042747,6.904993873964044,1.0254109443334491,1.0258570838244214,29,52,14.370621681213379,10.258979797363281,35,12
1143,128,2.5775157515857043,6.751146674595132,1.0000939350671907,1.030773539656809,61,116,15.066473960876465,10.258979797363281,67,12
1144,1,7.915883972576528,7.915883972576531,0.9644784239555935,0.9644784239555955,0,0,7.986213207244873,7.986213207244873,1,1
1144,2,6.35849625127741,6.358496251277412,0.9913949025027887,0.9913949025027904,0,0,8.18283748626709,7.986213207244873,2,2
1144,3,5.198725666376638,5.198725666376637,1.010269404276982,1.0102694042769822,0,0,8.582439422607422,7.986213207244873,3,3
1144,4,4.825959248914812,4.825959248914811,1.015603781267455,1.015603781267456,0,0,8.704008102416992,7.986213207244873,4,4
1144,8,4.454858581214747,4.454868465736198,1.0204983622901753,1.0205160453788904,1,1,9.224798202514648,7.986213207244873,7,7
1144,16,4.308006825576832,4.348032819102458,1.024340428207925,1.0246637288750395,3,3,9.689242362976074,7.986213207244873,13,13
1144,32,3.893024608068793,4.155487882283496,1.0293627827493501,1.0318878935572404,10,13,10.308335304260254,7.986213207244873,22,19
1144,64,3.0487994243048337,4.106079858792547,1.0142421666005492,1.0338917951997713,32,43,11.027408599853516,7.986213207244873,32,21
1144,128,1.7777534195393088,4.0620972793466255,1.005020672399656,1.036981578592622,64,103,11.749974250793457,7.986213207244873,64,25
1145,1,10.571821733597986,10.571821733597986,0.9314955976543591,0.9314955976543592,0,0,10.77121639251709,10.77121639251709,1,1
1145,2,10.10399920584587,10.10399920584587,0.9452668037380536,0.945266803738054,0,0,11.267012596130371,10.77121639251709,2,2
1145,3,9.784894439695156,9.784894439695158,0.9582813406341706,0.9582813406341711,0,0,12.103164672851562,10.77121639251709,3,3
1145,4,9.402449536595647,9.402449536595645,0.9699628764158754,0.969962876415875,0,0,12.33713150024414,10.77121639251709,4,4
1145,8,7.448277448826128,7.463354466788238,1.0237631193194905,1.0238169471126692,1,1,12.853473663330078,10.77121639251709,7,7
1145,16,7.209709582064939,7.460756541445981,1.0215335066524334,1.0240353826998543,7,8,13.448697090148926,10.77121639251709,9,8
1145,32,6.365830170081893,7.306745387215139,1.017055571707402,1.0280294045265193,16,24,13.986783981323242,10.77121639251709,16,8
1145,64,4.665480408169036,7.285358397118163,1.0046920407691184,1.031331687758371,33,53,14.734914779663086,10.77121639251709,31,11
1145,128,3.27889498069948,7.2501294674929,0.9954041341405406,1.0344429259397492,69,115,15.464507102966309,10.77121639251709,59,13
1146,1,6.784333969987807,6.7843339699878085,0.9728356529531532,0.9728356529531534,0,0,6.833897590637207,6.833897590637207,1,1
1146,2,5.936502945248913,5.936502945248914,0.9890505977135711,0.9890505977135717,0,0,7.201258659362793,6.833897590637207,2,2
1146,3,5.634436143673753,5.634436143673752,0.9942541446281514,0.9942541446281505,0,0,7.3018479347229,6.833897590637207,3,3
1146,4,4.959151633183837,4.959151633183836,1.003912022727523,1.0039120227275227,0,0,7.616964340209961,6.833897590637207,4,4
1146,8,4.764645674671673,4.80613895532441,1.008120181537159,1.007750381908203,2,2,8.832806587219238,6.833897590637207,6,6
1146,16,4.279840571510832,4.41843988457889,1.0156194865223864,1.0154649771301196,5,8,9.225248336791992,6.833897590637207,11,8
1146,32,3.517740508747694,4.402430690109953,1.010242135223281,1.0170246959428764,17,20,10.264375686645508,6.833897590637207,15,12
1146,64,2.8088861942973513,4.343056343051814,1.0080722400920314,1.0219482900002659,30,46,10.902177810668945,6.833897590637207,34,18
1146,128,1.3896849029468745,4.335837541399284,1.0035463897203045,1.0230997453689903,59,109,11.752150535583496,6.833897590637207,69,19
1147,1,11.07424147201514,11.074241472015142,0.9269973094312022,0.9269973094312027,0,0,11.291577339172363,11.291577339172363,1,1
1147,2,9.746329392755532,9.746329392755532,0.9651259619715222,0.9651259619715227,0,0,12.212937355041504,11.291577339172363,2,2
1147,3,9.330146529894725,9.330146529894723,0.9779804034336976,0.977980403433697,0,0,12.410148620605469,11.291577339172363,3,3
1147,4,9.112559090296164,9.112559090296166,0.9848401201984796,0.9848401201984793,0,0,12.695603370666504,11.291577339172363,4,4
1147,8,8.462793820006263,8.465713657600178,1.002938028568126,1.0028555916548252,2,2,13.575708389282227,11.291577339172363,6,6
1147,16,7.690390845437513,7.828119978686816,1.0249938794840938,1.0270820292818694,2,5,14.119449615478516,11.291577339172363,14,11
1147,32,6.7643424358894,7.537129980420866,1.0364802939696436,1.0357862661781014,10,18,14.727721214294434,11.291577339172363,22,14
1147,64,5.224523679588774,7.448881865592153,1.027289802313455,1.0393323644136059,27,46,15.307608604431152,11.291577339172363,37,18
1147,128,2.6802129551478235,7.297863220956692,1.0056994053500965,1.048706310288921,64,108,16.27337646484375,11.291577339172363,64,20
1148,1,6.1616043317188725,6.161604331718873,0.9769698822342259,0.9769698822342269,0,0,6.199349403381348,6.199349403381348,1,1
1148,2,6.05452247848547,6.054522478485472,0.9813043619562907,0.9813043619562918,0,0,8.185328483581543,6.199349403381348,2,2
1148,3,5.285736796371328,5.285736796371329,0.994916458625366,0.9949164586253662,0,0,8.297381401062012,6.199349403381348,3,3
1148,4,5.123229868831899,5.123229868831899,0.9979762145728496,0.9979762145728486,0,0,8.324972152709961,6.199349403381348,4,4
1148,8,5.01638914823284,5.047793694832969,0.9988706061877215,1.0001847057008186,2,2,8.838418006896973,6.199349403381348,6,6
1148,16,3.9414646579821473,4.155194786573812,1.0097567964225913,1.0127247087748517,6,10,9.152982711791992,6.199349403381348,10,6
1148,32,3.467099790010394,4.05800943945849,1.0159350524175328,1.0164251532126116,14,22,9.797119140625,6.199349403381348,18,10
1148,64,2.686922566066989,3.935206996586718,1.0084388075624797,1.019744860721835,28,56,10.351773262023926,6.199349403381348,36,8
1148,128,1.5115407362873523,3.9095391495824425,1.0034516599897227,1.0210864690025159,54,116,11.320168495178223,6.199349403381348,74,12
1149,1,9.35850483047912,9.358504830479127,0.9524086958594628,0.9524086958594649,0,0,9.465536117553711,9.465536117553711,1,1
1149,2,6.376218401491013,6.3762184014910135,1.0112666881838202,1.0112666881838188,0,0,9.538827896118164,9.465536117553711,2,2
1149,3,6.044936585640722,6.0449365856407224,1.0176578576076114,1.0176578576076094,0,0,10.173205375671387,9.465536117553711,3,3
1149,4,5.765573361008525,5.765573361008528,1.0221325544500592,1.0221325544500575,0,0,10.194647789001465,9.465536117553711,4,4
1149,8,5.472056464010826,5.472056464010828,1.0279883944586854,1.027988394458684,0,0,11.014510154724121,9.465536117553711,8,8
1149,16,5.26421716637165,5.270753441025566,1.0342194026327904,1.0338072883171128,2,3,11.40769100189209,9.465536117553711,14,13
1149,32,4.894279302878992,5.134848898292744,1.0355172415930802,1.0396801462738505,13,18,11.986059188842773,9.465536117553711,19,14
1149,64,3.5045642459267095,5.088317016400033,1.0197421553570338,1.042466073266018,32,45,12.709928512573242,9.465536117553711,32,19
1149,128,2.3358848704581816,5.081098481972518,1.0068742677467084,1.0431072509460955,58,110,13.542677879333496,9.465536117553711,70,18
1150,1,7.854868942475491,7.854868942475494,0.9601061971232656,0.9601061971232667,0,0,7.943813323974609,7.943813323974609,1,1
1150,2,6.725163799167908,6.725163799167909,0.9803570954337557,0.9803570954337564,0,0,8.684364318847656,7.943813323974609,2,2
1150,3,6.150807406069701,6.1508074060697,0.9904105551339204,0.9904105551339197,0,0,8.765071868896484,7.943813323974609,3,3
1150,4,5.7345948870113626,5.7345948870113626,0.9990590219449779,0.9990590219449769,0,0,9.000358581542969,7.943813323974609,4,4
1150,8,5.340237174057577,5.3408216407633855,1.0065632695836189,1.006566287646149,1,1,9.245037078857422,7.943813323974609,7,7
1150,16,4.853006767503633,4.945141350839439,1.0161018080254194,1.0143075236132413,3,4,9.855724334716797,7.943813323974609,13,12
1150,32,4.165052421506007,4.702450111979333,1.0145964341655773,1.0212982453488388,10,18,10.5913724899292,7.943813323974609,22,14
1150,64,3.2242527311869584,4.519257769320476,1.0143079875639205,1.028832882590695,27,45,11.263293266296387,7.943813323974609,37,19
1150,128,2.068334017814555,4.450889656083327,1.0045620083311637,1.032064345492064,66,108,11.87759780883789,7.943813323974609,62,20
1151,1,4.432754552646936,4.432754552646938,0.991633501390049,0.9916335013900498,0,0,4.440052509307861,4.440052509307861,1,1
1151,2,4.1134082733477895,4.1134082733477895,0.9951706255218784,0.9951706255218782,0,0,4.9283905029296875,4.440052509307861,2,2
1151,3,3.6249323744708435,3.6249323744708435,1.0003939868347445,1.0003939868347445,0,0,4.973283767700195,4.440052509307861,3,3
1151,4,3.620850185554838,3.6249323744708435,1.0003716598314525,1.0003939868347445,1,1,5.201859474182129,4.440052509307861,3,3
1151,8,3.082832356281349,3.198929699358838,1.0052535367289732,1.0068099933566699,2,2,6.070112705230713,4.440052509307861,6,6
1151,16,2.752676836728188,2.8303372937074522,1.0077513505043778,1.0100871496637729,4,5,6.5771403312683105,4.440052509307861,12,11
1151,32,2.2721749549678028,2.8156446895047247,1.0051870585747524,1.0107385472011687,14,19,7.4244608879089355,4.440052509307861,18,13
1151,64,1.4836290874776075,2.7967612808793403,1.0008839089122823,1.011986546801515,29,48,8.401593208312988,4.440052509307861,35,16
1151,128,0.628271310115894,2.7913027674185487,1.0006106534676376,1.0122666983336663,67,111,9.323142051696777,4.440052509307861,61,17
1152,1,9.056052302770281,9.056052302770283,0.956154792574038,0.9561547925740388,0,0,9.151260375976562,9.151260375976562,1,1
1152,2,7.505652515719888,7.505652515719888,0.9872744695548015,0.987274469554801,0,0,9.205744743347168,9.151260375976562,2,2
1152,3,6.941312882133141,6.941312882133141,0.9957655681683764,0.9957655681683786,0,0,9.24078369140625,9.151260375976562,3,3
1152,4,6.633436936677572,6.633436936677572,0.9992006716522623,0.9992006716522639,0,0,9.393576622009277,9.151260375976562,4,4
1152,8,5.999006578355,6.033459676342917,1.0148406679612587,1.0142680220692313,1,1,10.214089393615723,9.151260375976562,7,7
1152,16,5.51086530982422,5.879077355895413,1.0206843599983486,1.0207612562798285,6,6,10.822629928588867,9.151260375976562,10,10
1152,32,4.421112313415983,5.860970986103257,1.017034338411254,1.0210005098017974,12,19,11.330581665039062,9.151260375976562,20,13
1152,64,2.7570770854282673,5.858521698881117,1.0020502604041686,1.0215347051645227,29,49,11.953902244567871,9.151260375976562,35,15
1152,128,1.4019016336734298,5.652333557227581,1.0015873503169128,1.0254326208972078,64,114,12.36772346496582,9.151260375976562,64,14
1153,1,8.858813739003544,8.858813739003546,0.9492014660514309,0.9492014660514322,0,0,8.991483688354492,8.991483688354492,1,1
1153,2,6.945168847757881,6.94516884775788,0.9904249336458397,0.9904249336458398,0,0,9.137974739074707,8.991483688354492,2,2
1153,3,5.876964376916461,5.876964376916461,1.0072641767148967,1.0072641767148967,0,0,9.566386222839355,8.991483688354492,3,3
1153,4,5.8075211305138605,5.8075211305138605,1.0092026299534316,1.0092026299534314,0,0,9.608882904052734,8.991483688354492,4,4
1153,8,5.36647707343378,5.366477073433779,1.0187904255003108,1.018790425500311,0,0,9.743167877197266,8.991483688354492,8,8
1153,16,4.972244576482031,5.026670144354289,1.0267646265247932,1.0275274624898163,6,7,10.502885818481445,8.991483688354492,10,9
1153,32,4.415808444442566,4.980856302189927,1.026324000215193,1.0289943970102793,13,20,11.388607025146484,8.991483688354492,19,12
1153,64,2.8399260897112955,4.933866212020142,1.0122822775803413,1.030690608962061,33,51,12.205254554748535,8.991483688354492,31,13
1153,128,1.6334215463573813,4.924344020072157,1.0022543829789943,1.032443795147647,64,111,12.998313903808594,8.991483688354492,64,17
1154,1,8.873987144032105,8.873987144032109,0.9500666722553452,0.9500666722553472,0,0,8.99774169921875,8.99774169921875,1,1
1154,2,8.342053322477497,8.3420533224775,0.9659179683078696,0.9659179683078709,0,0,10.057056427001953,8.99774169921875,2,2
1154,3,8.159403046300906,8.159403046300909,0.9722249677535548,0.9722249677535562,0,0,10.314262390136719,8.99774169921875,3,3
1154,4,7.0423065978216774,7.042306597821677,0.9952083270607994,0.9952083270607999,0,0,10.32654857635498,8.99774169921875,4,4
1154,8,6.6053367919458275,6.90300140055194,1.0013353646755803,1.000494160758472,2,3,10.775918960571289,8.99774169921875,6,5
1154,16,5.874564601145716,6.315949076860323,1.009702631281039,1.0114939179790916,7,10,11.46233081817627,8.99774169921875,9,6
1154,32,5.205049251400492,6.184986946333541,1.0108941303365886,1.0177552553205222,13,22,12.087489128112793,8.99774169921875,19,10
1154,64,3.7734068086854156,6.029190267334856,1.005720640310713,1.0247211713478104,32,54,12.750605583190918,8.99774169921875,32,10
1154,128,2.3476887469321035,6.017542969800241,1.0030783135490626,1.0265534033411559,65,117,13.66841983795166,8.99774169921875,63,11
1155,1,6.316842228253497,6.316842228253501,0.9786403317909735,0.9786403317909754,0,0,6.348965167999268,6.348965167999268,1,1
1155,2,5.585970962280882,5.585970962280882,0.9927039842331511,0.9927039842331526,0,0,8.361299514770508,6.348965167999268,2,2
1155,3,5.382643410801724,5.382643410801723,0.9984748448249692,0.998474844824971,0,0,8.601637840270996,6.348965167999268,3,3
1155,4,5.175281144037151,5.175281144037151,1.0025590629249568,1.002559062924959,0,0,9.19401741027832,6.348965167999268,4,4
1155,8,4.728468961805352,4.742782011448043,1.0124389464478154,1.012724865995624,1,2,9.701244354248047,6.348965167999268,7,6
1155,16,4.4007023198201285,4.623752789027398,1.016278066287128,1.0172581496619244,5,8,10.450055122375488,6.348965167999268,11,8
1155,32,3.8715402352908126,4.54943737296977,1.0181202298388985,1.0215326358975931,14,20,11.356513023376465,6.348965167999268,18,12
1155,64,2.82999291961572,4.502518313935963,1.0098477712331808,1.024018840773993,33,49,12.08210277557373,6.348965167999268,31,15
1155,128,1.9058721857228147,4.425500964502962,1.0044187137210518,1.0296098094148332,64,108,12.666505813598633,6.348965167999268,64,20
1156,1,10.853456157234927,10.853456157234904,0.9106011983798966,0.9106011983798994,0,0,11.191218376159668,11.191218376159668,1,1
1156,2,10.555546124859646,10.55554612485965,0.9177308114878725,0.9177308114878738,0,0,11.28819751739502,11.191218376159668,2,2
1156,3,10.36751471838658,10.36751471838659,0.9268696391669748,0.9268696391669772,0,0,12.081831932067871,11.191218376159668,3,3
1156,4,10.34836067801675,10.36751471838659,0.926733915442682,0.9268696391669772,1,1,12.108341217041016,11.191218376159668,3,3
1156,8,9.617123704835793,9.777234554121963,0.944996792856363,0.9471699788986238,3,3,12.352781295776367,11.191218376159668,5,5
1156,16,8.63564903485406,9.382762753091345,0.9664435665339958,0.9619800698150812,6,10,12.643836975097656,11.191218376159668,10,6
1156,32,7.883984164012511,9.16436647949976,0.9819260152874487,0.9719977911637967,13,21,12.980395317077637,11.191218376159668,19,11
1156,64,6.2053009848198375,8.966697141598795,1.0029145343668644,0.9819539768731086,32,51,13.370953559875488,11.191218376159668,32,13
1156,128,3.0414547826158653,8.348531825987086,1.0049830008058003,1.0066053103832995,62,115,13.877364158630371,11.191218376159668,66,13
1157,1,7.580455553851925,7.580455553851928,0.9635455716116609,0.9635455716116619,0,0,7.66011381149292,7.66011381149292,1,1
1157,2,6.597920641257705,6.597920641257705,0.9823277071128315,0.9823277071128309,0,0,8.8558349609375,7.66011381149292,2,2
1157,3,6.5702050213480945,6.570205021348093,0.9828826908133101,0.9828826908133089,0,0,9.075942993164062,7.66011381149292,3,3
1157,4,6.336814188215767,6.336814188215767,0.9885383316034386,0.9885383316034382,0,0,9.274860382080078,7.66011381149292,4,4
1157,8,5.34862917761002,5.348629177610021,1.0095910356724054,1.0095910356724045,0,0,9.68736457824707,7.66011381149292,8,8
1157,16,4.806843861042075,5.141710380921611,1.0146101729177508,1.0162533200245742,5,7,10.279050827026367,7.66011381149292,11,9
1157,32,3.7668269556266476,4.693574292006975,1.0195313429782045,1.0268811824014739,14,19,10.68968677520752,7.66011381149292,18,13
1157,64,2.788195633159635,4.585431125199773,1.013879434216276,1.030467833216855,30,47,11.401272773742676,7.66011381149292,34,17
1157,128,1.5765589655639498,4.573102934988132,1.0057764051539657,1.0311575907526325,59,108,11.921366691589355,7.66011381149292,69,20
1158,1,9.475347913966909,9.475347913966909,0.9322772385815692,0.9322772385815689,0,0,9.694085121154785,9.694085121154785,1,1
1158,2,7.5989091191518945,7.598909119151894,0.9729584594978075,0.9729584594978065,0,0,9.734307289123535,9.694085121154785,2,2
1158,3,7.175491579009879,7.175491579009879,0.9852026282499576,0.9852026282499564,0,0,10.725379943847656,9.694085121154785,3,3
1158,4,7.169640166720522,7.16964016672052,0.9856984449184244,0.9856984449184231,0,0,10.89828109741211,9.694085121154785,4,4
1158,8,6.538547068217631,6.538547068217632,1.0061933960980938,1.0061933960980936,0,0,11.216756820678711,9.694085121154785,8,8
1158,16,5.586230332594104,5.642452663817295,1.0297266236611256,1.029433081609799,4,4,11.640986442565918,9.694085121154785,12,12
1158,32,5.0645820035190185,5.517803174633271,1.0273054984680858,1.0316858173057795,12,19,12.119376182556152,9.694085121154785,20,13
1158,64,4.081593713299493,5.443442635203239,1.0259867860093501,1.0363062694584766,26,48,12.83648681640625,9.694085121154785,38,16
1158,128,2.4521490941297426,5.325354970367897,1.0119229216034564,1.042904901286601,59,110,13.637801170349121,9.694085121154785,69,18
1159,1,9.678109441291394,9.678109441291395,0.9444275951790428,0.944427595179043,0,0,9.822221755981445,9.822221755981445,1,1
1159,2,8.251106247469496,8.251106247469494,0.9711863748949818,0.9711863748949812,0,0,9.893121719360352,9.822221755981445,2,2
1159,3,7.9719363548153375,7.9719363548153375,0.9779814847254933,0.9779814847254923,0,0,10.039628982543945,9.822221755981445,3,3
1159,4,7.67215683212519,7.67215683212519,0.9839946661984705,0.9839946661984698,0,0,10.083285331726074,9.822221755981445,4,4
1159,8,7.182870748919612,7.183377125007154,1.0001398108954611,1.000146284213675,1,1,10.45778751373291,9.822221755981445,7,7
1159,16,6.403388897209967,6.719496346166509,1.012833382904764,1.0126217349156275,5,4,11.22066593170166,9.822221755981445,11,12
1159,32,4.7838772084549595,6.055461704183543,1.0217254214140188,1.027145582775987,14,19,11.599647521972656,9.822221755981445,18,13
1159,64,3.553207691692527,5.674558876565989,1.0170178809850152,1.034198239065395,31,47,12.274149894714355,9.822221755981445,33,17
1159,128,2.1171143602422005,5.475193389577371,1.0042933393547964,1.0376587927100345,61,111,12.903350830078125,9.822221755981445,67,17
1160,1,7.501520818942395,7.501520818942395,0.9693756295214717,0.9693756295214733,0,0,7.558450222015381,7.558450222015381,1,1
1160,2,6.189166102932381,6.189166102932378,0.9915481532761123,0.9915481532761135,0,0,8.053492546081543,7.558450222015381,2,2
1160,3,5.510190026597622,5.510190026597621,1.0000834133835736,1.0000834133835745,0,0,8.160237312316895,7.558450222015381,3,3
1160,4,5.507034637692213,5.507034637692213,1.0001702884765893,1.0001702884765902,0,0,8.951142311096191,7.558450222015381,4,4
1160,8,5.1774962047766175,5.177668573011577,1.0116913556747675,1.011707163530168,1,1,9.358837127685547,7.558450222015381,7,7
1160,16,4.542308293097654,4.6638863218677145,1.021770376035276,1.0241219484043842,3,3,10.26884937286377,7.558450222015381,13,13
1160,32,3.8747859767482353,4.5159974432255305,1.0238561262007218,1.0292566969014176,12,17,10.92665958404541,7.558450222015381,20,15
1160,64,2.8789285152651547,4.447533365530537,1.0109869542796908,1.031398602687036,25,49,11.421753883361816,7.558450222015381,39,15
1160,128,1.896098086204004,4.421620124038419,1.007041964200719,1.0339653172654946,55,109,12.073506355285645,7.558450222015381,73,19
1161,1,9.408620445439473,9.408620445439476,0.9529208385067249,0.9529208385067269,0,0,9.515046119689941,9.515046119689941,1,1
1161,2,7.83248374376643,7.832483743766431,0.9894023780328973,0.9894023780328984,0,0,10.22703742980957,9.515046119689941,2,2
1161,3,7.427597101601193,7.427597101601193,0.9999250230289657,0.9999250230289676,0,0,10.691164016723633,9.515046119689941,3,3
1161,4,7.352328038319359,7.35232803831936,1.0022600739016625,1.0022600739016638,0,0,10.749160766601562,9.515046119689941,4,4
1161,8,7.116537070128358,7.153017739197243,1.0082253955358,1.0078720425056718,2,2,11.096558570861816,9.515046119689941,6,6
1161,16,6.235699358008294,6.710240896374296,1.017676952008568,1.0186862146300948,6,9,11.438008308410645,9.515046119689941,10,7
1161,32,5.238203100766732,6.618811930615318,1.020830529320763,1.022780264326445,19,22,12.05179500579834,9.515046119689941,13,10
1161,64,3.976627548741762,6.378049149662461,1.0189590239593267,1.0321570429073574,38,53,12.526891708374023,9.515046119689941,26,11
1161,128,2.0769712286664643,6.373353239008143,1.0004805530561063,1.0331908690678233,65,114,12.974316596984863,9.515046119689941,63,14
1162,1,10.785512464493872,10.785512464493838,0.923665994046442,0.923665994046445,0,0,11.029417991638184,11.029417991638184,1,1
1162,2,8.501162598847298,8.5011625988473,0.986210837037095,0.9862108370370959,0,0,11.051419258117676,11.029417991638184,2,2
1162,3,7.958381688603343,7.958381688603344,1.0025109985119511,1.0025109985119514,0,0,11.261780738830566,11.029417991638184,3,3
1162,4,7.880474877488952,7.880474877488952,1.0049768305364728,1.004976830536473,0,0,11.545966148376465,11.029417991638184,4,4
1162,8,7.126860157244318,7.12745380854663,1.0201011008389655,1.020250628267159,1,1,12.249665260314941,11.029417991638184,7,7
1162,16,6.419233549339189,6.637009263068646,1.031843904622383,1.0335719386959425,3,5,13.253764152526855,11.029417991638184,13,11
1162,32,5.558965803227558,6.472894142534028,1.0397155246954495,1.0432811782505365,13,17,14.16891860961914,11.029417991638184,19,15
1162,64,4.18561251316731,6.347289973605427,1.0214743077459003,1.0501147432458353,32,50,14.936835289001465,11.029417991638184,32,14
1162,128,2.59179713374296,6.342126846412232,1.0066915648760504,1.0509507402627414,60,112,16.02109146118164,11.029417991638184,68,16
1163,1,7.674577248095493,7.674577248095497,0.9682553785781102,0.9682553785781121,0,0,7.734503269195557,7.734503269195557,1,1
1163,2,6.3656072899224005,6.365607289922393,0.9884729033836122,0.9884729033836144,0,0,7.818531036376953,7.734503269195557,2,2
1163,3,5.9671067655635825,5.967106765563584,0.995142452444677,0.99514245244468,0,0,8.229681968688965,7.734503269195557,3,3
1163,4,5.74107641468125,5.74107641468125,0.9993268050970774,0.9993268050970793,0,0,8.372161865234375,7.734503269195557,4,4
1163,8,5.363302669868856,5.365056028750796,1.0065828388300782,1.0063970924613055,1,1,8.897632598876953,7.734503269195557,7,7
1163,16,4.781658365399999,4.95698434385063,1.0157611706888319,1.0154523203835317,3,7,9.464974403381348,7.734503269195557,13,9
1163,32,4.064738869238816,4.898308879061435,1.0143686982463265,1.0190163747299161,12,19,10.014586448669434,7.734503269195557,20,13
1163,64,2.7910041316921355,4.812926912303458,1.0054877015110006,1.0216461838172677,29,50,10.708732604980469,7.734503269195557,35,14
1163,128,1.4817467522123144,4.694331020415232,1.0039680626835836,1.027460303413138,64,110,11.381309509277344,7.734503269195557,64,18
1164,1,8.607844222713311,8.607844222713311,0.9527976304739584,0.9527976304739594,0,0,8.725454330444336,8.725454330444336,1,1
1164,2,7.623594347896131,7.62359434789613,0.9746517427193431,0.9746517427193432,0,0,9.680171012878418,8.725454330444336,2,2
1164,3,7.3871322376085065,7.3871322376085065,0.9813129353196621,0.981312935319662,0,0,9.82055377960205,8.725454330444336,3,3
1164,4,7.174821261433738,7.174821261433739,0.9840241067532269,0.984024106753227,0,0,10.059630393981934,8.725454330444336,4,4
1164,8,6.149846135439708,6.150206630599364,1.0083843762576752,1.0084412964725162,1,1,10.600174903869629,8.725454330444336,7,7
1164,16,5.839406541007643,6.030270936478791,1.0116106830913894,1.0113742704420938,5,8,11.042386054992676,8.725454330444336,11,8
1164,32,4.89398080042052,5.741304787142714,1.0232567555916363,1.0218310275909552,15,19,11.688647270202637,8.725454330444336,17,13
1164,64,3.530484276627488,5.390970973701171,1.0118759435214226,1.029616540871536,23,51,12.342528343200684,8.725454330444336,41,13
1164,128,2.325223075721214,5.338952729384554,1.0046750230678,1.032128547013996,71,112,12.88632869720459,8.725454330444336,57,16
1165,1,6.030915150061902,6.030915150061887,0.9794995583166644,0.9794995583166665,0,0,6.0625200271606445,6.0625200271606445,1,1
1165,2,4.706293579522485,4.706293579522486,0.9961704696129989,0.9961704696130009,0,0,6.761186122894287,6.0625200271606445,2,2
1165,3,4.404643783489311,4.40464378348931,1.0003824914655146,1.0003824914655166,0,0,6.8973002433776855,6.0625200271606445,3,3
1165,4,4.361173317886553,4.3611733178865535,1.0007051075663782,1.0007051075663795,0,0,6.940401554107666,6.0625200271606445,4,4
1165,8,4.23627638979177,4.23627638979177,1.0024902599375975,1.0024902599375993,0,0,7.106316566467285,6.0625200271606445,8,8
1165,16,3.596608359652202,3.7277624344325098,1.0119558792134202,1.0120419463229782,4,7,7.609154224395752,6.0625200271606445,12,9
1165,32,2.783015868929954,3.5756216421395544,1.0104864189566072,1.0142861967741728,16,16,7.979111194610596,6.0625200271606445,16,16
1165,64,2.08820687589835,3.451165706492515,1.0076865485433655,1.0158297809793404,34,50,8.382966995239258,6.0625200271606445,30,14
1165,128,0.8554796191364251,3.3675940561093154,1.0006496139815122,1.0181803821016473,59,106,9.196549415588379,6.0625200271606445,69,22
1166,1,10.926804551038552,10.926804551038556,0.934443204126851,0.9344432041268521,0,0,11.100428581237793,11.100428581237793,1,1
1166,2,8.1504396588879,8.1504396588879,1.000063055016867,1.0000630550168677,0,0,11.192769050598145,11.100428581237793,2,2
1166,3,7.836086313793244,7.836086313793245,1.006124331131127,1.0061243311311276,0,0,11.394768714904785,11.100428581237793,3,3
1166,4,7.813392731999496,7.813392731999496,1.0063697589469862,1.0063697589469858,0,0,11.486948013305664,11.100428581237793,4,4
1166,8,7.573325577708272,7.591622126394745,1.0125550235783858,1.0120257161386046,1,2,11.779073715209961,11.100428581237793,7,6
1166,16,7.1159367084155205,7.411516093979521,1.0250852786508642,1.0184988550983742,4,7,12.058443069458008,11.100428581237793,12,9
1166,32,6.157671900791855,6.885245020787249,1.0408555474246648,1.030172018111566,14,18,12.234582901000977,11.100428581237793,18,14
1166,64,4.885122512230024,6.750613773915237,1.042700543307447,1.034814807370053,32,48,12.61901569366455,11.100428581237793,32,16
1166,128,2.7725948362277184,6.454257927714737,1.0203851107705693,1.0424973090344232,65,109,13.06514835357666,11.100428581237793,63,19
1167,1,8.224051646024982,8.224051646024986,0.9580457720997287,0.9580457720997306,0,0,8.322162628173828,8.322162628173828,1,1
1167,2,6.987625079495489,6.987625079495491,0.982548217197077,0.9825482171970783,0,0,8.366012573242188,8.322162628173828,2,2
1167,3,6.742555893690163,6.742555893690163,0.9882201575458774,0.9882201575458779,0,0,8.783663749694824,8.322162628173828,3,3
1167,4,6.715548892577315,6.715548892577315,0.9891483770610918,0.9891483770610926,0,0,9.189530372619629,8.322162628173828,4,4
1167,8,5.7142079150316905,5.814170371980906,1.0089840740801095,1.0098236841864288,2,2,9.873900413513184,8.322162628173828,6,6
1167,16,5.172289199870529,5.622155131692224,1.0162431648165728,1.014506958216566,5,6,10.231085777282715,8.322162628173828,11,10
1167,32,4.480495633736059,5.233847377204446,1.0246759482871608,1.0259273696083415,13,20,10.60272216796875,8.322162628173828,19,12
1167,64,3.2286099212415684,5.155677966744136,1.014979766708151,1.0284771844558283,31,49,11.05569076538086,8.322162628173828,33,15
1167,128,1.9054248137564338,5.138768456068474,1.0026753476741268,1.0303111808050294,66,110,11.816498756408691,8.322162628173828,62,18
1168,1,7.687369775001187,7.687369775001189,0.971162722225257,0.9711627222252589,0,0,7.735867977142334,7.735867977142334,1,1
1168,2,6.697536126829664,6.697536126829663,0.9896969680836321,0.9896969680836332,0,0,8.876510620117188,7.735867977142334,2,2
1168,3,6.324635633264279,6.324635633264279,0.9962221047774624,0.9962221047774644,0,0,9.218098640441895,7.735867977142334,3,3
1168,4,5.73600188298726,5.736001882987259,1.0079201054365865,1.0079201054365878,0,0,9.31695556640625,7.735867977142334,4,4
1168,8,4.9603736073280755,4.96037360732808,1.022572436216368,1.022572436216369,0,0,9.581652641296387,7.735867977142334,8,8
1168,16,4.406545235524297,4.598499513720307,1.0276663991510566,1.0286611069777973,5,5,10.09041690826416,7.735867977142334,11,11
1168,32,3.712379068053965,4.527168792778572,1.0224681810735128,1.0308459698314643,12,19,10.884417533874512,7.735867977142334,20,13
1168,64,2.842641963334527,4.409901907556202,1.0153740635932293,1.0359289496112802,31,49,11.556169509887695,7.735867977142334,33,15
1168,128,1.6482655095517789,4.408351727514619,1.0043667895315167,1.0363819067412616,57,109,12.3593111038208,7.735867977142334,71,19
1169,1,9.95717892635325,9.957178926353253,0.9483857120064642,0.9483857120064654,0,0,10.07811164855957,10.07811164855957,1,1
1169,2,8.147300547523777,8.147300547523775,0.9906848777514317,0.990684877751431,0,0,10.746082305908203,10.07811164855957,2,2
1169,3,7.268739943283554,7.268739943283554,1.0100985568676912,1.0100985568676917,0,0,10.946369171142578,10.07811164855957,3,3
1169,4,6.209141381042362,6.209141381042362,1.0281642374279432,1.0281642374279427,0,0,11.075850486755371,10.07811164855957,4,4
1169,8,5.973430113142185,6.06851814426607,1.0321873970193178,1.0315103358064923,1,1,11.586579322814941,10.07811164855957,7,7
1169,16,5.665730997280119,5.984967739714033,1.0381712175505238,1.0352125951667812,4,6,12.058201789855957,10.07811164855957,12,10
1169,32,5.093860860694364,5.818882459582695,1.0403856609398876,1.0442145975060613,11,15,12.93539047241211,10.07811164855957,21,17
1169,64,3.6227311464449214,5.752669960424298,1.0138571117151542,1.0464239233684915,31,48,13.524174690246582,10.07811164855957,33,16
1169,128,2.2888104750085843,5.631867513954722,1.0058861102895027,1.0528760314458239,64,108,14.242741584777832,10.07811164855957,64,20
1170,1,13.006987883899114,13.006987883899123,0.9029948227205463,0.9029948227205493,0,0,13.307909965515137,13.307909965515137,1,1
1170,2,11.786481131363232,11.786481131363235,0.9506111518749443,0.9506111518749452,0,0,14.441414833068848,13.307909965515137,2,2
1170,3,11.551641699106309,11.55164169910631,0.959458483612796,0.9594584836127966,0,0,14.494003295898438,13.307909965515137,3,3
1170,4,11.200210788165094,11.200210788165093,0.9716055802405104,0.9716055802405097,0,0,14.544175148010254,13.307909965515137,4,4
1170,8,10.854485656248047,10.913028581278068,0.9793284437018834,0.9781908608438425,1,2,15.024744987487793,13.307909965515137,7,6
1170,16,9.629641588400832,9.931236490723233,1.014656342744125,1.0091399410980282,9,10,15.498525619506836,13.307909965515137,7,6
1170,32,8.109226087677223,9.15998710545986,1.044675105542285,1.0314692969759482,15,21,15.902522087097168,13.307909965515137,17,11
1170,64,6.596521365060427,8.94809155728772,1.026889534402657,1.0396829613785277,31,52,16.559228897094727,13.307909965515137,33,12
1170,128,4.570031517136076,8.945302931374357,1.008991239059753,1.0407301500752255,70,114,17.266653060913086,13.307909965515137,58,14
1171,1,4.858415397641399,4.8584153976414,0.981732343501646,0.9817323435016466,0,0,4.890481472015381,4.890481472015381,1,1
1171,2,4.298129474270647,4.298129474270647,0.9919053809157246,0.9919053809157246,0,0,5.550910472869873,4.890481472015381,2,2
1171,3,3.8884031718599354,3.888403171859936,0.9957943585386944,0.9957943585386946,0,0,6.0893778800964355,4.890481472015381,3,3
1171,4,3.369761237366822,3.3697612373668226,1.0028228279362734,1.0028228279362739,0,0,6.189137935638428,4.890481472015381,4,4
1171,8,2.9491014481366538,2.97674020233415,1.0054380817402415,1.0063737216394353,2,2,6.73972225189209,4.890481472015381,6,6
1171,16,2.734387708624849,2.794722495527669,1.0076845462765407,1.0091373474333918,7,7,7.332553386688232,4.890481472015381,9,9
1171,32,2.1606116780028675,2.6572014932649317,1.0059281787820118,1.0109216426739107,15,21,7.881294250488281,4.890481472015381,17,11
1171,64,1.5460868420422818,2.5227981484547346,1.0037577206182173,1.0146856067930985,30,51,8.506696701049805,4.890481472015381,34,13
1171,128,0.7981012660070887,2.5156098804550506,1.0016862238039919,1.0156868837595692,60,111,9.247629165649414,4.890481472015381,68,17
1172,1,7.510002347489778,7.510002347489782,0.9732922564986237,0.9732922564986263,0,0,7.551323413848877,7.551323413848877,1,1
1172,2,5.461042863156537,5.461042863156536,1.0027565487315426,1.0027565487315453,0,0,7.581039905548096,7.551323413848877,2,2
1172,3,5.258318064190644,5.258318064190661,1.0050278299952178,1.0050278299952198,0,0,7.724610328674316,7.551323413848877,3,3
1172,4,4.642270714074405,4.642270714074406,1.0116267516559916,1.0116267516559916,0,0,8.402002334594727,7.551323413848877,4,4
1172,8,4.299144266138299,4.359269655490046,1.0183617836722363,1.0175785334307925,2,1,9.610074043273926,7.551323413848877,6,7
1172,16,3.856639038338748,4.2941380670583875,1.017040994354535,1.0200820767374363,6,7,10.011240005493164,7.551323413848877,10,9
1172,32,3.210718229055529,4.098315507836869,1.0195945018096855,1.0241967619898389,12,21,10.467876434326172,7.551323413848877,20,11
1172,64,2.4628089128691695,3.9840643372325877,1.0113599743079065,1.0294427027472515,31,48,11.14197063446045,7.551323413848877,33,16
1172,128,1.5352976632827209,3.909381278956607,1.0022947479701068,1.0323436087716393,64,115,11.850279808044434,7.551323413848877,64,13
1173,1,8.350762267280734,8.35076226728074,0.9581784625819335,0.9581784625819352,0,0,8.446691513061523,8.446691513061523,1,1
1173,2,7.8312552307982415,7.831255230798244,0.9686143255573056,0.9686143255573068,0,0,8.60941219329834,8.446691513061523,2,2
1173,3,6.845186904525861,6.845186904525862,0.9866309089749192,0.9866309089749206,0,0,8.73233699798584,8.446691513061523,3,3
1173,4,6.642136928521693,6.642136928521692,0.989449720092547,0.9894497200925467,0,0,8.75637149810791,8.446691513061523,4,4
1173,8,5.695314111870436,5.707846575689673,1.00328938931283,1.0031782778796807,2,2,9.035846710205078,8.446691513061523,6,6
1173,16,5.083279558353269,5.222156755493103,1.0168282483604933,1.0135361546500559,5,8,9.332259178161621,8.446691513061523,11,8
1173,32,4.107270484580002,4.9152324060856385,1.0199282276892592,1.0194459456557348,15,22,9.74541187286377,8.446691513061523,17,10
1173,64,2.961637872357057,4.832509136397919,1.0126029042108375,1.0225032430102319,34,51,10.094024658203125,8.446691513061523,30,13
1173,128,1.461341678633543,4.711601580919623,1.0035984760926433,1.02581749181277,63,113,10.452404975891113,8.446691513061523,65,15
1174,1,7.98724390393961,7.987243903939617,0.9674868960268128,0.9674868960268181,0,0,8.044611930847168,8.044611930847168,1,1
1174,2,5.748741119938772,5.748741119938772,1.0015122399672012,1.0015122399672056,0,0,8.495993614196777,8.044611930847168,2,2
1174,3,5.234535825341122,5.23453582534112,1.0090782857609664,1.0090782857609695,0,0,8.901840209960938,8.044611930847168,3,3
1174,4,5.170539367324992,5.17053936732499,1.0104798277204048,1.0104798277204081,0,0,9.335472106933594,8.044611930847168,4,4
1174,8,4.702337770127031,4.716093066680368,1.0198392269207757,1.019562507262484,1,1,10.113234519958496,8.044611930847168,7,7
1174,16,4.2598841762263895,4.488370055867178,1.0281238742154137,1.027498336781624,5,5,10.738943099975586,8.044611930847168,11,11
1174,32,3.7071636935115584,4.475334035944753,1.0268934043286313,1.0284233676177648,13,20,11.521159172058105,8.044611930847168,19,12
1174,64,2.764514493849487,4.458584173876748,1.0141459746332862,1.030080040733716,32,49,12.520516395568848,8.044611930847168,32,15
1174,128,1.9046423550659972,4.446078664395224,1.002579043795288,1.0323209884936693,59,111,13.625411033630371,8.044611930847168,69,17
1175,1,6.055517084008469,6.055517084008474,0.9733367735213309,0.973336773521333,0,0,6.10986328125,6.10986328125,1,1
1175,2,5.211372891873734,5.211372891873735,0.9875870579385411,0.9875870579385426,0,0,6.49245548248291,6.10986328125,2,2
1175,3,4.960174765750018,4.960174765750019,0.9900790775247097,0.9900790775247107,0,0,6.599362373352051,6.10986328125,3,3
1175,4,4.539748849848371,4.539748849848372,0.9945417389847024,0.9945417389847037,0,0,6.646811008453369,6.10986328125,4,4
1175,8,4.322573670309563,4.322573670309564,0.9976640126871623,0.9976640126871629,0,0,7.09439754486084,6.10986328125,8,8
1175,16,3.681989495928297,3.962528636822831,1.0029865290813231,1.003311478452315,7,7,7.746044635772705,6.10986328125,9,9
1175,32,3.052599496825645,3.6733523832833033,1.0106239293154275,1.0107448686524692,13,19,8.042303085327148,6.10986328125,19,13
1175,64,2.2052152064448243,3.612083802099374,1.0071607809005014,1.0131518451300194,27,45,8.496397972106934,6.10986328125,37,19
1175,128,1.1007295015087912,3.547498148298993,1.0000597524899266,1.014563275587745,59,106,8.988133430480957,6.10986328125,69,22
1176,1,8.845834305665054,8.845834305665054,0.9680223933547334,0.9680223933547342,0,0,8.897008895874023,8.897008895874023,1,1
1176,2,7.858706453775572,7.858706453775571,0.9913218725564369,0.9913218725564369,0,0,9.899009704589844,8.897008895874023,2,2
1176,3,7.015287983101703,7.015287983101704,1.0127454166898917,1.0127454166898913,0,0,9.933566093444824,8.897008895874023,3,3
1176,4,6.652062742780294,6.652062742780294,1.0194413031770546,1.0194413031770535,0,0,10.411535263061523,8.897008895874023,4,4
1176,8,6.393999827371029,6.583408104371593,1.023131185939309,1.022621040582133,1,1,10.669892311096191,8.897008895874023,7,7
1176,16,6.2056363286738865,6.522729342145662,1.0232781384130254,1.0243042538482128,4,7,11.041766166687012,8.897008895874023,12,9
1176,32,4.560596717721271,6.474739310110491,1.0247264859052965,1.024935871252543,16,23,11.59666633605957,8.897008895874023,16,9
1176,64,3.872523655254682,6.182328730633728,1.0170034449668632,1.036996572076001,30,53,12.260616302490234,8.897008895874023,34,11
1176,128,2.173412143398238,6.1661712603610175,1.0040163624721776,1.0390683119733817,65,115,13.267171859741211,8.897008895874023,63,13
1177,1,8.69026422275018,8.690264222750184,0.9569297918271272,0.9569297918271291,0,0,8.784796714782715,8.784796714782715,1,1
1177,2,6.757438395306009,6.757438395306008,0.9904026224296264,0.990402622429627,0,0,8.828645706176758,8.784796714782715,2,2
1177,3,6.419790147937515,6.4197901479375155,0.9964564686045516,0.9964564686045525,0,0,9.2373046875,8.784796714782715,3,3
1177,4,6.019245849098976,6.019245849098976,1.0018838599447242,1.0018838599447235,0,0,9.295644760131836,8.784796714782715,4,4
1177,8,5.67124030424781,5.687641673382074,1.0098018800795932,1.0096523273301807,1,1,9.797914505004883,8.784796714782715,7,7
1177,16,5.013995729962278,5.265818336439242,1.0217575893516764,1.0190786054259575,6,9,10.556412696838379,8.784796714782715,10,7
1177,32,4.625455614402457,5.039036318752503,1.0259831047865753,1.0272466156892626,13,21,11.329869270324707,8.784796714782715,19,11
1177,64,3.5605493093449163,4.975932686057847,1.0122648464940702,1.030707006931554,29,50,12.091425895690918,8.784796714782715,35,14
1177,128,2.2120167305009284,4.932428124540857,1.002933044620332,1.0329469623738357,62,112,12.942304611206055,8.784796714782715,66,16
1178,1,12.13958915816304,12.139589158163048,0.8958157514131005,0.8958157514131023,0,0,12.542689323425293,12.542689323425293,1,1
1178,2,11.64671757227048,11.646717572270484,0.9135551178093398,0.9135551178093408,0,0,12.621705055236816,12.542689323425293,2,2
1178,3,10.769944831027798,10.769944831027802,0.9444337495299191,0.9444337495299207,0,0,12.6534423828125,12.542689323425293,3,3
1178,4,10.64805067256938,10.648050672569383,0.9484864135265679,0.948486413526569,0,0,12.789613723754883,12.542689323425293,4,4
1178,8,10.319807264971779,10.353246279508866,0.9579503917022297,0.9568533841707055,3,3,13.048225402832031,12.542689323425293,5,5
1178,16,8.170960136027244,8.411655240408491,1.0138960621211843,1.0090578724788077,4,5,13.530257225036621,12.542689323425293,12,11
1178,32,6.980573274601958,7.878519094815091,1.02930935760949,1.0224065941928693,12,20,13.831581115722656,12.542689323425293,20,12
1178,64,5.884025870556599,7.62646035485081,1.0246016879202062,1.033036903556525,25,45,14.343965530395508,12.542689323425293,39,19
1178,128,3.4081660819074173,7.47889919657523,1.010614408022254,1.0397685993808676,62,110,14.882063865661621,12.542689323425293,66,18
1179,1,2.928903591430404,2.928903591430404,0.9955147604307105,0.9955147604307096,0,0,2.9322073459625244,2.9322073459625244,1,1
1179,2,2.593771908820227,2.5937719088202265,0.9966344460387273,0.9966344460387273,0,0,3.0770490169525146,2.9322073459625244,2,2
1179,3,2.3573377482524536,2.3573377482524536,0.9992216915794505,0.9992216915794497,0,0,3.250800371170044,2.9322073459625244,3,3
1179,4,2.357329789009388,2.3573297890093876,0.9992266016493409,0.9992266016493393,0,0,3.250849723815918,2.9322073459625244,4,4
1179,8,1.9854752554260824,2.110769847973315,0.9999278397208379,1.0002082206160097,1,3,3.53538179397583,2.9322073459625244,7,5
1179,16,1.6785020421331347,2.089713702759097,1.0013359143769667,1.0008677210169517,6,8,3.818983316421509,2.9322073459625244,10,8
1179,32,1.2016408318101541,2.0307694069909217,1.0004541184521485,1.0019995456252517,16,22,4.137068271636963,2.9322073459625244,16,10
1179,64,0.6040062993600634,1.9168491181038336,0.9998228655102568,1.0030636459291409,32,53,4.690850257873535,2.9322073459625244,32,11
1179,128,0.03151863243141113,1.8742106940193086,0.9999652389930822,1.0029851857544927,69,115,5.348965644836426,2.9322073459625244,59,13
1180,1,2.8642628292999186,2.864262829299921,0.9917117821533428,0.9917117821533441,0,0,2.8757894039154053,2.8757894039154053,1,1
1180,2,2.4706293642889148,2.4706293642889157,0.9946053708218299,0.9946053708218305,0,0,2.8796005249023438,2.8757894039154053,2,2
1180,3,2.3461996358912103,2.3461996358912094,0.9958676858298379,0.9958676858298381,0,0,3.2098610401153564,2.8757894039154053,3,3
1180,4,2.2077492815056954,2.2077492815056945,0.9973128792750926,0.9973128792750932,0,0,3.296596050262451,2.8757894039154053,4,4
1180,8,1.5163257647759039,1.5599443564839723,1.0007714053638426,1.0008190568369784,2,3,3.474313497543335,2.8757894039154053,6,5
1180,16,1.166808311953747,1.3573417251997622,1.002127774972288,1.0018937878584961,7,10,3.7598979473114014,2.8757894039154053,9,6
1180,32,0.8962735133066113,1.3364007194395657,1.0014157397479795,1.0023571386628551,12,22,4.059167861938477,2.8757894039154053,20,10
1180,64,0.547815781353421,1.1853677323093994,1.0006742387619911,1.0029744530570217,31,53,4.517169952392578,2.8757894039154053,33,11
1180,128,0.03403155749022783,1.126605384023303,1.0000294231494307,1.0044228107268416,60,115,5.147834300994873,2.8757894039154053,68,13
1181,1,6.8245678930979485,6.8245678930979485,0.981885677326861,0.981885677326862,0,0,6.846742630004883,6.846742630004883,1,1
1181,2,5.001631414471772,5.001631414471772,1.0020983343118344,1.0020983343118357,0,0,7.3378472328186035,6.846742630004883,2,2
1181,3,4.996827771393353,4.9968277713933515,1.0026405916819625,1.0026405916819634,0,0,8.203105926513672,6.846742630004883,3,3
1181,4,4.861751347655556,4.861751347655556,1.0040095861908462,1.004009586190846,0,0,8.303115844726562,6.846742630004883,4,4
1181,8,4.624055202066706,4.625437890135966,1.0091797921049324,1.0093112690109867,1,1,9.114072799682617,6.846742630004883,7,7
1181,16,3.753192178303373,3.9898583370349283,1.0209325983873716,1.0206759209772036,5,9,9.366394996643066,6.846742630004883,11,7
1181,32,3.2621218186587684,3.964488469473515,1.0158434138180836,1.0211618605033712,13,21,9.565269470214844,6.846742630004883,19,11
1181,64,2.220975014478996,3.7878097088316225,1.0095330085851912,1.0236290672539274,27,57,9.836047172546387,6.846742630004883,37,7
1181,128,0.8894398418054198,3.7807615599026234,1.0023893390037952,1.0241625072764515,66,121,10.19367790222168,6.846742630004883,62,7
1182,1,10.0313194127278,10.03131941272781,0.9390993911281287,0.9390993911281311,0,0,10.199045181274414,10.199045181274414,1,1
1182,2,8.767426738325968,8.76742673832597,0.9655904321647704,0.9655904321647722,0,0,10.881735801696777,10.199045181274414,2,2
1182,3,8.578184284307124,8.578184284307106,0.9726868845618719,0.972686884561873,0,0,11.846586227416992,10.199045181274414,3,3
1182,4,7.985743987318883,7.985743987318884,0.992775461892663,0.992775461892665,0,0,12.077628135681152,10.199045181274414,4,4
1182,8,7.841935865214391,7.844573776884185,0.9985132703748298,0.9989453102559189,2,2,12.483295440673828,10.199045181274414,6,6
1182,16,6.877475870681154,7.6324691374165266,1.0026276785165784,1.009444959574764,4,7,12.997655868530273,10.199045181274414,12,9
1182,32,5.822592594040619,7.31790216022582,1.0181503165664316,1.0250976252578299,13,19,13.348989486694336,10.199045181274414,19,13
1182,64,3.7240156325671734,6.706155839998917,1.0137145697076126,1.0400107340972402,30,49,13.924654006958008,10.199045181274414,34,15
1182,128,2.3864537583487357,6.450636637731466,1.0079132632983532,1.04862647977183,62,113,14.586821556091309,10.199045181274414,66,15
1183,1,5.830973794147721,5.830973794147724,0.9808670216922424,0.9808670216922439,0,0,5.859317779541016,5.859317779541016,1,1
1183,2,5.174300126326771,5.174300126326773,0.9912698002772491,0.9912698002772506,0,0,6.792260646820068,5.859317779541016,2,2
1183,3,4.434037834168123,4.434037834168123,0.9990741177808311,0.9990741177808323,0,0,6.886516094207764,5.859317779541016,3,3
1183,4,4.261598967264554,4.265826133951478,1.0020476934791185,1.0020113833826454,1,1,6.890761852264404,5.859317779541016,3,3
1183,8,3.6270217352767564,3.6270217352767533,1.0119600152883976,1.0119600152883994,0,0,7.294798374176025,5.859317779541016,8,8
1183,16,3.157574178957542,3.365037966174034,1.012903393449303,1.016323145456136,5,8,7.902729034423828,5.859317779541016,11,8
1183,32,2.7143634891547848,3.202455652767607,1.0139085610654057,1.0193454421569645,13,18,8.473783493041992,5.859317779541016,19,14
1183,64,2.050331007151796,3.1747036209620823,1.0108684233383396,1.020483982921983,28,48,9.045950889587402,5.859317779541016,36,16
1183,128,1.006457005184461,3.0880213519758515,1.0012444643986147,1.0223657047412056,64,112,9.725461959838867,5.859317779541016,64,16
1184,1,8.904757539319844,8.904757539319847,0.9548411444925319,0.9548411444925328,0,0,9.00841236114502,9.00841236114502,1,1
1184,2,7.939238022954133,7.9392380229541315,0.9806098986102885,0.980609898610288,0,0,10.021876335144043,9.00841236114502,2,2
1184,3,7.0690535117506625,7.069053511750663,0.9986157464717842,0.9986157464717842,0,0,10.209611892700195,9.00841236114502,3,3
1184,4,6.042569133213674,6.042569133213674,1.0174853101115473,1.0174853101115473,0,0,10.383218765258789,9.00841236114502,4,4
1184,8,5.814166851858888,5.866299223761108,1.0196118233267406,1.019075235368399,1,1,10.941184043884277,9.00841236114502,7,7
1184,16,5.2729449402538515,5.559937509228814,1.0293177744494213,1.0249758139833054,4,7,11.107101440429688,9.00841236114502,12,9
1184,32,4.507673113290761,5.462719341862801,1.0214304261174307,1.0271045181646823,15,22,11.499665260314941,9.00841236114502,17,10
1184,64,4.048672048800742,5.380951229320101,1.0189132778535988,1.0298702969059312,29,52,11.750062942504883,9.00841236114502,35,12
1184,128,2.6151766640722407,5.234755367662639,1.0093858141281782,1.0341680265469417,61,115,12.059613227844238,9.00841236114502,67,13
1185,1,10.808673082952419,10.808673082952424,0.9238389378559838,0.9238389378559857,0,0,11.04481315612793,11.04481315612793,1,1
1185,2,10.45605718032186,10.456057180321864,0.940990734707108,0.9409907347071096,0,0,12.246007919311523,11.04481315612793,2,2
1185,3,9.750661909402714,9.750661909402714,0.966687023374279,0.9666870233742799,0,0,12.699737548828125,11.04481315612793,3,3
1185,4,9.445002384959094,9.445002384959094,0.974109418515505,0.9741094185155049,0,0,12.826956748962402,11.04481315612793,4,4
1185,8,8.187610771365149,8.244697086427477,1.0107838338342114,1.0093860672334012,2,2,13.146825790405273,11.04481315612793,6,6
1185,16,7.620305160042205,7.693038938674314,1.0262614332371076,1.023164736590751,2,5,13.556142807006836,11.04481315612793,14,11
1185,32,6.422764216152918,7.3394227492312965,1.040381476604216,1.0368687653741882,14,17,13.82721996307373,11.04481315612793,18,15
1185,64,5.286213947867684,7.177659891650342,1.0375514126274794,1.0409990818235855,27,43,14.170333862304688,11.04481315612793,37,21
1185,128,3.0545514472248074,7.003047510182892,1.0138262821861836,1.0478076791118145,61,107,14.529206275939941,11.04481315612793,67,21
1186,1,7.52813574739008,7.52813574739008,0.9682253347538007,0.9682253347538008,0,0,7.588778495788574,7.588778495788574,1,1
1186,2,5.053953228512574,5.053953228512574,1.0056300813902106,1.0056300813902104,0,0,8.417404174804688,7.588778495788574,2,2
1186,3,4.9850949430834195,4.9850949430834195,1.006643374670707,1.0066433746707064,0,0,8.572589874267578,7.588778495788574,3,3
1186,4,4.678121475173119,4.6815179755852805,1.00983606383638,1.0098512843539773,1,1,8.613600730895996,7.588778495788574,3,3
1186,8,4.368140996851596,4.422909734863601,1.0152800419707309,1.0147303971229622,2,2,9.171027183532715,7.588778495788574,6,6
1186,16,4.096034204958121,4.238384327024059,1.019713574755076,1.0191979740558532,5,6,10.019978523254395,7.588778495788574,11,10
1186,32,3.385326492752237,4.200716649803255,1.009359636456161,1.0219989467558346,14,18,11.237741470336914,7.588778495788574,18,14
1186,64,2.6514234608088207,4.149769196872996,1.0063756699847397,1.024878662401242,30,50,12.13463306427002,7.588778495788574,34,14
1186,128,1.4186678794085545,4.125054407193078,1.0013155286806992,1.0260912704289158,64,114,13.02433967590332,7.588778495788574,64,14
1187,1,11.224176510241474,11.224176510241477,0.9176875559889893,0.9176875559889902,0,0,11.486092567443848,11.486092567443848,1,1
1187,2,9.553401983198075,9.553401983198077,0.9620313970461891,0.9620313970461893,0,0,11.654111862182617,11.486092567443848,2,2
1187,3,9.193416770195482,9.19341677019548,0.969179953483553,0.9691799534835528,0,0,11.850118637084961,11.486092567443848,3,3
1187,4,8.239999136355177,8.239999136355177,0.9948636675302784,0.9948636675302778,0,0,12.338601112365723,11.486092567443848,4,4
1187,8,7.852057431869314,7.997144367671819,1.0001594986412101,1.0024516511494932,1,2,12.9491605758667,11.486092567443848,7,6
1187,16,7.402216527845362,7.821646704099561,1.014921848680768,1.0132706103009927,4,6,13.82361125946045,11.486092567443848,12,10
1187,32,6.330962816711632,7.404351587076508,1.0243766646470425,1.0256355159335413,16,21,14.300607681274414,11.486092567443848,16,11
1187,64,5.134570598115765,7.381981612387559,1.0167394689033038,1.0267082266574032,32,52,14.764094352722168,11.486092567443848,32,12
1187,128,3.120215228983516,7.166810962106543,1.0066476362121108,1.0402356333414196,65,112,15.410362243652344,11.486092567443848,63,16
1188,1,6.57760570552934,6.577605705529343,0.974996507053739,0.9749965070537415,0,0,6.619406223297119,6.619406223297119,1,1
1188,2,5.578897696794328,5.5788976967943285,0.9890099084896554,0.9890099084896568,0,0,6.816863059997559,6.619406223297119,2,2
1188,3,5.001732464410255,5.001732464410255,0.9956019946122185,0.9956019946122191,0,0,6.834229469299316,6.619406223297119,3,3
1188,4,4.653754123839226,4.653754123839226,1.0007895653464793,1.0007895653464798,0,0,7.469785690307617,6.619406223297119,4,4
1188,8,4.379692536090014,4.422200885248158,1.0051848558651035,1.0055197041799746,1,1,8.427603721618652,6.619406223297119,7,7
1188,16,4.2737020490367215,4.3182240275103965,1.0089930736188406,1.0099057556975444,5,5,8.747593879699707,6.619406223297119,11,11
1188,32,4.118978168387197,4.252004003228502,1.0087977559867867,1.01177117263562,13,16,9.406553268432617,6.619406223297119,19,16
1188,64,3.0659447720942468,4.180223365104664,1.003313182503557,1.0142696241551739,31,49,9.937427520751953,6.619406223297119,33,15
1188,128,1.6616356203032898,4.1090005792094875,1.0020479854372044,1.0194696989760677,63,109,10.927319526672363,6.619406223297119,65,19
1189,1,3.072055716015047,3.072055716015047,0.9950960669474715,0.9950960669474713,0,0,3.075824022293091,3.075824022293091,1,1
1189,2,2.3602200893052583,2.3602200893052583,0.999835106985605,0.9998351069856044,0,0,3.1149864196777344,3.075824022293091,2,2
1189,3,2.1844500652915895,2.1844500652915895,1.0000496866240811,1.0000496866240804,0,0,3.208200216293335,3.075824022293091,3,3
1189,4,2.076833332121229,2.076833332121229,1.0008636531653365,1.0008636531653354,0,0,3.290994167327881,3.075824022293091,4,4
1189,8,1.8817614439374726,1.99547691420195,1.001669868464813,1.0012885222018453,2,3,3.571441650390625,3.075824022293091,6,5
1189,16,1.5266351415028636,1.7221955347942934,1.0032017995346298,1.0025560218396279,7,11,4.0002031326293945,3.075824022293091,9,5
1189,32,1.0856093504403481,1.712426438329355,1.0020919997548439,1.0027449384616285,13,24,4.359278678894043,3.075824022293091,19,8
1189,64,0.49461762575997675,1.6422369745077587,0.9995719827982276,1.00355352718154,33,54,4.8237223625183105,3.075824022293091,31,10
1189,128,0.024008643259624988,1.6410645688787446,1.0000058786182895,1.0036469083453594,59,118,5.585228443145752,3.075824022293091,69,10
1190,1,10.307381312486653,10.307381312486656,0.9424758850967327,0.9424758850967339,0,0,10.448626518249512,10.448626518249512,1,1
1190,2,8.776396964985851,8.776396964985851,0.9780868282108262,0.9780868282108264,0,0,10.636744499206543,10.448626518249512,2,2
1190,3,8.608235468091578,8.608235468091578,0.9841622520161928,0.984162252016192,0,0,11.110401153564453,10.448626518249512,3,3
1190,4,8.336511925048379,8.336511925048383,0.9897126262799446,0.9897126262799439,0,0,11.157754898071289,10.448626518249512,4,4
1190,8,8.060746514598296,8.070506731785652,0.9983567722961251,0.9984540540956084,2,2,11.427340507507324,10.448626518249512,6,6
1190,16,7.099608044537879,7.368171329020424,1.0245773990832985,1.0193562141614922,5,5,11.893550872802734,10.448626518249512,11,11
1190,32,6.458066616846263,6.957928011647548,1.0352000225004394,1.0365620258941053,12,20,12.576788902282715,10.448626518249512,20,12
1190,64,4.477321819096864,6.658500530424959,1.0316124852162862,1.047073454920887,23,48,13.19542121887207,10.448626518249512,41,16
1190,128,2.6643418576801388,6.565056679546828,1.0071754619289681,1.0506075436856512,60,114,13.9173583984375,10.448626518249512,68,14
1191,1,9.139990115026906,9.139990115026905,0.9484461712366892,0.9484461712366905,0,0,9.269510269165039,9.269510269165039,1,1
1191,2,8.147908944775574,8.147908944775576,0.9761945294131054,0.9761945294131061,0,0,10.456239700317383,9.269510269165039,2,2
1191,3,8.138671983300469,8.13867198330047,0.977492693761044,0.977492693761045,0,0,11.613816261291504,9.269510269165039,3,3
1191,4,8.120226794791291,8.13867198330047,0.975917363192283,0.977492693761045,1,1,11.982211112976074,9.269510269165039,3,3
1191,8,6.797095907454548,7.24845613127699,1.0125123327583245,1.0100344651583697,3,3,12.864045143127441,9.269510269165039,5,5
1191,16,5.894489425067691,6.4952320176295055,1.0212120994595348,1.0279617343478464,8,9,13.698455810546875,9.269510269165039,8,7
1191,32,5.050561627969128,6.424804782130984,1.015231243792969,1.0344495253954205,13,21,14.531292915344238,9.269510269165039,19,11
1191,64,3.716016331754333,6.130416653722713,1.0203538291546772,1.0437354718214387,31,52,15.336811065673828,9.269510269165039,33,12
1191,128,2.2265952585334987,6.129971001574998,1.0067057891630409,1.0441086633809191,59,115,16.205371856689453,9.269510269165039,69,13
1192,1,8.297061507608342,8.297061507608342,0.9586194870512338,0.9586194870512336,0,0,8.392328262329102,8.392328262329102,1,1
1192,2,7.292843919264848,7.292843919264846,0.9786951548288948,0.9786951548288937,0,0,8.763223648071289,8.392328262329102,2,2
1192,3,6.732548698503976,6.732548698503976,0.989466283336274,0.9894662833362726,0,0,8.822000503540039,8.392328262329102,3,3
1192,4,6.593860537369174,6.593860537369173,0.9920356952089867,0.9920356952089855,0,0,9.442985534667969,8.392328262329102,4,4
1192,8,5.524646763582325,5.5901649481980495,1.0099605981599291,1.0098734194418557,3,3,9.863118171691895,8.392328262329102,5,5
1192,16,5.007319352744382,5.40648210623914,1.0143995801671157,1.0144027981135446,6,9,10.373451232910156,8.392328262329102,10,7
1192,32,3.97168627283582,5.157681891572583,1.0228584947461803,1.0215910009719056,12,21,10.809271812438965,8.392328262329102,20,11
1192,64,2.913053708882224,5.152895732999143,1.0094209776278906,1.0217976666574533,31,52,11.22882080078125,8.392328262329102,33,12
1192,128,1.5370791071202117,4.949975072088968,0.9991165532745405,1.0287054554481507,72,115,11.717188835144043,8.392328262329102,56,13
1193,1,3.0776745913547376,3.0776745913547403,0.990712283996696,0.9907122839966975,0,0,3.0912113189697266,3.0912113189697266,1,1
1193,2,2.5592432514096837,2.559243251409684,0.9962143527972157,0.996214352797217,0,0,3.0955140590667725,3.0912113189697266,2,2
1193,3,2.4214241671515744,2.4214241671515753,0.9962681717003707,0.9962681717003719,0,0,3.12884521484375,3.0912113189697266,3,3
1193,4,2.396547128431794,2.3965471284317954,0.9967430345454942,0.9967430345454961,0,0,3.133025646209717,3.0912113189697266,4,4
1193,8,1.8899022632779392,1.967399393888781,1.0004702273328514,1.000625486006105,2,2,3.3297317028045654,3.0912113189697266,6,6
1193,16,1.6625981273618797,1.843568641559922,1.0020617070794293,1.0021678348792729,6,7,3.6615264415740967,3.0912113189697266,10,9
1193,32,1.095324894349254,1.6859459767745826,1.0017628086718726,1.0034321557522201,13,23,3.866804838180542,3.0912113189697266,19,9
1193,64,0.4514895488495383,1.648276571652667,1.0004352017190428,1.003499132098332,28,51,4.277074337005615,3.0912113189697266,36,13
1193,128,0.03337596410117624,1.588976389860422,1.000003775247488,1.0040900979601608,61,115,4.7132415771484375,3.0912113189697266,67,13
1194,1,10.212307810860022,10.212307810860029,0.9244234161502267,0.924423416150229,0,0,10.46643352508545,10.46643352508545,1,1
1194,2,9.084240713695346,9.084240713695348,0.9550236026460235,0.9550236026460246,0,0,10.534704208374023,10.46643352508545,2,2
1194,3,8.320096911706688,8.32009691170669,0.973546739218135,0.9735467392181357,0,0,11.31475830078125,10.46643352508545,3,3
1194,4,8.021466266955201,8.021466266955201,0.983443601649729,0.9834436016497293,0,0,11.551344871520996,10.46643352508545,4,4
1194,8,7.656841956091743,7.668251801033854,0.9988712907964259,0.9985280803588236,1,1,11.88172435760498,10.46643352508545,7,7
1194,16,6.691934017167647,6.890043485420255,1.017336937556156,1.0155767718756246,4,5,12.29328727722168,10.46643352508545,12,11
1194,32,5.950536557579961,6.831208140984766,1.0138912432019023,1.0207166779873305,12,20,12.797533988952637,10.46643352508545,20,12
1194,64,4.234146485030282,6.7531117051250655,1.0074716827382404,1.0255440695624283,31,51,13.157608985900879,10.46643352508545,33,13
1194,128,2.839434663938892,6.704930259909799,1.0076578531719074,1.029278983595967,60,114,13.681896209716797,10.46643352508545,68,14
1195,1,6.946124217426511,6.9461242174265125,0.9686078749184075,0.9686078749184082,0,0,7.0088653564453125,7.0088653564453125,1,1
1195,2,6.333770190889788,6.33377019088979,0.9799767310246961,0.9799767310246958,0,0,7.5920562744140625,7.0088653564453125,2,2
1195,3,5.907497113951135,5.907497113951135,0.9894703642737939,0.9894703642737936,0,0,8.086258888244629,7.0088653564453125,3,3
1195,4,5.703760025849755,5.703760025849755,0.9932416426421165,0.9932416426421159,0,0,8.224746704101562,7.0088653564453125,4,4
1195,8,4.967637994485199,5.086012462613637,1.0050658463549667,1.0039604571612406,2,2,8.731635093688965,7.0088653564453125,6,6
1195,16,4.5462806028843366,4.723630863403098,1.0159869854909755,1.0160183679623518,4,5,9.599757194519043,7.0088653564453125,12,11
1195,32,3.558201715328111,4.556427504109881,1.0148716111915526,1.0215811627063147,17,20,10.129277229309082,7.0088653564453125,15,12
1195,64,2.9034292004518507,4.556050406303985,1.0092491217314354,1.0217398152864197,33,50,11.056029319763184,7.0088653564453125,31,14
1195,128,1.6642077773504653,4.450961550192477,1.0022018457314124,1.0290659199297822,64,108,12.062433242797852,7.0088653564453125,64,20
1196,1,6.148058998805137,6.14805899880514,0.9751809621180725,0.9751809621180767,0,0,6.194319725036621,6.194319725036621,1,1
1196,2,4.94588891947518,4.945888919475181,0.991515558546217,0.9915155585462186,0,0,6.644500255584717,6.194319725036621,2,2
1196,3,4.663263572671281,4.663263572671281,0.9973385187004071,0.9973385187004082,0,0,6.697732448577881,6.194319725036621,3,3
1196,4,4.338302925460701,4.3383029254607015,1.0025850869655697,1.0025850869655708,0,0,7.326001167297363,6.194319725036621,4,4
1196,8,4.174200968438544,4.3226014158097055,1.0038263955685072,1.003698556054029,2,2,8.280444145202637,6.194319725036621,6,6
1196,16,3.6880423850159185,3.8907956397199395,1.0119909382134589,1.0130158957855975,5,7,8.625162124633789,6.194319725036621,11,9
1196,32,2.9261384743277423,3.68773420421889,1.0113013146179453,1.0182309278357704,15,19,9.346138000488281,6.194319725036621,17,13
1196,64,2.266871254398682,3.615513149437304,1.0058606995983865,1.0208667600284633,33,49,10.023853302001953,6.194319725036621,31,15
1196,128,1.2104030230813203,3.5567158693482064,0.9997105874289884,1.0224717257138707,60,110,10.966485977172852,6.194319725036621,68,18
1197,1,6.4352513178239885,6.43525131782399,0.9761302967081456,0.9761302967081472,0,0,6.47542667388916,6.47542667388916,1,1
1197,2,5.9560979761468085,5.956097976146809,0.9859677749514874,0.9859677749514881,0,0,7.304702281951904,6.47542667388916,2,2
1197,3,5.75791550190647,5.75791550190647,0.9911389197645823,0.991138919764583,0,0,7.612554550170898,6.47542667388916,3,3
1197,4,5.637397146125256,5.637397146125255,0.9946559170811806,0.9946559170811805,0,0,7.6464524269104,6.47542667388916,4,4
1197,8,5.085403781844714,5.3936907650457036,1.0031609204877405,1.000106148022581,2,2,8.600845336914062,6.47542667388916,6,6
1197,16,4.5303944632468545,5.030611017414154,1.011300496393089,1.0119604198237822,6,8,9.536412239074707,6.47542667388916,10,8
1197,32,3.852330593857174,4.66212770976481,1.0184668596600277,1.0222876529078828,17,18,10.352869987487793,6.47542667388916,15,14
1197,64,2.5607510645012734,4.228213581765166,1.006960750041061,1.0276194086479853,30,49,11.275344848632812,6.47542667388916,34,15
1197,128,1.4598800621568089,4.111974453621751,1.000700649911809,1.030504725609152,65,110,12.26152229309082,6.47542667388916,63,18
1198,1,11.578153593536861,11.578153593536832,0.9204735569787582,0.9204735569787615,0,0,11.819544792175293,11.819544792175293,1,1
1198,2,10.074974389177466,10.074974389177468,0.964051103341693,0.9640511033416943,0,0,12.703758239746094,11.819544792175293,2,2
1198,3,9.758296821412198,9.7582968214122,0.9745772201242193,0.9745772201242204,0,0,12.769515037536621,11.819544792175293,3,3
1198,4,9.116350990069014,9.116350990069014,0.9996237378172399,0.999623737817241,0,0,13.692355155944824,11.819544792175293,4,4
1198,8,7.883888474754963,7.9007549042910945,1.0247553491671635,1.0254144428018173,1,1,14.046591758728027,11.819544792175293,7,7
1198,16,7.576221315779395,7.735364193006377,1.0327450231797421,1.0325668799625267,5,6,14.465705871582031,11.819544792175293,11,10
1198,32,6.489196275865782,7.518036333014192,1.0386487083921798,1.0386953462122865,13,21,14.901934623718262,11.819544792175293,19,11
1198,64,5.285315554483906,7.461666516175808,1.0461701975793372,1.0425067496180833,28,50,15.415371894836426,11.819544792175293,36,14
1198,128,3.308013242440467,7.423739238848711,1.0149317878435937,1.045991620305596,67,113,15.885680198669434,11.819544792175293,61,15
1199,1,8.90141164791715,8.901411647917156,0.958656115720725,0.9586561157207276,0,0,8.986449241638184,8.986449241638184,1,1
1199,2,8.173691491732836,8.173691491732836,0.9766899618880402,0.9766899618880418,0,0,9.435534477233887,8.986449241638184,2,2
1199,3,6.987662193660788,6.987662193660789,0.9972396430151999,0.9972396430152017,0,0,9.460686683654785,8.986449241638184,3,3
1199,4,6.3381698887994515,6.338169888799453,1.0069558432922472,1.0069558432922492,0,0,9.720047950744629,8.986449241638184,4,4
1199,8,6.0837403750576895,6.109729281114909,1.0104614452159104,1.0108180090941545,1,1,10.101001739501953,8.986449241638184,7,7
1199,16,5.199129246639402,5.62979884266176,1.0200237412038944,1.0202690254249789,5,6,11.205897331237793,8.986449241638184,11,10
1199,32,4.232315823503006,5.549043750872832,1.0203451634534269,1.0256748614576108,11,21,11.8594331741333,8.986449241638184,21,11
1199,64,2.9355176199594655,5.493849993532817,1.0101887723891567,1.0299281596774121,28,50,12.677504539489746,8.986449241638184,36,14
1199,128,1.8616697094440011,5.410256308604729,1.0039180364249898,1.033350871707237,63,109,13.519765853881836,8.986449241638184,65,19
1200,1,10.046168139591936,10.04616813959194,0.9336967488195324,0.9336967488195332,0,0,10.242093086242676,10.242093086242676,1,1
1200,2,8.287830873490385,8.287830873490385,0.9818573347915529,0.9818573347915533,0,0,10.668230056762695,10.242093086242676,2,2
1200,3,7.975845527726824,7.975845527726823,0.9906184214827322,0.9906184214827323,0,0,11.02121639251709,10.242093086242676,3,3
1200,4,7.974868081255435,7.974868081255436,0.9908005266742798,0.9908005266742789,0,0,11.295080184936523,10.242093086242676,4,4
1200,8,7.771093131247033,7.779121399084704,0.9974078070676866,0.9977187100226979,3,3,11.70335578918457,10.242093086242676,5,5
1200,16,7.110632348692832,7.343244355220297,1.0111544436772928,1.0108032498036537,6,7,11.956254959106445,10.242093086242676,10,9
1200,32,6.393669114469367,6.9885308429704045,1.0186759320563143,1.0186065474150379,15,20,12.235386848449707,10.242093086242676,17,12
1200,64,4.429205145757129,6.722448978704895,1.0129745538581203,1.0218046169933785,31,49,12.709602355957031,10.242093086242676,33,15
1200,128,2.4800715940061897,6.624051835780782,1.003016239798523,1.026821639714596,63,107,13.152090072631836,10.242093086242676,65,21
1201,1,3.1330481568471784,3.133048156847168,0.993793774664971,0.9937937746649728,0,0,3.1389288902282715,3.1389288902282715,1,1
1201,2,2.590121258470041,2.5901212584700386,0.9983511331763317,0.9983511331763331,0,0,3.6887898445129395,3.1389288902282715,2,2
1201,3,2.489598586006538,2.489598586006539,0.9980923609529994,0.9980923609530006,0,0,3.793010950088501,3.1389288902282715,3,3
1201,4,2.1664043112638485,2.1664043112638494,0.9999094051578857,0.999909405157887,0,0,3.886695146560669,3.1389288902282715,4,4
1201,8,2.0275294423594254,2.029981130284647,1.0003222747482161,1.000522879647875,1,2,4.150298118591309,3.1389288902282715,7,6
1201,16,1.8662529999684578,1.9733101952502623,1.0009611695684169,1.0011979354023062,5,8,4.5498504638671875,3.1389288902282715,11,8
1201,32,1.5758796315154198,1.9442576304148942,1.0006229096752555,1.0020739009705388,10,20,4.9609880447387695,3.1389288902282715,22,12
1201,64,0.9271003301189263,1.9442576304148942,0.9994054077632821,1.0020739009705384,35,52,5.377164840698242,3.1389288902282715,29,12
1201,128,0.1839502455048173,1.8716530265858955,0.9999581647567228,1.0034290198439577,66,118,5.770195007324219,3.1389288902282715,62,10
1202,1,12.120863970896478,12.120863970896483,0.9113859517959774,0.9113859517959793,0,0,12.391658782958984,12.391658782958984,1,1
1202,2,10.24093155520038,10.240931555200381,0.9625062035639744,0.9625062035639753,0,0,12.455766677856445,12.391658782958984,2,2
1202,3,9.024493002975646,9.024493002975648,0.9913917718474827,0.9913917718474823,0,0,13.011898040771484,12.391658782958984,3,3
1202,4,8.772451795193108,8.772451795193108,1.0009756264369782,1.0009756264369782,0,0,13.556421279907227,12.391658782958984,4,4
1202,8,8.178156277917077,8.178156277917074,1.0171081334793477,1.0171081334793461,0,0,14.016335487365723,12.391658782958984,8,8
1202,16,6.990324235252534,7.387127030797314,1.0489242267521783,1.0407274894317295,5,5,14.418919563293457,12.391658782958984,11,11
1202,32,6.087299368705426,7.372904354436286,1.0417960620590987,1.0410792432574871,13,20,14.955322265625,12.391658782958984,19,12
1202,64,4.978459946096564,7.218621845555954,1.0433539626004125,1.0499228564132075,26,50,15.351502418518066,12.391658782958984,38,14
1202,128,3.511762815826712,7.182172752148781,1.0225543680904818,1.0536411635704894,60,111,15.890591621398926,12.391658782958984,68,17
1203,1,8.156298081487286,8.156298081487293,0.9593059147281822,0.9593059147281855,0,0,8.245341300964355,8.245341300964355,1,1
1203,2,6.3630358286606485,6.36303582866065,0.9872131668125645,0.9872131668125657,0,0,8.342802047729492,8.245341300964355,2,2
1203,3,6.221947416466928,6.221947416466929,0.991421517769155,0.9914215177691557,0,0,8.726043701171875,8.245341300964355,3,3
1203,4,6.207876945925356,6.207876945925356,0.9924009516563858,0.9924009516563868,0,0,8.913365364074707,8.245341300964355,4,4
1203,8,5.831512811490337,5.835011590563028,1.003180907429944,1.0033441166908657,1,1,9.652867317199707,8.245341300964355,7,7
1203,16,5.44938411143339,5.741226113794579,1.005938632289069,1.0089022185487093,6,7,10.545552253723145,8.245341300964355,10,9
1203,32,4.44819103273598,5.251645664771527,1.0133646251260988,1.021992396130409,11,24,11.187947273254395,8.245341300964355,21,8
1203,64,3.6493368632595926,5.114810781857797,1.003860376678533,1.0277462446656256,31,53,11.78676986694336,8.245341300964355,33,11
1203,128,2.4119425325378465,5.000441964913426,0.9960113456830917,1.033527597838114,61,109,12.549089431762695,8.245341300964355,67,19
1204,1,11.368679241263827,11.368679241263827,0.9250657396355207,0.9250657396355206,0,0,11.591559410095215,11.591559410095215,1,1
1204,2,10.463860412303747,10.463860412303747,0.9584934124760176,0.9584934124760178,0,0,12.289952278137207,11.591559410095215,2,2
1204,3,9.968345457054607,9.968345457054607,0.9722696582851631,0.9722696582851633,0,0,12.527071952819824,11.591559410095215,3,3
1204,4,9.448254399779284,9.448254399779284,0.9867019436366873,0.9867019436366872,0,0,12.72916030883789,11.591559410095215,4,4
1204,8,8.193765746174575,8.212858901391073,1.0174648561081,1.0175120448861001,1,1,12.960345268249512,11.591559410095215,7,7
1204,16,7.551319955542958,7.788860045297126,1.0333299541545868,1.0299313942869666,6,7,13.566252708435059,11.591559410095215,10,9
1204,32,6.632480945368105,7.507892208736429,1.0479420170715255,1.0423094346164254,11,17,14.109562873840332,11.591559410095215,21,15
1204,64,5.273475928223116,7.387786455841973,1.0305586425270041,1.046679803914634,29,47,14.537256240844727,11.591559410095215,35,17
1204,128,3.2623500874179046,7.269733253084074,1.0182611924040468,1.0529826448098358,62,109,14.95944595336914,11.591559410095215,66,19
1205,1,7.563935172975003,7.563935172975007,0.9665103685331201,0.9665103685331218,0,0,7.630890846252441,7.630890846252441,1,1
1205,2,6.0373283804125455,6.0373283804125455,0.9899807661904138,0.9899807661904139,0,0,7.948000431060791,7.630890846252441,2,2
1205,3,5.2102674410152146,5.210267441015215,1.0051001788778826,1.0051001788778828,0,0,7.971286773681641,7.630890846252441,3,3
1205,4,5.023165215905468,5.023165215905468,1.0084717631595246,1.008471763159524,0,0,8.180839538574219,7.630890846252441,4,4
1205,8,4.482189187544898,4.485397435627746,1.014356153833805,1.0144254838969853,1,1,8.523366928100586,7.630890846252441,7,7
1205,16,3.8532737617573205,4.035620134421255,1.0227645756280057,1.0225264445958242,4,4,8.873686790466309,7.630890846252441,12,12
1205,32,3.2920885512656763,3.8836972665487477,1.019603726680378,1.0261572770327025,14,19,9.530243873596191,7.630890846252441,18,13
1205,64,2.2381088668001348,3.839798485716147,1.011382125585299,1.0279687720901711,28,49,10.07149887084961,7.630890846252441,36,15
1205,128,1.239754256406512,3.7795951291498264,1.0034548829090442,1.0307807531156008,61,111,10.820834159851074,7.630890846252441,67,17
1206,1,6.9083208178626885,6.90832081786269,0.9826409256612617,0.9826409256612624,0,0,6.928286552429199,6.928286552429199,1,1
1206,2,5.549406030874883,5.549406030874883,1.0027862711756608,1.00278627117566,0,0,7.622761249542236,6.928286552429199,2,2
1206,3,5.15464559204785,5.15464559204785,1.0081015134491094,1.0081015134491087,0,0,8.378523826599121,6.928286552429199,3,3
1206,4,4.9590317107942035,4.959031710794204,1.0124532859609674,1.0124532859609674,0,0,9.356422424316406,6.928286552429199,4,4
1206,8,4.630965512797681,4.7254360309534915,1.0182824367995016,1.0176391570706178,3,4,9.674434661865234,6.928286552429199,5,4
1206,16,4.055841003445467,4.272334012630586,1.0226963463344931,1.0283562164089655,4,5,10.506810188293457,6.928286552429199,12,11
1206,32,3.5005416561595566,4.140027243429898,1.0253343929575338,1.0342362556932012,13,19,11.297805786132812,6.928286552429199,19,13
1206,64,2.9129887509000274,4.123520716513938,1.0150434732924931,1.0343379758278872,29,50,11.845990180969238,6.928286552429199,35,14
1206,128,1.9056245938167182,4.064356175093313,1.0028903451309104,1.0366464409373595,69,111,12.315732955932617,6.928286552429199,59,17
1207,1,7.381393835988237,7.381393835988237,0.9709717562604421,0.9709717562604441,0,0,7.431569576263428,7.431569576263428,1,1
1207,2,6.111570470149526,6.111570470149527,0.9915268193455875,0.9915268193455877,0,0,8.350830078125,7.431569576263428,2,2
1207,3,5.925665764843031,5.925665764843032,0.995346050688245,0.9953460506882454,0,0,9.087183952331543,7.431569576263428,3,3
1207,4,5.50353333399613,5.50353333399613,1.0040817549016403,1.0040817549016408,0,0,9.169870376586914,7.431569576263428,4,4
1207,8,5.170136458671299,5.170978453177602,1.01578047452267,1.0157241367049594,1,1,10.30180549621582,7.431569576263428,7,7
1207,16,4.7656768973639965,4.997881734814444,1.0178432486156848,1.0221194492372803,5,5,11.237384796142578,7.431569576263428,11,11
1207,32,4.179573566804887,4.810126617719997,1.0140503113430979,1.0239749065753023,14,21,12.134391784667969,7.431569576263428,18,11
1207,64,2.9764430099577317,4.7803749724438305,1.0049906240179527,1.0266569128577483,31,50,12.840238571166992,7.431569576263428,33,14
1207,128,1.9140415664907398,4.750191114122023,1.0030920615146717,1.0288665620631727,63,115,13.398970603942871,7.431569576263428,65,13
1208,1,10.333765238037904,10.333765238037909,0.9471283846319065,0.9471283846319081,0,0,10.454121589660645,10.454121589660645,1,1
1208,2,8.17135985187282,8.171359851872822,0.9905566082942276,0.9905566082942281,0,0,10.557244300842285,10.454121589660645,2,2
1208,3,7.342387836815241,7.342387836815242,1.0054545439396476,1.0054545439396478,0,0,10.682851791381836,10.454121589660645,3,3
1208,4,7.342002647970536,7.342387836815242,1.0054545019792829,1.0054545439396478,1,1,11.200671195983887,10.454121589660645,3,3
1208,8,6.9208651168336495,6.924018618987618,1.0174126198562314,1.017247487793485,1,1,11.670458793640137,10.454121589660645,7,7
1208,16,6.284734444727653,6.436662202474844,1.026407189754838,1.025711449193109,4,9,11.988786697387695,10.454121589660645,12,7
1208,32,5.391660586415801,5.937980066298517,1.0358725709928072,1.0407876688568287,14,20,12.651162147521973,10.454121589660645,18,12
1208,64,4.557946385805653,5.817421630746337,1.0359081717542191,1.0445698584328031,32,47,12.987791061401367,10.454121589660645,32,17
1208,128,2.479447897430236,5.801554922130997,1.0123815005714276,1.045802064540406,61,109,13.317110061645508,10.454121589660645,67,19
1209,1,7.825604750131096,7.825604750131096,0.9522254316809007,0.9522254316809008,0,0,7.958384037017822,7.958384037017822,1,1
1209,2,6.623887505571261,6.62388750557126,0.9749925587349992,0.9749925587349983,0,0,8.140950202941895,7.958384037017822,2,2
1209,3,6.619606257273413,6.619606257273411,0.9754609686206773,0.9754609686206757,0,0,9.116447448730469,7.958384037017822,3,3
1209,4,6.61943434156486,6.619434341564858,0.9755868915665541,0.9755868915665531,0,0,9.190486907958984,7.958384037017822,4,4
1209,8,6.397707490056096,6.425842105698488,0.9834812203075417,0.9840476582636681,2,2,9.624661445617676,7.958384037017822,6,6
1209,16,5.16675027913217,5.639419686792101,1.0029167819414502,1.0050700971616053,8,9,10.416314125061035,7.958384037017822,8,7
1209,32,4.101965248675509,5.392542345162248,1.0056952627091749,1.0094205330047952,14,21,11.094461441040039,7.958384037017822,18,11
1209,64,3.1407297982769373,5.379287646015442,0.9985345812955295,1.010421553698774,28,53,11.844465255737305,7.958384037017822,36,11
1209,128,2.0125883341422726,5.315390655957809,0.997841328925194,1.0161791546566858,59,117,12.717416763305664,7.958384037017822,69,11
1210,1,8.502586130951507,8.502586130951494,0.9521407846555299,0.9521407846555306,0,0,8.62338638305664,8.62338638305664,1,1
1210,2,7.563494752344547,7.563494752344546,0.9804889909027076,0.9804889909027072,0,0,10.30601978302002,8.62338638305664,2,2
1210,3,7.514436268894387,7.514436268894385,0.9826379226545462,0.9826379226545456,0,0,10.519407272338867,8.62338638305664,3,3
1210,4,7.091523442868324,7.091523442868323,0.9909852749451169,0.9909852749451167,0,0,10.763368606567383,8.62338638305664,4,4
1210,8,6.614647222104096,6.621728858432141,1.0041332995863321,1.0043739952733979,1,1,10.906404495239258,8.62338638305664,7,7
1210,16,5.913431670806388,6.369136703965999,1.0071571349994646,1.011288695207207,6,5,11.347763061523438,8.62338638305664,10,11
1210,32,5.3332151742759875,6.118927769958805,1.01783504936983,1.022361655677228,14,17,11.973617553710938,8.62338638305664,18,15
1210,64,4.407940607215223,5.956045461068394,1.0080060979487298,1.0285454397698013,30,47,12.59475326538086,8.62338638305664,34,17
1210,128,2.856555974390979,5.837688320468854,1.007242307420452,1.037388140969143,64,108,13.328585624694824,8.62338638305664,64,20
1211,1,2.749052719173469,2.7490527191734735,0.9941398729536507,0.9941398729536544,0,0,2.755000352859497,2.755000352859497,1,1
1211,2,2.4832135592997426,2.4832135592997435,0.9972731383186362,0.9972731383186396,0,0,3.482853889465332,2.755000352859497,2,2
1211,3,2.392441351791037,2.392441351791037,0.998913555322694,0.9989135553226967,0,0,3.5230391025543213,2.755000352859497,3,3
1211,4,2.292023395760078,2.2920233957600775,0.9995086832226159,0.9995086832226155,0,0,3.7427380084991455,2.755000352859497,4,4
1211,8,2.232231421812845,2.2859812241057416,1.0005369112756015,0.9999270813933094,2,2,4.4464569091796875,2.755000352859497,6,6
1211,16,2.0623144522691708,2.2228245738665793,1.0027174960898437,1.0008106439344826,5,7,4.767393589019775,2.755000352859497,11,9
1211,32,1.6256814686944776,2.1381546179263884,1.0018187601170787,1.0018028416370357,17,21,5.387718677520752,2.755000352859497,15,11
1211,64,1.043227551268355,2.1029485733377262,1.0001945337714293,1.0025972147925737,29,52,5.7945122718811035,2.755000352859497,35,12
1211,128,0.519733080843072,2.0579203814107005,1.0013616555021219,1.0042189200183256,61,116,6.6006388664245605,2.755000352859497,67,12
1212,1,7.9778099177612365,7.977809917761241,0.9541077393607305,0.9541077393607329,0,0,8.095917701721191,8.095917701721191,1,1
1212,2,6.665808497242859,6.665808497242862,0.9821998271182079,0.9821998271182106,0,0,8.318626403808594,8.095917701721191,2,2
1212,3,6.136308818630965,6.136308818630965,0.9895860588406206,0.9895860588406215,0,0,9.246524810791016,8.095917701721191,3,3
1212,4,6.063735339843675,6.063735339843677,0.9910904318984588,0.9910904318984604,0,0,9.308174133300781,8.095917701721191,4,4
1212,8,5.639679592095777,5.650653977025645,1.0004402081821167,1.000053748580175,1,1,9.515816688537598,8.095917701721191,7,7
1212,16,4.870323051507622,5.306367737502937,1.0082387596211517,1.006422798043996,4,7,9.99297046661377,8.095917701721191,12,9
1212,32,4.121857833683249,4.978570174927951,1.015272944319023,1.014015576603942,14,22,10.403938293457031,8.095917701721191,18,10
1212,64,3.112630211294771,4.975054667462137,1.0056938752381699,1.0141897240685682,27,51,10.68937873840332,8.095917701721191,37,13
1212,128,1.751042676951186,4.869614447074621,1.000510064781976,1.017513991891033,69,116,11.221563339233398,8.095917701721191,59,12
1213,1,2.311625011192626,2.311625011192626,1.0018087748250435,1.0018087748250435,0,0,2.312277317047119,2.312277317047119,1,1
1213,2,2.2276292707389085,2.2276292707389085,1.0023058973213492,1.002305897321349,0,0,3.0385541915893555,2.312277317047119,2,2
1213,3,2.0804698135139454,2.080469813513946,1.0033858208033655,1.003385820803365,0,0,3.0453946590423584,2.312277317047119,3,3
1213,4,1.7970885932179335,1.7970885932179341,1.0035471018552578,1.0035471018552569,0,0,3.0619804859161377,2.312277317047119,4,4
1213,8,1.5131842978984933,1.5162130555040971,1.0054947379522443,1.0054032685667884,1,1,3.372860908508301,2.312277317047119,7,7
1213,16,1.2822130807235192,1.4179798415319904,1.0042497744089327,1.0050599373953122,5,7,3.718797206878662,2.312277317047119,11,9
1213,32,0.8029469917302987,1.382245084107909,1.0018390681369862,1.0054334266862022,14,23,4.148814678192139,2.312277317047119,18,9
1213,64,0.3309867846942386,1.3680223182090154,1.0004703427457553,1.005833800613192,27,53,4.466559886932373,2.312277317047119,37,11
1213,128,0.025194805297635514,1.3550974827322295,1.0000145176584865,1.005845079932905,66,119,5.003276348114014,2.312277317047119,62,9
1214,1,4.186771908787058,4.186771908787059,0.9877887516956919,0.9877887516956922,0,0,4.203762054443359,4.203762054443359,1,1
1214,2,3.9730605845275746,3.973060584527575,0.9902959370626958,0.9902959370626964,0,0,4.457523345947266,4.203762054443359,2,2
1214,3,3.7154273455025026,3.7154273455025026,0.9929793006451196,0.9929793006451196,0,0,4.475757122039795,4.203762054443359,3,3
1214,4,3.613109960955225,3.613109960955225,0.993406142061842,0.9934061420618421,0,0,4.482821464538574,4.203762054443359,4,4
1214,8,2.793341848272117,2.9171476390208584,1.00179426919793,1.001058908125676,1,2,4.989767551422119,4.203762054443359,7,6
1214,16,2.276857983309271,2.833012787502786,1.0044793476718263,1.0023725088280517,6,9,5.3553147315979,4.203762054443359,10,7
1214,32,1.7786151864210868,2.7503616734704233,1.0037143182765789,1.0040199146672169,17,23,5.610286235809326,4.203762054443359,15,9
1214,64,0.9964542054702743,2.4085828910525877,1.0032184843010994,1.0074545177037888,32,50,5.993893146514893,4.203762054443359,32,14
1214,128,0.20679984512260163,2.3819672605967943,1.0002616387542436,1.0080306619146429,65,112,6.474295139312744,4.203762054443359,63,16
1215,1,8.159594357626261,8.159594357626258,0.957206049241073,0.9572060492410723,0,0,8.262798309326172,8.262798309326172,1,1
1215,2,6.875173033077898,6.8751730330778935,0.9811804717700475,0.9811804717700452,0,0,8.327742576599121,8.262798309326172,2,2
1215,3,6.496687820314537,6.496687820314537,0.9846739246468401,0.9846739246468402,0,0,8.330914497375488,8.262798309326172,3,3
1215,4,6.294020939047689,6.294020939047688,0.9874290624593121,0.9874290624593118,0,0,8.564732551574707,8.262798309326172,4,4
1215,8,5.458333052165754,5.51083972317865,1.0029001496506174,1.0037192715791943,1,1,9.887909889221191,8.262798309326172,7,7
1215,16,4.98827269974903,5.2029653067934785,1.0139173429682544,1.0149906815424545,4,4,10.22172737121582,8.262798309326172,12,12
1215,32,4.080600084102281,5.113108266009854,1.0112045901519502,1.020487880510466,10,16,10.716020584106445,8.262798309326172,22,16
1215,64,2.652369064949589,4.979313944058152,1.0143751098264948,1.0257905488805716,27,44,11.254382133483887,8.262798309326172,37,20
1215,128,1.7511594887372495,4.903021727039052,1.008023780265471,1.029265205988774,65,106,11.842415809631348,8.262798309326172,63,22
1216,1,5.735626714479528,5.7356267144795305,0.9770087840849433,0.9770087840849443,0,0,5.779152870178223,5.779152870178223,1,1
1216,2,5.184014818724716,5.184014818724719,0.988420596423438,0.9884205964234396,0,0,6.291583061218262,5.779152870178223,2,2
1216,3,5.157566554931057,5.157566554931058,0.988859948922075,0.9888599489220753,0,0,6.67025899887085,5.779152870178223,3,3
1216,4,4.375886258301825,4.3781566050490675,0.9994235364460909,0.9994088812424948,1,1,6.827818870544434,5.779152870178223,3,3
1216,8,3.473822275117109,3.949503888542764,1.0062230510249557,1.0048975517431344,3,3,7.110264778137207,5.779152870178223,5,5
1216,16,2.8683626853693625,3.437690480551632,1.0112210306148084,1.012224290422722,5,8,7.5895915031433105,5.779152870178223,11,8
1216,32,2.310804562823745,3.3362917853104785,1.0085643920499932,1.015207270210536,15,21,8.041521072387695,5.779152870178223,17,11
1216,64,1.6722586950271512,3.2193346634475577,1.0065330884753256,1.018045657266947,28,49,8.51770305633545,5.779152870178223,36,15
1216,128,0.8276406391134036,3.2193346634475577,1.0026197549492422,1.018045657266947,55,113,9.166105270385742,5.779152870178223,73,15
1217,1,5.8135160836133,5.813516083613301,0.9834291379698737,0.9834291379698746,0,0,5.835593223571777,5.835593223571777,1,1
1217,2,4.815993581972712,4.815993581972713,0.9947523578181349,0.9947523578181349,0,0,5.880006790161133,5.835593223571777,2,2
1217,3,4.213323428603632,4.213323428603632,1.0041441287110804,1.0041441287110802,0,0,6.262207984924316,5.835593223571777,3,3
1217,4,4.206867765470266,4.213323428603632,1.0040526138172026,1.0041441287110802,1,1,6.424114227294922,5.835593223571777,3,3
1217,8,3.329070471309902,3.4805753533791006,1.0105014756285735,1.0097654065064856,1,3,7.318159103393555,5.835593223571777,7,5
1217,16,2.790655183925151,3.173684116246549,1.0144594736161152,1.0165389753922685,5,4,8.226036071777344,5.835593223571777,11,12
1217,32,2.2967122975729564,3.127336188707826,1.0073279360078453,1.0177895705423072,15,20,8.588216781616211,5.835593223571777,17,12
1217,64,1.7069344323235898,3.120045479585077,1.0023958307050473,1.0181236532407496,30,51,9.413067817687988,5.835593223571777,34,13
1217,128,0.8693403607327073,3.0668159847875507,1.0012987841345085,1.0204788698587604,67,114,10.162979125976562,5.835593223571777,61,14
1218,1,7.85929421123984,7.859294211239838,0.96042549373458,0.9604254937345824,0,0,7.945762634277344,7.945762634277344,1,1
1218,2,6.039884416143178,6.039884416143178,0.9963153177321835,0.9963153177321855,0,0,8.008949279785156,7.945762634277344,2,2
1218,3,5.580263883353789,5.580263883353788,1.0025795617514877,1.0025795617514883,0,0,8.19310188293457,7.945762634277344,3,3
1218,4,5.214458349376139,5.214458349376138,1.0085156281507006,1.0085156281507017,0,0,8.389348983764648,7.945762634277344,4,4
1218,8,4.861755201622941,4.861755201622944,1.0160055382657485,1.0160055382657491,0,0,9.215145111083984,7.945762634277344,8,8
1218,16,4.495733296704224,4.855972579427098,1.0165090228523692,1.0170545210610733,6,7,10.24534797668457,7.945762634277344,10,9
1218,32,4.24909570946423,4.763802169044849,1.017733321473552,1.0243484255617497,15,19,11.22111988067627,7.945762634277344,17,13
1218,64,2.912407997592822,4.716587007062246,1.0006808200475756,1.0263252276446369,26,52,12.125185012817383,7.945762634277344,38,12
1218,128,1.8637876464764922,4.708006848887972,0.9998802933758563,1.0277195098032812,60,115,12.96522045135498,7.945762634277344,68,13
1219,1,9.018756163939202,9.018756163939202,0.948852518309013,0.9488525183090141,0,0,9.145294189453125,9.145294189453125,1,1
1219,2,8.10318927149398,8.10318927149398,0.9715166659840166,0.971516665984017,0,0,9.9948148727417,9.145294189453125,2,2
1219,3,7.562372188738458,7.562372188738459,0.9842972754879963,0.9842972754879972,0,0,10.344676971435547,9.145294189453125,3,3
1219,4,7.25658221347755,7.25658221347755,0.9917853406081801,0.9917853406081807,0,0,10.937798500061035,9.145294189453125,4,4
1219,8,6.298480300997694,6.299268455508406,1.014182989356689,1.014165535712827,1,1,11.191322326660156,9.145294189453125,7,7
1219,16,5.901195552979894,6.264017036118475,1.016026708182624,1.0154960198293272,5,8,11.797966003417969,9.145294189453125,11,8
1219,32,5.170073650017437,6.16981064868315,1.0131256262606323,1.0188679957211848,14,22,12.458460807800293,9.145294189453125,18,10
1219,64,3.7343257072504756,5.812903056157323,1.0172947370102134,1.0344490094746612,32,49,13.011512756347656,9.145294189453125,32,15
1219,128,2.1952843569821057,5.639643167415973,1.0063665115465783,1.0393737441809434,63,114,13.49324893951416,9.145294189453125,65,14
1220,1,10.047756640810261,10.04775664081027,0.9326117360050414,0.9326117360050447,0,0,10.243477821350098,10.243477821350098,1,1
1220,2,9.072878790340585,9.072878790340589,0.9548410005445434,0.9548410005445445,0,0,10.277502059936523,10.243477821350098,2,2
1220,3,7.6732128479959325,7.6732128479959325,0.9896426321926866,0.9896426321926868,0,0,10.421765327453613,10.243477821350098,3,3
1220,4,7.079562298209595,7.079562298209595,1.0029385216316309,1.0029385216316302,0,0,10.449179649353027,10.243477821350098,4,4
1220,8,6.019060733286563,6.140666163002849,1.0217258656769035,1.0206272048992462,1,1,11.117227554321289,10.243477821350098,7,7
1220,16,5.842356101188,6.077252217324093,1.0245016061142875,1.0243052404210888,5,7,11.905555725097656,10.243477821350098,11,9
1220,32,4.838015032525548,5.799719180957474,1.0280382444842768,1.034368191788774,14,21,12.465319633483887,10.243477821350098,18,11
1220,64,3.535780497898421,5.761130802845016,1.0120914842636533,1.0372674263891284,30,49,13.635313987731934,10.243477821350098,34,15
1220,128,2.4108087441694175,5.748568390592521,1.0020842325559678,1.0391974491048601,60,111,14.587542533874512,10.243477821350098,68,17
1221,1,9.337390891207228,9.337390891207217,0.9434348946752494,0.9434348946752515,0,0,9.490687370300293,9.490687370300293,1,1
1221,2,7.998578150814698,7.998578150814696,0.9760729313519807,0.9760729313519823,0,0,9.63707160949707,9.490687370300293,2,2
1221,3,7.695848874455919,7.69584887445592,0.9856071410407561,0.9856071410407579,0,0,10.58605670928955,9.490687370300293,3,3
1221,4,7.601757966340242,7.601757966340244,0.989492697824299,0.9894926978243006,0,0,11.56554889678955,9.490687370300293,4,4
1221,8,6.402967867420805,6.404453543499,1.02335280913797,1.0234867160534202,2,2,11.834053039550781,9.490687370300293,6,6
1221,16,5.428862113900464,5.819121622883692,1.0362051142203987,1.0413615269067387,5,6,12.272124290466309,9.490687370300293,11,10
1221,32,4.666118549848129,5.665636312385471,1.0276580803014657,1.0449232503330703,14,18,12.99138069152832,9.490687370300293,18,14
1221,64,3.4454257895998293,5.528936388185352,1.0170307189611927,1.0507546191892654,26,47,13.497970581054688,9.490687370300293,38,17
1221,128,2.2857834910239836,5.515747872113915,1.0110729093332147,1.0527651857432003,60,109,14.315407752990723,9.490687370300293,68,19
1222,1,7.201643574203684,7.201643574203687,0.9680900198017136,0.9680900198017147,0,0,7.265620708465576,7.265620708465576,1,1
1222,2,6.314900282525427,6.314900282525427,0.980535143136442,0.9805351431364415,0,0,7.285626411437988,7.265620708465576,2,2
1222,3,5.855873359468512,5.855873359468512,0.9888810943044434,0.9888810943044433,0,0,7.549004554748535,7.265620708465576,3,3
1222,4,5.428358738750933,5.428358738750933,0.9954330413652808,0.9954330413652799,0,0,7.675638675689697,7.265620708465576,4,4
1222,8,4.70981627244205,4.732121282609375,1.0069704104192811,1.007059477805273,1,1,8.38270378112793,7.265620708465576,7,7
1222,16,4.27112835011406,4.337192497957106,1.013174016945492,1.013350061689974,3,5,8.72516918182373,7.265620708465576,13,11
1222,32,3.7747306090516726,4.263805350687799,1.0143702579078595,1.0151176559207902,13,18,9.232111930847168,7.265620708465576,19,14
1222,64,2.863771394454312,4.220780156065174,1.0057388758774837,1.0175100707361395,32,49,9.873397827148438,7.265620708465576,32,15
1222,128,1.6650915780924842,4.197669365913112,1.005050410265382,1.0188916219178847,64,111,10.743889808654785,7.265620708465576,64,17
1223,1,10.162492976094569,10.162492976094564,0.9385087602364862,0.9385087602364895,0,0,10.322967529296875,10.322967529296875,1,1
1223,2,9.753000159104765,9.753000159104767,0.956447023828431,0.9564470238284333,0,0,12.449024200439453,10.322967529296875,2,2
1223,3,9.735746079636597,9.753000159104767,0.9550452910499101,0.9564470238284333,1,1,12.761627197265625,10.322967529296875,2,2
1223,4,9.69539727377517,9.753000159104767,0.9534099524559283,0.9564470238284333,2,2,12.811508178710938,10.322967529296875,2,2
1223,8,8.206157310184464,8.52799382536766,1.0078788133512724,1.0084436464833004,3,3,13.225950241088867,10.322967529296875,5,5
1223,16,7.266942562085019,7.914680609177414,1.0302320162592329,1.0284715182532242,5,7,13.95634651184082,10.322967529296875,11,9
1223,32,6.306011865806386,7.914680609177414,1.0321553588912826,1.0284715182532242,14,23,14.662168502807617,10.322967529296875,18,9
1223,64,4.797721951353195,7.590798101250591,1.0231952286896644,1.0422942638376962,30,52,15.24760627746582,10.322967529296875,34,12
1223,128,3.003626535032709,7.579706033780362,1.0128190103315224,1.0436898817056857,60,115,16.14956283569336,10.322967529296875,68,13
1224,1,8.662446014553153,8.662446014553153,0.9639911467348441,0.9639911467348433,0,0,8.730180740356445,8.730180740356445,1,1
1224,2,7.357946464418315,7.357946464418313,0.9932506641656222,0.9932506641656211,0,0,10.881837844848633,8.730180740356445,2,2
1224,3,6.949299759682852,6.9492997596828525,1.0011634680810941,1.001163468081093,0,0,10.914968490600586,8.730180740356445,3,3
1224,4,6.89775235098787,6.89775235098787,1.0028498261533474,1.002849826153346,0,0,11.192246437072754,8.730180740356445,4,4
1224,8,6.453213703407673,6.676570734913701,1.009130993087022,1.0077131913069466,2,2,11.777637481689453,8.730180740356445,6,6
1224,16,5.878031498487119,6.205724102282304,1.022981847242155,1.023985404963364,5,5,12.174125671386719,8.730180740356445,11,11
1224,32,4.959681320185882,6.092444167827743,1.0250091535797274,1.0281001509809364,12,19,12.595016479492188,8.730180740356445,20,13
1224,64,4.365107842853142,5.942245459545083,1.025000679292185,1.0370191886309417,28,48,12.980457305908203,8.730180740356445,36,16
1224,128,3.0325828451956185,5.637270985250299,1.0119950694783753,1.0464141788194474,58,109,13.447829246520996,8.730180740356445,70,19
1225,1,7.08735302636648,7.087353026366483,0.9691371283454698,0.9691371283454706,0,0,7.146636962890625,7.146636962890625,1,1
1225,2,5.529625633642346,5.529625633642347,0.99598097400593,0.99598097400593,0,0,8.871236801147461,7.146636962890625,2,2
1225,3,5.488987320510642,5.488987320510642,0.9975561478395714,0.9975561478395719,0,0,8.946608543395996,7.146636962890625,3,3
1225,4,5.3630199983566165,5.363019998356616,1.002987739795039,1.0029877397950386,0,0,9.239065170288086,7.146636962890625,4,4
1225,8,4.9951257450499025,4.9951257450499025,1.011846797686811,1.0118467976868104,0,0,9.637908935546875,7.146636962890625,8,8
1225,16,4.536819761596208,4.873551108671895,1.013083280335304,1.0152546999420093,5,7,10.32697582244873,7.146636962890625,11,9
1225,32,4.007973133306324,4.6689077513940065,1.0168450075034137,1.0199155223135523,12,19,10.933320999145508,7.146636962890625,20,13
1225,64,2.9363797218786107,4.615707223223223,1.0095206096599405,1.022043168440335,28,50,11.65481185913086,7.146636962890625,36,14
1225,128,1.7792729097337892,4.615389386429481,1.0031677044972724,1.0222688123297432,60,113,12.384467124938965,7.146636962890625,68,15
1226,1,10.259421993477492,10.259421993477499,0.9416523233709136,0.9416523233709158,0,0,10.410809516906738,10.410809516906738,1,1
1226,2,9.206303183539005,9.206303183539005,0.967297028138519,0.9672970281385201,0,0,10.416206359863281,10.410809516906738,2,2
1226,3,8.17552465121098,8.175524651210981,0.9888698839919448,0.9888698839919456,0,0,10.647860527038574,10.410809516906738,3,3
1226,4,7.973731761028385,7.973731761028385,0.9931543687774256,0.993154368777425,0,0,10.785202980041504,10.410809516906738,4,4
1226,8,6.776733887639098,6.7767338876390975,1.0120525416881232,1.012052541688124,0,0,11.374748229980469,10.410809516906738,8,8
1226,16,6.436739508939487,6.697084639015092,1.0193551738765863,1.0147784403412903,5,7,11.857458114624023,10.410809516906738,11,9
1226,32,5.676264112751761,6.201834874866974,1.0275001664601078,1.029657438550179,12,15,12.229968070983887,10.410809516906738,20,17
1226,64,3.87199871483171,5.992555982800654,1.0219195081070012,1.0371260358562027,25,48,12.63300895690918,10.410809516906738,39,16
1226,128,2.3793598038380592,5.843394088784938,1.0096299024699096,1.0403627684635448,55,115,13.059833526611328,10.410809516906738,73,13
1227,1,6.871154832076561,6.871154832076561,0.9727259585469573,0.9727259585469582,0,0,6.920350074768066,6.920350074768066,1,1
1227,2,6.371355760090816,6.3713557600908155,0.9858471280089622,0.9858471280089625,0,0,8.610276222229004,6.920350074768066,2,2
1227,3,5.828587757424338,5.828587757424338,0.9992225488517109,0.9992225488517124,0,0,9.391744613647461,6.920350074768066,3,3
1227,4,5.605838796833168,5.605838796833167,1.0046203157507585,1.0046203157507585,0,0,9.442005157470703,6.920350074768066,4,4
1227,8,5.062493749203699,5.092929340694224,1.0166506707313792,1.0179778544391542,2,1,10.454549789428711,6.920350074768066,6,7
1227,16,4.628682100197781,4.698887937030413,1.0226750029847076,1.0247362336531465,5,6,10.911988258361816,6.920350074768066,11,10
1227,32,3.662652081058564,4.566545030109772,1.0133741199989,1.031436946226358,13,18,12.019010543823242,6.920350074768066,19,14
1227,64,2.929479385688642,4.509365261110624,1.0125539634466683,1.0348704230037318,29,48,12.949808120727539,6.920350074768066,35,16
1227,128,1.7020030368963337,4.4433199531967285,1.0024823187582208,1.0377836327014074,62,110,13.808866500854492,6.920350074768066,66,18
1228,1,10.097277238219148,10.097277238219156,0.9335543877699993,0.9335543877700023,0,0,10.293771743774414,10.293771743774414,1,1
1228,2,9.769255227839123,9.76925522783913,0.9412811710918874,0.9412811710918898,0,0,10.5365571975708,10.293771743774414,2,2
1228,3,8.11403703860427,8.11403703860427,0.981225679153573,0.9812256791535745,0,0,10.683215141296387,10.293771743774414,3,3
1228,4,8.06918669011209,8.069186690112094,0.9829044561181716,0.9829044561181731,0,0,10.691998481750488,10.293771743774414,4,4
1228,8,7.207078488212873,7.2290884558510635,1.0019888068441247,1.0011628120717107,2,2,10.964099884033203,10.293771743774414,6,6
1228,16,6.174163144530913,6.251489513925259,1.025385370025358,1.023765179763695,4,6,11.387659072875977,10.293771743774414,12,10
1228,32,5.593752892905787,6.073745460271667,1.0296345579327804,1.028160086404488,10,17,11.907865524291992,10.293771743774414,22,15
1228,64,4.379964594250156,6.064999997956921,1.0179258725379587,1.0289511752014326,28,48,12.425664901733398,10.293771743774414,36,16
1228,128,2.456353373748321,5.99357520786344,1.004915342164126,1.0335884337713885,64,111,12.946820259094238,10.293771743774414,64,17
1229,1,7.8766284298914435,7.876628429891445,0.9607132395358339,0.9607132395358349,0,0,7.9628520011901855,7.9628520011901855,1,1
1229,2,6.802351916634075,6.802351916634075,0.981206926119766,0.9812069261197665,0,0,8.083989143371582,7.9628520011901855,2,2
1229,3,6.29855007479376,6.298550074793761,0.9899282166736594,0.9899282166736594,0,0,8.309739112854004,7.9628520011901855,3,3
1229,4,6.188223466317476,6.188223466317476,0.9923962739510493,0.9923962739510497,0,0,8.740020751953125,7.9628520011901855,4,4
1229,8,5.742640771023918,5.745888852347543,1.0044521264515913,1.004396112009365,1,1,9.53507137298584,7.9628520011901855,7,7
1229,16,5.340103733120564,5.512494351978117,1.0138809066705052,1.0128237221902434,5,4,10.256414413452148,7.9628520011901855,11,12
1229,32,4.369051540432397,5.437222942608838,1.006348808131953,1.0146488901405946,17,19,10.64387035369873,7.9628520011901855,15,13
1229,64,3.579095004024946,5.3054671081523175,1.0006745779405473,1.0190062651275311,27,46,11.253899574279785,7.9628520011901855,37,18
1229,128,2.03860461527392,4.990670886406405,0.9996661981449938,1.0244530830748309,66,110,12.14803695678711,7.9628520011901855,62,18
1230,1,7.743836041835434,7.743836041835436,0.965416100546469,0.9654161005464701,0,0,7.81441593170166,7.81441593170166,1,1
1230,2,5.859150775407529,5.85915077540753,0.9963305241254865,0.9963305241254878,0,0,7.863931179046631,7.81441593170166,2,2
1230,3,5.518192367942193,5.518192367942193,1.0014466099240107,1.001446609924012,0,0,7.869811058044434,7.81441593170166,3,3
1230,4,5.115682917211715,5.115682917211716,1.0069064891238997,1.0069064891239008,0,0,7.935240745544434,7.81441593170166,4,4
1230,8,4.863758067980066,4.863758067980067,1.0129419889567044,1.0129419889567042,0,0,8.480779647827148,7.81441593170166,8,8
1230,16,4.384170752300634,4.385267547554556,1.02052288550658,1.02051270288954,3,2,8.90859317779541,7.81441593170166,13,14
1230,32,3.865830718246951,4.168394512281628,1.021067651486322,1.025270841627632,12,16,9.322198867797852,7.81441593170166,20,16
1230,64,2.518235940127849,4.077747249110803,1.0138273254295855,1.027495648492434,30,48,10.015031814575195,7.81441593170166,34,16
1230,128,1.4665285690818664,4.0245654914015985,1.0049718965760817,1.0306085766816016,61,110,10.751018524169922,7.81441593170166,67,18
1231,1,7.298863278932866,7.298863278932867,0.9728185721786972,0.9728185721786984,0,0,7.343147277832031,7.343147277832031,1,1
1231,2,6.258355755309112,6.258355755309112,0.992502213460676,0.9925022134606752,0,0,8.727181434631348,7.343147277832031,2,2
1231,3,5.877664047286032,5.877664047286031,1.0002311675772686,1.000231167577268,0,0,8.742624282836914,7.343147277832031,3,3
1231,4,5.768459221000789,5.768459221000789,1.0001589315999844,1.0001589315999835,0,0,8.865375518798828,7.343147277832031,4,4
1231,8,5.385158937503622,5.5050803880534405,1.0057960831983317,1.00606337640355,1,3,9.899826049804688,7.343147277832031,7,5
1231,16,4.995122587097625,5.324834850206791,1.0191021157291293,1.0155486203289241,7,8,10.694297790527344,7.343147277832031,9,8
1231,32,3.8736273106481245,5.313362612658796,1.0116047278373288,1.017235703579592,17,23,11.471771240234375,7.343147277832031,15,9
1231,64,3.017466423907623,5.193976469337383,1.0112665625421835,1.0240665710033838,34,51,12.198319435119629,7.343147277832031,30,13
1231,128,1.8658560176573895,5.149463187916032,1.0032658350372112,1.0266226470079571,60,114,12.759801864624023,7.343147277832031,68,14
1232,1,8.76717326318308,8.767173263183071,0.9556984781760095,0.9556984781760117,0,0,8.869441986083984,8.869441986083984,1,1
1232,2,8.250117671395168,8.250117671395172,0.9642183509645714,0.9642183509645728,0,0,8.901838302612305,8.869441986083984,2,2
1232,3,7.8922275682438325,7.892227568243835,0.9732560522046682,0.9732560522046694,0,0,9.382070541381836,8.869441986083984,3,3
1232,4,6.857229653140322,6.886268801166488,0.9895486967492818,0.9897049785483385,1,1,9.566641807556152,8.869441986083984,3,3
1232,8,6.569427606769935,6.660163681819926,0.9972556400436804,0.9972177751873178,2,3,9.96618938446045,8.869441986083984,6,5
1232,16,5.910112632211055,6.307372842987821,1.0092443768060562,1.0065193344741048,6,7,10.283013343811035,8.869441986083984,10,9
1232,32,5.08069316102476,5.60967385217916,1.0194703550495583,1.0224498152331984,11,20,10.843404769897461,8.869441986083984,21,12
1232,64,3.6662471408623816,5.590084684721328,1.005885885021318,1.0231479354825566,32,50,11.348796844482422,8.869441986083984,32,14
1232,128,2.2494165770614525,5.4362094223900135,1.004649330571125,1.027245362433766,65,109,11.896756172180176,8.869441986083984,63,19
1233,1,10.464309965236948,10.464309965236952,0.9419099641354832,0.9419099641354856,0,0,10.608163833618164,10.608163833618164,1,1
1233,2,8.71904585016859,8.719045850168591,0.9807160462235156,0.9807160462235169,0,0,10.612252235412598,10.608163833618164,2,2
1233,3,7.6991225690818865,7.699122569081888,0.9963432754193466,0.9963432754193482,0,0,10.628799438476562,10.608163833618164,3,3
1233,4,7.11213554261452,7.112135542614519,1.0073640588168513,1.0073640588168522,0,0,10.655888557434082,10.608163833618164,4,4
1233,8,6.13918635506834,6.171467841801512,1.0281219101040544,1.0278229832742203,1,1,11.192167282104492,10.608163833618164,7,7
1233,16,5.9783599290262055,6.0257565837156974,1.0321542823228438,1.031597246412895,3,5,11.415326118469238,10.608163833618164,13,11
1233,32,5.488210168152226,6.012150843314768,1.0329104878411233,1.0320621864095803,11,18,12.01220417022705,10.608163833618164,21,14
1233,64,4.367305134989027,5.814506810966662,1.0199850513338653,1.042623056026134,28,46,13.044035911560059,10.608163833618164,36,18
1233,128,2.4437745969588764,5.757832040080291,1.0046665944311082,1.0453734915236712,64,109,13.983695983886719,10.608163833618164,64,19
1234,1,11.818559548185599,11.8185595481856,0.908626570421881,0.9086265704218823,0,0,12.12199592590332,12.12199592590332,1,1
1234,2,10.618231922073063,10.618231922073061,0.9479490384399001,0.9479490384398999,0,0,12.460907936096191,12.12199592590332,2,2
1234,3,9.249070871841555,9.249070871841555,0.9897239807814067,0.989723980781407,0,0,12.696749687194824,12.12199592590332,3,3
1234,4,8.634894859473139,8.63489485947314,1.002323188318564,1.0023231883185628,0,0,12.756162643432617,12.12199592590332,4,4
1234,8,8.403359607846586,8.418591629006098,1.005596834260433,1.0050399489234347,1,1,13.034531593322754,12.12199592590332,7,7
1234,16,7.686790763472283,7.889827155138621,1.0194959954810707,1.01778479906141,5,6,13.582473754882812,12.12199592590332,11,10
1234,32,6.523034455874223,7.49436591509645,1.0232993832643649,1.0289061628571663,15,18,13.999147415161133,12.12199592590332,17,14
1234,64,4.429057573691392,7.3902873449979465,1.017743903475237,1.0323397674935226,26,51,14.572032928466797,12.12199592590332,38,13
1234,128,3.107021731941325,7.279823730663943,1.0102759418139218,1.0389328221390084,59,111,15.046062469482422,12.12199592590332,69,17
1235,1,8.340296097945416,8.34029609794542,0.9652012631636839,0.9652012631636855,0,0,8.40497875213623,8.40497875213623,1,1
1235,2,7.100532749849166,7.100532749849165,0.9909996363382311,0.9909996363382323,0,0,8.850255012512207,8.40497875213623,2,2
1235,3,6.284757196129016,6.284757196129015,1.0010007050529504,1.0010007050529515,0,0,9.042821884155273,8.40497875213623,3,3
1235,4,6.228790273317006,6.228790273317007,1.0023391583792556,1.0023391583792567,0,0,9.755538940429688,8.40497875213623,4,4
1235,8,6.077332698752659,6.077332698752658,1.0100001313213358,1.0100001313213367,0,0,10.914117813110352,8.40497875213623,8,8
1235,16,5.179231156271754,5.472595425944825,1.0332368741161924,1.032072043685046,3,2,11.56069564819336,8.40497875213623,13,14
1235,32,4.692456227345229,5.18938865321061,1.0351144469115814,1.0423355024412546,13,16,12.208755493164062,8.40497875213623,19,16
1235,64,3.235213512389684,5.131875990398321,1.017932960858297,1.0466618572896447,29,46,12.845941543579102,8.40497875213623,35,18
1235,128,1.8722832937526876,5.073329899554905,1.0058059917384587,1.0508525894994885,69,104,13.627215385437012,8.40497875213623,59,24
1236,1,3.6659308202863374,3.6659308202863397,0.9922636389198608,0.9922636389198628,0,0,3.673793315887451,3.673793315887451,1,1
1236,2,3.3874199195406423,3.3874199195406436,0.9948161456952298,0.9948161456952314,0,0,3.821078300476074,3.673793315887451,2,2
1236,3,3.2063992844202867,3.2063992844202867,0.9956727328718289,0.9956727328718309,0,0,3.850618600845337,3.673793315887451,3,3
1236,4,3.070088845555194,3.0700888455551936,0.9961875419620454,0.9961875419620464,0,0,3.851893186569214,3.673793315887451,4,4
1236,8,2.859923529750941,2.979211500880135,0.9960758381817462,0.9970568661370052,1,3,4.035214900970459,3.673793315887451,7,5
1236,16,2.308964618348332,2.795581244275944,0.9972614358856987,0.9980403240892994,5,11,4.2241129875183105,3.673793315887451,11,5
1236,32,1.0607183430162586,2.774404352980424,1.0022166766736076,0.9986395259349684,16,26,4.477625846862793,3.673793315887451,16,6
1236,64,0.4661964412910922,2.521637047060753,0.9999039770846043,1.0009700637987344,31,57,4.927433490753174,3.673793315887451,33,7
1236,128,0.05699832197596048,2.515353029515226,1.0000196190719355,1.0011508557035131,61,119,5.536592960357666,3.673793315887451,67,9
1237,1,7.896912120076244,7.896912120076251,0.9607085739027524,0.9607085739027545,0,0,7.984307289123535,7.984307289123535,1,1
1237,2,7.228984096139719,7.228984096139722,0.9786375659238906,0.9786375659238916,0,0,8.736124038696289,7.984307289123535,2,2
1237,3,6.051665969535959,6.051665969535959,0.9992192881559763,0.9992192881559764,0,0,8.758864402770996,7.984307289123535,3,3
1237,4,5.606567595865827,5.606567595865827,1.0045428208234113,1.0045428208234106,0,0,9.227545738220215,7.984307289123535,4,4
1237,8,5.182223028516232,5.182223028516232,1.0106802728720754,1.0106802728720758,2,2,9.43977165222168,7.984307289123535,6,6
1237,16,4.566390010646557,4.663169529745404,1.0212096160789859,1.0209055419853192,4,5,10.209775924682617,7.984307289123535,12,11
1237,32,3.647929351677598,4.63647571622892,1.0191462449530027,1.0226789483098884,12,18,10.812488555908203,7.984307289123535,20,14
1237,64,3.0775657546389765,4.625226570318341,1.0109150331717223,1.0232585643420384,32,50,11.388193130493164,7.984307289123535,32,14
1237,128,1.5836343592150706,4.624207715198948,1.0008898736398366,1.0237055892593268,65,113,12.729187965393066,7.984307289123535,63,15
1238,1,2.7747156663660792,2.77471566636608,0.9944277354906091,0.9944277354906104,0,0,2.7801127433776855,2.7801127433776855,1,1
1238,2,2.1729319450924125,2.1729319450924134,0.9974342499256945,0.9974342499256956,0,0,2.84696102142334,2.7801127433776855,2,2
1238,3,2.1436743193313856,2.1436743193313856,0.9978667085504193,0.99786670855042,0,0,2.88669753074646,2.7801127433776855,3,3
1238,4,2.135515425203161,2.135515425203157,0.9979522023819849,0.9979522023819858,0,0,2.950603723526001,2.7801127433776855,4,4
1238,8,1.8947142565519037,1.9295420162003003,0.9984909620702875,0.9988640912413067,4,4,3.321190118789673,2.7801127433776855,4,4
1238,16,1.5982307229318597,1.8887266707675778,1.0003523568708659,0.9995857072529464,6,8,3.4304449558258057,2.7801127433776855,10,8
1238,32,1.0586559872450398,1.6012631215171638,1.0032401496323928,1.002216586764591,14,20,3.719719171524048,2.7801127433776855,18,12
1238,64,0.7044511314209476,1.5375662031072375,1.0022830776291858,1.0034684939815426,31,51,4.14687967300415,2.7801127433776855,33,13
1238,128,0.02989476783430759,1.4634211569566347,0.999983125019978,1.0047188642825045,70,115,4.651838779449463,2.7801127433776855,58,13
1239,1,7.869851919682102,7.869851919682105,0.9658903674278508,0.965890367427852,0,0,7.936960220336914,7.936960220336914,1,1
1239,2,6.920189902051335,6.920189902051336,0.9851337266947289,0.9851337266947298,0,0,9.374979972839355,7.936960220336914,2,2
1239,3,6.38245698408975,6.382456984089751,0.9972383088468697,0.9972383088468715,0,0,9.633539199829102,7.936960220336914,3,3
1239,4,6.205499341304316,6.205499341304317,1.0034841359027913,1.0034841359027935,0,0,9.717248916625977,7.936960220336914,4,4
1239,8,5.529001482762722,5.533463249504997,1.0179151581338814,1.0181283578855134,1,1,10.107650756835938,7.936960220336914,7,7
1239,16,5.209373135865912,5.2710979289909785,1.0264581141867901,1.0265859598196267,5,5,10.423592567443848,7.936960220336914,11,11
1239,32,4.331042899384788,5.0591160848637715,1.0257866445734134,1.032129347452345,12,18,10.935964584350586,7.936960220336914,20,14
1239,64,3.1719341205096203,5.014471410979918,1.0190545073412411,1.034689390094202,33,44,11.43730354309082,7.936960220336914,31,20
1239,128,1.7946319565346998,4.868686531963014,1.0072572555273416,1.039680478938519,62,104,11.913490295410156,7.936960220336914,66,24
1240,1,5.510616164408098,5.510616164408098,0.982675982004453,0.9826759820044526,0,0,5.5365495681762695,5.5365495681762695,1,1
1240,2,5.172583885568598,5.1725838855685975,0.986675044603893,0.9866750446038922,0,0,5.543892860412598,5.5365495681762695,2,2
1240,3,4.120323614157212,4.124546636078958,0.9986129009003157,0.9985134466200029,1,1,5.647678852081299,5.5365495681762695,2,2
1240,4,4.077898227666622,4.082786955805576,0.9991149217135531,0.9990046877223813,1,1,5.667880058288574,5.5365495681762695,3,3
1240,8,3.5734653375630154,3.690659209694133,1.0046723617215982,1.0032281058427364,1,2,6.083370685577393,5.5365495681762695,7,6
1240,16,3.235459981461936,3.6685137710108555,1.005409938886618,1.0038377932160023,5,9,6.294923782348633,5.5365495681762695,11,7
1240,32,2.6521852926948486,3.6072096244429015,1.0032756930347086,1.0057160041112785,15,25,6.777019500732422,5.5365495681762695,17,7
1240,64,1.4759550164661128,3.599156183435909,0.9995577616512977,1.0064776276697007,29,54,7.217246055603027,5.5365495681762695,35,10
1240,128,0.8820958643769242,3.5426645007443445,0.9989744019499651,1.0080464186193996,54,118,7.790125370025635,5.5365495681762695,74,10
1241,1,9.062626955977048,9.062626955977052,0.9469578955999082,0.9469578955999097,0,0,9.2027587890625,9.2027587890625,1,1
1241,2,7.298895484184952,7.2988954841849525,0.9844725320931976,0.9844725320931986,0,0,9.278693199157715,9.2027587890625,2,2
1241,3,7.079253972953278,7.079253972953279,0.9879549601274462,0.9879549601274464,0,0,9.647143363952637,9.2027587890625,3,3
1241,4,6.74800350058468,6.74800350058468,0.9965319128383041,0.996531912838304,0,0,9.903524398803711,9.2027587890625,4,4
1241,8,5.899682622931031,5.904714116323877,1.0076382353158273,1.0083328063073345,1,1,10.350616455078125,9.2027587890625,7,7
1241,16,5.637803699169831,5.762541586834093,1.012971326315276,1.0131727472725105,6,6,10.648313522338867,9.2027587890625,10,10
1241,32,4.598013200325471,5.724325347008287,1.0134209253781068,1.0161157026210086,13,19,11.276841163635254,9.2027587890625,19,13
1241,64,3.385749022387763,5.601934174190794,1.0091871010759084,1.0229929736093162,27,47,12.149396896362305,9.2027587890625,37,17
1241,128,1.9410322927243155,5.381305775114336,1.0080864503085616,1.0321950552407673,61,111,13.05014705657959,9.2027587890625,67,17
1242,1,5.872935194344438,5.872935194344438,0.9784069421936229,0.9784069421936231,0,0,5.90967321395874,5.90967321395874,1,1
1242,2,5.443361325234079,5.443361325234079,0.983673138464149,0.9836731384641485,0,0,6.200746059417725,5.90967321395874,2,2
1242,3,4.957478211497936,4.957478211497935,0.9937112679751949,0.9937112679751945,0,0,6.890321731567383,5.90967321395874,3,3
1242,4,4.953530696006536,4.953530696006536,0.9940723174863464,0.9940723174863464,0,0,7.186393737792969,5.90967321395874,4,4
1242,8,4.297295828442222,4.344658933509104,1.0003650488604414,1.0008868116447385,2,2,7.946279525756836,5.90967321395874,6,6
1242,16,3.3726168059813357,3.982603504786154,1.0035903915905509,1.0078976753674898,5,8,8.684162139892578,5.90967321395874,11,8
1242,32,2.999443819133687,3.741649533673039,1.0079433739029227,1.0118342404873464,15,21,9.254606246948242,5.90967321395874,17,11
1242,64,2.1634793664051664,3.5692066807376173,1.0049382505791924,1.0183674553904902,31,49,9.660123825073242,5.90967321395874,33,15
1242,128,1.2320459598751672,3.5595343816828593,0.9995730957172171,1.0192760655874933,65,110,10.069865226745605,5.90967321395874,63,18
1243,1,8.930930675596867,8.930930675596867,0.9625525384211936,0.9625525384211938,0,0,9.002197265625,9.002197265625,1,1
1243,2,7.65868895728242,7.658688957282417,0.9894566637605868,0.9894566637605853,0,0,9.30625057220459,9.002197265625,2,2
1243,3,6.712942720487046,6.712942720487047,1.0037295287555166,1.0037295287555157,0,0,9.771862030029297,9.002197265625,3,3
1243,4,6.540283488075585,6.540283488075585,1.0069390714727073,1.006939071472707,0,0,10.104907989501953,9.002197265625,4,4
1243,8,5.979937928993115,5.979937928993115,1.0193736302494958,1.0193736302494953,0,0,10.31375789642334,9.002197265625,8,8
1243,16,5.7979271033688,5.861793801020008,1.0216602279185372,1.0219420870858316,4,5,10.725337028503418,9.002197265625,12,11
1243,32,4.954120435651006,5.424382105923038,1.0308274030264095,1.0316949011471017,12,18,11.172828674316406,9.002197265625,20,14
1243,64,3.6428479993017433,5.308349515240905,1.0213684042441864,1.0362194166599683,27,45,11.592497825622559,9.002197265625,37,19
1243,128,1.967090805914351,5.1627238963230155,1.006402242944008,1.0402670718990719,64,107,12.121889114379883,9.002197265625,64,21
1244,1,6.565998017102761,6.5659980171027685,0.9763028385664164,0.9763028385664198,0,0,6.606032848358154,6.606032848358154,1,1
1244,2,6.186103427876359,6.186103427876364,0.9823418604992595,0.9823418604992616,0,0,6.879145622253418,6.606032848358154,2,2
1244,3,5.410459353698842,5.410459353698844,0.9924800980693286,0.9924800980693307,0,0,6.953916072845459,6.606032848358154,3,3
1244,4,5.043665177622063,5.043665177622064,0.9965740429720784,0.9965740429720801,0,0,7.257769584655762,6.606032848358154,4,4
1244,8,4.555296694557859,4.563366855781631,1.0044607473945601,1.0044826488936651,2,2,7.586651802062988,6.606032848358154,6,6
1244,16,3.847766188726089,4.288661988189149,1.006338267552683,1.0101092953736552,5,8,8.25820541381836,6.606032848358154,11,8
1244,32,3.22724215546143,4.2050058098243275,1.0078790100994717,1.0124432884882275,16,22,8.84730339050293,6.606032848358154,16,10
1244,64,2.2738417058443945,4.155779720921143,1.003520677376552,1.0138370143844,35,53,9.627423286437988,6.606032848358154,29,11
1244,128,0.9366428942188624,3.9630694104844655,1.0018719124895705,1.019750498453461,59,111,10.208216667175293,6.606032848358154,69,17
1245,1,9.105721496955944,9.105721496955942,0.9460974439965436,0.9460974439965449,0,0,9.24754524230957,9.24754524230957,1,1
1245,2,7.266129715885979,7.26612971588598,0.9858066965718368,0.9858066965718382,0,0,9.280694961547852,9.24754524230957,2,2
1245,3,6.716937831739356,6.716937831739355,0.9987425232802755,0.9987425232802758,0,0,9.544204711914062,9.24754524230957,3,3
1245,4,6.424529737372558,6.424529737372557,1.0016486793475017,1.0016486793475012,0,0,9.575935363769531,9.24754524230957,4,4
1245,8,5.954566480556287,5.954566480556289,1.0116536399987293,1.0116536399987304,0,0,10.21821403503418,9.24754524230957,8,8
1245,16,5.617100325656693,5.7669219127094555,1.0166458741200128,1.0181679494408788,4,6,11.012873649597168,9.24754524230957,12,10
1245,32,4.665855675080441,5.580761207870676,1.0192859205415865,1.0264738884951639,11,16,11.511884689331055,9.24754524230957,21,16
1245,64,3.317320222037942,5.459434403815952,1.007154299943354,1.0342202831156686,29,43,12.437459945678711,9.24754524230957,35,21
1245,128,2.075233026071223,5.419287160372996,1.0032126328561979,1.0395057955720988,62,102,13.24946403503418,9.24754524230957,66,26
1246,1,9.608148432789411,9.60814843278942,0.9488805569194517,0.9488805569194553,0,0,9.726694107055664,9.726694107055664,1,1
1246,2,8.149264277558954,8.149264277558954,0.9801076442962126,0.9801076442962136,0,0,9.847092628479004,9.726694107055664,2,2
1246,3,7.853590705554642,7.853590705554642,0.987884705032641,0.9878847050326414,0,0,10.248291969299316,9.726694107055664,3,3
1246,4,7.796314085881919,7.796314085881918,0.9907661988858408,0.9907661988858403,0,0,11.018929481506348,9.726694107055664,4,4
1246,8,7.12950621691056,7.191794226303411,1.0086021690049005,1.008757053799052,1,1,11.496121406555176,9.726694107055664,7,7
1246,16,6.142855657775364,6.857561452278151,1.0190260489516094,1.0188534516915433,7,9,11.886466979980469,9.726694107055664,9,7
1246,32,4.976120171270268,6.769458834748454,1.0134206500846186,1.0224260821072393,14,24,12.632122039794922,9.726694107055664,18,8
1246,64,3.5989415802478657,6.477251927324423,1.0093548790401552,1.0341875750418523,29,51,13.375614166259766,9.726694107055664,35,13
1246,128,2.077815710796869,6.346965609662821,1.0065517104167159,1.0428439025134004,67,113,14.15100383758545,9.726694107055664,61,15
1247,1,11.672191775276932,11.672191775276938,0.9143920525103846,0.9143920525103864,0,0,11.949398040771484,11.949398040771484,1,1
1247,2,10.889663166964459,10.889663166964462,0.9420842793507687,0.9420842793507695,0,0,12.293743133544922,11.949398040771484,2,2
1247,3,9.370887200306298,9.370887200306296,0.980322687219721,0.9803226872197203,0,0,12.358234405517578,11.949398040771484,3,3
1247,4,8.717932762573476,8.717932762573476,0.9967601940500981,0.9967601940500976,0,0,12.524930000305176,11.949398040771484,4,4
1247,8,8.355422321457661,8.383556964932792,1.0100413822940482,1.009002035296164,1,1,12.873400688171387,11.949398040771484,7,7
1247,16,7.228864635599497,7.57030540441234,1.0352459373577587,1.0293562161506429,5,7,13.356904983520508,11.949398040771484,11,9
1247,32,6.527087050821177,7.287910706143131,1.0427338526757075,1.0394716627968648,14,20,13.759485244750977,11.949398040771484,18,12
1247,64,5.139027185377841,7.240250148722961,1.039345994247272,1.0425770407533754,29,49,14.083356857299805,11.949398040771484,35,15
1247,128,2.893002103840127,7.17207376931032,1.0158931656419172,1.0462040996655508,66,109,14.622490882873535,11.949398040771484,62,19
1248,1,10.009578302820737,10.009578302820744,0.9364057101940877,0.9364057101940901,0,0,10.1851806640625,10.1851806640625,1,1
1248,2,8.825212897031035,8.825212897031038,0.9666625284752506,0.9666625284752521,0,0,10.763142585754395,10.1851806640625,2,2
1248,3,7.513365496169547,7.5133654961695475,0.9913450968084745,0.9913450968084749,0,0,11.00778865814209,10.1851806640625,3,3
1248,4,6.8605680098186985,6.8605680098186985,1.0098106234307118,1.009810623430712,0,0,11.655817985534668,10.1851806640625,4,4
1248,8,6.669846498543531,6.66984649854353,1.0162552824310183,1.0162552824310198,0,0,12.142956733703613,10.1851806640625,8,8
1248,16,6.378970206634827,6.432769566676613,1.0216524216072949,1.0228921705960419,6,6,12.69176959991455,10.1851806640625,10,10
1248,32,5.888735785819128,6.3907050533062435,1.0167782619557193,1.0244081578191802,11,21,13.619495391845703,10.1851806640625,21,11
1248,64,4.719509541202305,6.318502530850388,1.006821451767737,1.0306329690528682,30,51,14.118596076965332,10.1851806640625,34,13
1248,128,2.920528646891244,6.318502530850388,1.0027160342910564,1.0306329690528682,60,115,14.596336364746094,10.1851806640625,68,13
1249,1,8.891673998645846,8.89167399864585,0.9484583906555136,0.9484583906555141,0,0,9.020112037658691,9.020112037658691,1,1
1249,2,7.5673373507742765,7.567337350774277,0.9730685814689988,0.9730685814689988,0,0,9.633769989013672,9.020112037658691,2,2
1249,3,7.158983368024126,7.158983368024096,0.9829508731445611,0.9829508731445616,0,0,9.754572868347168,9.020112037658691,3,3
1249,4,6.989364030149815,6.989364030149814,0.9867940179030045,0.9867940179030038,0,0,10.018807411193848,9.020112037658691,4,4
1249,8,6.953048020017745,6.959163354227479,0.9883407079659045,0.9885498777880889,1,1,10.33629035949707,9.020112037658691,7,7
1249,16,6.419475737413942,6.679757858342286,0.9983470410578053,0.9996265230141268,7,7,11.105504989624023,9.020112037658691,9,9
1249,32,6.030507078700598,6.578626872706616,1.0003068570858287,1.004758548225349,15,19,11.601285934448242,9.020112037658691,17,13
1249,64,5.06792465060737,6.344424370767251,0.9968251713200058,1.0137122055676682,33,48,12.20896053314209,9.020112037658691,31,16
1249,128,3.2719317228642266,6.322690238439138,0.9959796371095533,1.015083015704985,62,112,12.742987632751465,9.020112037658691,66,16
1250,1,4.216124143216044,4.216124143216043,0.9913986070077164,0.9913986070077165,0,0,4.224274635314941,4.224274635314941,1,1
1250,2,3.480803190501159,3.4808031905011596,0.999733196819909,0.9997331968199088,0,0,5.589658260345459,4.224274635314941,2,2
1250,3,3.403979657513019,3.403979657513019,1.0007484360592909,1.0007484360592902,0,0,5.950934886932373,4.224274635314941,3,3
1250,4,3.281506642503631,3.2815066425036306,1.004008840176313,1.0040088401763134,0,0,6.479253768920898,4.224274635314941,4,4
1250,8,3.037409058139219,3.1344480966977173,1.0052970838724617,1.006753804073753,2,2,6.758264064788818,4.224274635314941,6,6
1250,16,2.830018807872398,3.0889542956268286,1.0052358105615318,1.0075881357874046,5,8,7.375494480133057,4.224274635314941,11,8
1250,32,2.1425177809706333,3.0442315568264475,1.0036802285806408,1.0096781520915623,15,21,8.367597579956055,4.224274635314941,17,11
1250,64,1.4536852719116402,2.752446055122234,1.004328913249176,1.0141214363492594,29,51,9.22542667388916,4.224274635314941,35,13
1250,128,0.6421741747752551,2.7346427177181494,1.0012268177592254,1.0154216133779554,70,113,10.309324264526367,4.224274635314941,58,15
1251,1,11.441654834947208,11.441654834947203,0.9204896319322021,0.9204896319322048,0,0,11.690546989440918,11.690546989440918,1,1
1251,2,9.734669314336978,9.734669314336939,0.9689489619144536,0.9689489619144556,0,0,12.619928359985352,11.690546989440918,2,2
1251,3,8.981442153355022,8.981442153355022,0.9893976226765773,0.9893976226765784,0,0,13.020662307739258,11.690546989440918,3,3
1251,4,8.96780209648231,8.96780209648231,0.9901203433320928,0.990120343332095,0,0,13.53287124633789,11.690546989440918,4,4
1251,8,8.497191456059298,8.504063849427828,1.0107876871036134,1.010798205129175,1,1,13.795831680297852,11.690546989440918,7,7
1251,16,7.506579500322824,7.904861348117599,1.0348769565886555,1.031741451063581,6,6,14.637940406799316,11.690546989440918,10,10
1251,32,6.2607014123076725,7.714105598107107,1.041003315796655,1.0395743244133882,13,19,15.34126091003418,11.690546989440918,19,13
1251,64,5.291226865567755,7.6897017457132035,1.0357941690373438,1.0415358373760737,28,51,15.986083984375,11.690546989440918,36,13
1251,128,3.61069800260655,7.6446810294926655,1.0239020985793448,1.0467291882189687,64,111,16.341936111450195,11.690546989440918,64,17
1252,1,8.971189960757021,8.97118996075703,0.9549284746488824,0.9549284746488858,0,0,9.070311546325684,9.070311546325684,1,1
1252,2,6.879823329763863,6.879823329763863,1.000553419544043,1.000553419544044,0,0,9.684783935546875,9.070311546325684,2,2
1252,3,6.421779579368648,6.421779579368648,1.0070123629222767,1.007012362922278,0,0,9.857439041137695,9.070311546325684,3,3
1252,4,5.950539813009854,5.950539813009852,1.0170164517449929,1.0170164517449942,0,0,9.882282257080078,9.070311546325684,4,4
1252,8,4.991053198985371,4.991053198985368,1.0318024922502806,1.0318024922502826,0,0,10.356011390686035,9.070311546325684,8,8
1252,16,4.658459866409996,4.901676550018754,1.0351712117079561,1.0339796028181327,4,5,11.619063377380371,9.070311546325684,12,11
1252,32,4.137686491790172,4.627646199634665,1.034101633484471,1.042129605497272,10,19,12.396007537841797,9.070311546325684,22,13
1252,64,3.37098193318439,4.627588478245199,1.023166392926237,1.042221747619451,25,50,13.065271377563477,9.070311546325684,39,14
1252,128,2.0020434994802745,4.6262581633110145,1.0037579358257702,1.0426856465930903,59,112,13.957634925842285,9.070311546325684,69,16
1253,1,12.059061688071528,12.059061688071532,0.904783093965459,0.90478309396546,0,0,12.388702392578125,12.388702392578125,1,1
1253,2,10.682587559787285,10.682587559787285,0.9471648360119893,0.9471648360119891,0,0,13.662032127380371,12.388702392578125,2,2
1253,3,10.237117041780282,10.237117041780284,0.9635287668438672,0.9635287668438676,0,0,13.679662704467773,12.388702392578125,3,3
1253,4,9.961641288201164,9.961641288201166,0.9723313956114411,0.9723313956114412,0,0,14.07544994354248,12.388702392578125,4,4
1253,8,9.595733639659537,9.729051368179991,0.9829596255562445,0.9831063497299456,2,3,14.692622184753418,12.388702392578125,6,5
1253,16,8.754105043886957,9.070329006594534,1.0113101312701598,1.0098560568396893,6,8,15.180400848388672,12.388702392578125,10,8
1253,32,8.285497223706907,9.018986595587176,1.0166871802523392,1.0136627642214702,11,21,15.611166000366211,12.388702392578125,21,11
1253,64,6.456228967092361,8.931742337951368,1.004690513527613,1.0179882565836702,28,53,16.244426727294922,12.388702392578125,36,11
1253,128,4.323269679909847,8.559045070469924,0.9930571411986542,1.0378301144557913,63,110,16.76451873779297,12.388702392578125,65,18
1254,1,3.2457769459242063,3.2457769459242067,0.9941157050027025,0.9941157050027044,0,0,3.250896692276001,3.250896692276001,1,1
1254,2,2.843741780423183,2.8437417804231835,0.996530460243101,0.9965304602431024,0,0,3.356346368789673,3.250896692276001,2,2
1254,3,2.5922670162800316,2.5922670162800316,0.9993276408318771,0.9993276408318779,0,0,3.4272496700286865,3.250896692276001,3,3
1254,4,2.518360775155349,2.5183607751553496,0.9992206527381433,0.9992206527381444,0,0,3.535741090774536,3.250896692276001,4,4
1254,8,1.6776554064761733,1.7089139917411844,1.0026053116033113,1.0026482104364574,2,3,3.768474578857422,3.250896692276001,6,5
1254,16,1.2006555788385411,1.4934342445562598,1.003571893854496,1.0030898079321646,5,9,3.9627158641815186,3.250896692276001,11,7
1254,32,0.9430604538715043,1.369039209323684,1.0028974294959807,1.0044909785288416,13,22,4.294498443603516,3.250896692276001,19,10
1254,64,0.3983934396376497,1.3689970958843507,1.000235658642365,1.0044856535039504,23,53,4.772189140319824,3.250896692276001,41,11
1254,128,0.024350993132306615,1.3516052438287085,1.0000366412892348,1.0048386470285913,65,115,5.251649379730225,3.250896692276001,63,13
1255,1,6.080684849497719,6.080684849497721,0.9792783839044504,0.9792783839044511,0,0,6.112926959991455,6.112926959991455,1,1
1255,2,5.373928308729275,5.373928308729276,0.9886507016697059,0.9886507016697055,0,0,6.376728057861328,6.112926959991455,2,2
1255,3,4.171566208557664,4.171566208557664,1.0037567994766972,1.0037567994766978,0,0,6.669609546661377,6.112926959991455,3,3
1255,4,4.069519178093983,4.069519178093983,1.0047199604738999,1.0047199604739,0,0,6.690114498138428,6.112926959991455,4,4
1255,8,3.4762420125226092,3.4762420125226092,1.0130886153283378,1.0130886153283378,0,0,7.313985347747803,6.112926959991455,8,8
1255,16,3.2628181767644793,3.3983917399999433,1.0137391147605874,1.015144843012658,5,5,7.8964457511901855,6.112926959991455,11,11
1255,32,2.6191142932579887,3.391403707083126,1.0108021076095777,1.0154993679980748,10,20,8.612353324890137,6.112926959991455,22,12
1255,64,1.5736903867250236,3.3873787090027494,1.0036781469030371,1.0157864358016084,29,50,9.552810668945312,6.112926959991455,35,14
1255,128,0.7556167010404258,3.3848729637412633,0.9997741917420437,1.016323866983745,62,112,10.47220516204834,6.112926959991455,66,16
1256,1,9.753684828854439,9.753684828854446,0.9427570064382812,0.9427570064382836,0,0,9.902325630187988,9.902325630187988,1,1
1256,2,8.308440241064565,8.308440241064565,0.9832463353280965,0.983246335328099,0,0,11.315574645996094,9.902325630187988,2,2
1256,3,7.5933773281066586,7.5933773281066586,0.9931191186313584,0.9931191186313588,0,0,11.400713920593262,9.902325630187988,3,3
1256,4,6.952717798415808,6.952717798415808,1.0070515708374765,1.0070515708374765,0,0,11.406777381896973,9.902325630187988,4,4
1256,8,6.478608466590577,6.550299735875593,1.015796211495863,1.015433446371308,2,3,12.272847175598145,9.902325630187988,6,5
1256,16,5.766093953835222,5.992076283216232,1.0338313793214646,1.0321688255018173,5,6,12.554085731506348,9.902325630187988,11,10
1256,32,4.892040776959187,5.9162237814465115,1.0383211845174292,1.0360145042915327,11,22,13.571181297302246,9.902325630187988,21,10
1256,64,4.03946624646216,5.881371446560327,1.0295985235951717,1.0392037276178336,33,51,14.106009483337402,9.902325630187988,31,13
1256,128,2.6333687422435887,5.723354358601836,1.0125849541776393,1.045231413862505,59,113,14.578619956970215,9.902325630187988,69,15
1257,1,2.1386927679865906,2.138692767986592,0.9968560229025878,0.9968560229025889,0,0,2.1408851146698,2.1408851146698,1,1
1257,2,1.7289624248244682,1.7289624248244684,0.9987580676252648,0.9987580676252654,0,0,2.146092414855957,2.1408851146698,2,2
1257,3,1.5658958367509943,1.5658958367509945,0.9997450123430318,0.999745012343032,0,0,2.6992201805114746,2.1408851146698,3,3
1257,4,1.5611259542364633,1.5611259542364633,0.9998389473285794,0.9998389473285797,0,0,3.140913963317871,2.1408851146698,4,4
1257,8,1.3359932440757132,1.4472500936459582,1.0011071660204425,1.000758359989994,2,3,3.6665124893188477,2.1408851146698,6,5
1257,16,1.0703013011294968,1.4472500936459582,1.0000606567956545,1.000758359989994,8,11,3.851937770843506,2.1408851146698,8,5
1257,32,0.8869069500730112,1.4249588809948581,1.001028406231892,1.0014113970334888,14,24,4.239729881286621,2.1408851146698,18,8
1257,64,0.5611206196699288,1.414320033872847,1.0002729875244436,1.0016632832664905,33,57,4.5881452560424805,2.1408851146698,31,7
1257,128,0.07570922595449456,1.4103557800898752,0.9999469331884256,1.0017559490776256,64,119,5.127167224884033,2.1408851146698,64,9
1258,1,8.379919984264147,8.379919984264147,0.949407454574088,0.9494074545740879,0,0,8.51794719696045,8.51794719696045,1,1
1258,2,7.458972485286487,7.458972485286486,0.9686448376338557,0.9686448376338549,0,0,8.624191284179688,8.51794719696045,2,2
1258,3,7.380827624176551,7.380827624176551,0.9701100905494294,0.9701100905494289,0,0,9.051753044128418,8.51794719696045,3,3
1258,4,7.021697486578813,7.021697486578815,0.9766756006998395,0.9766756006998388,0,0,9.2354097366333,8.51794719696045,4,4
1258,8,6.064338631957087,6.070885335759493,0.9991354572672104,0.9991816468034356,3,3,9.6804780960083,8.51794719696045,5,5
1258,16,5.3611941014576665,5.7675638851993725,1.0081098477810533,1.0062802696652424,7,9,10.189382553100586,8.51794719696045,9,7
1258,32,4.658490013196113,5.174416358753748,1.0241984984828498,1.0257741128441957,13,21,10.82453727722168,8.51794719696045,19,11
1258,64,3.3114003881832628,5.023696477006324,1.0152613693263643,1.031368310960636,29,51,11.69700813293457,8.51794719696045,35,13
1258,128,2.0888428213079666,5.018817660223993,1.0003391914892914,1.0323492146128723,68,112,12.769522666931152,8.51794719696045,60,16
1259,1,9.045883192452951,9.045883192452955,0.9529247849092851,0.9529247849092858,0,0,9.151458740234375,9.151458740234375,1,1
1259,2,6.9603884476368805,6.9603884476368805,0.9916045514660836,0.9916045514660834,0,0,9.70855712890625,9.151458740234375,2,2
1259,3,6.926319235518482,6.926319235518482,0.9940577914922595,0.9940577914922595,0,0,11.194503784179688,9.151458740234375,3,3
1259,4,6.905344914042914,6.905344914042915,0.9949664203007497,0.9949664203007488,0,0,11.342628479003906,9.151458740234375,4,4
1259,8,6.488220038267543,6.521985144631994,1.0089347047698787,1.0082307086330982,2,2,12.136282920837402,9.151458740234375,6,6
1259,16,6.269160193121423,6.368614507518054,1.0181407392611301,1.016851242318693,6,6,12.60945987701416,9.151458740234375,10,10
1259,32,5.751502325661538,6.260886389330732,1.0156149250180078,1.020082906749155,13,23,13.060712814331055,9.151458740234375,19,9
1259,64,4.377077521566573,5.928377205099029,1.0175681021950032,1.0315825799733622,31,53,13.594991683959961,9.151458740234375,33,11
1259,128,2.66566770941797,5.894297371835969,1.0032441536903625,1.0352865592623413,63,116,14.360236167907715,9.151458740234375,65,12
1260,1,5.359045649252506,5.359045649252506,0.9847447707573994,0.9847447707573991,0,0,5.379899024963379,5.379899024963379,1,1
1260,2,4.950037254633597,4.950037254633596,0.9911159934096898,0.9911159934096894,0,0,6.076534271240234,5.379899024963379,2,2
1260,3,4.949566004527455,4.950037254633596,0.9910333007793091,0.9911159934096894,1,1,6.156683921813965,5.379899024963379,2,2
1260,4,4.846218406117519,4.846218406117517,0.9936579864498587,0.9936579864498583,0,0,6.3990797996521,5.379899024963379,4,4
1260,8,4.255377715449911,4.481839152912916,0.9973389711561234,0.9982660923995659,3,2,6.590312480926514,5.379899024963379,5,6
1260,16,3.5788505400507384,4.399382778414353,0.9986597117512614,0.9999911464028538,8,10,7.1890869140625,5.379899024963379,8,6
1260,32,2.773084260620156,4.398826665330471,0.9971486595818344,1.0001067856065635,13,25,7.645684719085693,5.379899024963379,19,7
1260,64,1.4098249551188535,4.0681820011085685,1.0004346535854638,1.0067570482539892,33,56,7.996348857879639,5.379899024963379,31,8
1260,128,0.4943523607605111,3.9110802345973226,1.0004348266849385,1.0095441490019177,59,120,8.312768936157227,5.379899024963379,69,8
1261,1,7.111759323639022,7.111759323639028,0.9693220587357215,0.9693220587357242,0,0,7.1706647872924805,7.1706647872924805,1,1
1261,2,5.807344031093171,5.80734403109317,0.9887673102679531,0.9887673102679556,0,0,7.18795108795166,7.1706647872924805,2,2
1261,3,4.701704979139342,4.701704979139343,1.003829900792415,1.0038299007924176,0,0,7.192697048187256,7.1706647872924805,3,3
1261,4,4.531142493723923,4.531142493723921,1.0063982398673763,1.006398239867378,0,0,7.5906758308410645,7.1706647872924805,4,4
1261,8,4.341673241309683,4.341673241309679,1.0115183325242392,1.0115183325242418,0,0,8.020816802978516,7.1706647872924805,8,8
1261,16,3.8207773335300446,3.959501330532857,1.0193409818610553,1.018624623598302,4,3,8.6968412399292,7.1706647872924805,12,13
1261,32,3.4427206627769302,3.74799685298774,1.0217772099907934,1.0243502469479506,11,18,9.17017936706543,7.1706647872924805,21,14
1261,64,2.435054823270896,3.711994449497359,1.0145847695568728,1.026632556685024,35,47,9.668710708618164,7.1706647872924805,29,17
1261,128,1.4102419017128804,3.598682217981449,1.0030277092621736,1.0301982694823941,53,105,10.53380012512207,7.1706647872924805,75,23
1262,1,8.784606218166614,8.784606218166616,0.9613690681621627,0.9613690681621632,0,0,8.862746238708496,8.862746238708496,1,1
1262,2,7.77564740885029,7.77564740885029,0.9852799049863947,0.9852799049863954,0,0,8.990914344787598,8.862746238708496,2,2
1262,3,6.6487171802221985,6.648717180222199,1.006571152155796,1.0065711521557952,0,0,9.425492286682129,8.862746238708496,3,3
1262,4,5.876625624198782,5.876625624198783,1.0198938053146145,1.0198938053146147,0,0,9.765548706054688,8.862746238708496,4,4
1262,8,5.49255885509196,5.494229302026235,1.0282620683560215,1.0282478984459542,2,2,10.3008394241333,8.862746238708496,6,6
1262,16,5.039767765701341,5.085979774663646,1.036064380282336,1.0354818555372687,2,5,10.833002090454102,8.862746238708496,14,11
1262,32,4.636719452055902,4.967200522296801,1.0320106167905307,1.0368449716428323,11,16,11.280839920043945,8.862746238708496,21,16
1262,64,3.300341277809448,4.9624709419970445,1.0189385889000975,1.0376237422729426,28,44,12.171663284301758,8.862746238708496,36,20
1262,128,1.9050527501462078,4.962461687956723,1.0045807988300846,1.037652408469517,65,107,13.14057445526123,8.862746238708496,63,21
1263,1,11.20775223314956,11.207752233149565,0.9239750135102643,0.9239750135102661,0,0,11.439810752868652,11.439810752868652,1,1
1263,2,10.390266920619899,10.390266920619899,0.9558803589293661,0.9558803589293663,0,0,12.818896293640137,11.439810752868652,2,2
1263,3,10.376845913305925,10.376845913305928,0.9574331075242424,0.9574331075242423,0,0,13.72480297088623,11.439810752868652,3,3
1263,4,10.371759689140852,10.371759689140854,0.9585618145957892,0.9585618145957899,0,0,13.753838539123535,11.439810752868652,4,4
1263,8,9.589074194347859,9.640652968908205,0.9775820005994204,0.979998437165551,4,5,15.032171249389648,11.439810752868652,4,3
1263,16,9.096566460876495,9.454108144237123,0.9898864948866305,0.9904114016820085,5,11,15.624382019042969,11.439810752868652,11,5
1263,32,7.871079952394612,9.43270070221071,1.0015714862746707,0.993745217906783,13,25,16.391204833984375,11.439810752868652,19,7
1263,64,5.135277458994366,9.306613832984723,1.0171673509937236,1.0076586318601661,30,55,17.078161239624023,11.439810752868652,34,9
1263,128,3.888491830514393,9.028409986964508,1.0072432150457982,1.0272261063613797,61,118,17.718975067138672,11.439810752868652,67,10
1264,1,7.234841556981237,7.234841556981241,0.9755748057015594,0.9755748057015613,0,0,7.272801876068115,7.272801876068115,1,1
1264,2,5.227984762095214,5.227984762095214,1.0011152139372914,1.0011152139372914,0,0,7.457998752593994,7.272801876068115,2,2
1264,3,4.805484596950602,4.805484596950602,1.0058148251293821,1.005814825129382,0,0,7.6279520988464355,7.272801876068115,3,3
1264,4,4.276970796425578,4.276970796425577,1.0122328127906286,1.0122328127906295,0,0,7.718796253204346,7.272801876068115,4,4
1264,8,4.005699530238538,4.005699530238554,1.0174398867316459,1.0174398867316468,0,0,8.381789207458496,7.272801876068115,8,8
1264,16,3.715053829090563,3.870979597351409,1.0195428024972286,1.0210681362022873,4,5,9.121298789978027,7.272801876068115,12,11
1264,32,3.157015579130771,3.690682097678861,1.0203977804949502,1.0255110786879835,15,18,9.81092357635498,7.272801876068115,17,14
1264,64,2.178928871403221,3.579228610183931,1.0113140180432356,1.0270758838884455,32,48,10.176225662231445,7.272801876068115,32,16
1264,128,1.254711555140938,3.5661580365194183,1.0014775506496367,1.0282719154023834,62,106,10.888284683227539,7.272801876068115,66,22
1265,1,8.478394613760182,8.47839461376018,0.9477708596095726,0.9477708596095721,0,0,8.622535705566406,8.622535705566406,1,1
1265,2,7.355691429601405,7.355691429601403,0.9674311421893593,0.9674311421893595,0,0,8.805280685424805,8.622535705566406,2,2
1265,3,6.824028390667804,6.824028390667804,0.9835418443977471,0.9835418443977477,0,0,10.125065803527832,8.622535705566406,3,3
1265,4,6.4913459934203015,6.4913459934203015,0.9927089286271977,0.9927089286271976,0,0,10.225336074829102,8.622535705566406,4,4
1265,8,6.35746881667317,6.397842146692822,0.9950062731161381,0.996182017852101,2,2,10.814042091369629,8.622535705566406,6,6
1265,16,6.0269214663992665,6.213247971833006,1.0056379574049252,1.0052016314171444,4,7,11.159326553344727,8.622535705566406,12,9
1265,32,5.2343192335608935,5.960159240296291,1.0147070243069658,1.0189679015873112,15,20,11.720268249511719,8.622535705566406,17,12
1265,64,3.957960479099108,5.677651987259053,1.0141535213722401,1.0251267653838583,29,49,12.38159465789795,8.622535705566406,35,15
1265,128,2.1501175688594785,5.536278716625062,1.0059443771110965,1.0296390620038394,55,113,13.07473087310791,8.622535705566406,73,15
1266,1,9.857092861979254,9.85709286197925,0.9359265464344231,0.9359265464344255,0,0,10.042933464050293,10.042933464050293,1,1
1266,2,8.046613561831412,8.046613561831395,0.9788010405517833,0.9788010405517849,0,0,10.074716567993164,10.042933464050293,2,2
1266,3,6.859760938212507,6.859760938212506,1.0011725120395931,1.001172512039593,0,0,10.273033142089844,10.042933464050293,3,3
1266,4,6.819014939880181,6.859760938212506,1.00121608814361,1.001172512039593,1,1,10.437006950378418,10.042933464050293,3,3
1266,8,5.84861193629498,5.937647222531939,1.0212955837201143,1.020431510623378,2,2,10.835755348205566,10.042933464050293,6,6
1266,16,5.310524802457063,5.540356759344049,1.027892197216632,1.0296279998490074,5,7,11.802022933959961,10.042933464050293,11,9
1266,32,4.205343790187323,5.540356759344049,1.0206702672367773,1.0296279998490074,12,23,12.387829780578613,10.042933464050293,20,9
1266,64,2.8609318280481366,5.498416507188039,1.010053797700119,1.0330997270924602,33,50,13.217979431152344,10.042933464050293,31,14
1266,128,1.880280908068054,5.490220612795581,1.0017566979135957,1.0337395351853305,66,116,14.23940372467041,10.042933464050293,62,12
1267,1,8.574995814969798,8.574995814969801,0.9645955097682439,0.9645955097682459,0,0,8.639143943786621,8.639143943786621,1,1
1267,2,7.8407564485427494,7.840756448542752,0.9765829290297507,0.9765829290297533,0,0,8.807578086853027,8.639143943786621,2,2
1267,3,6.514984599894531,6.514984599894532,0.9998639125675551,0.9998639125675575,0,0,8.825702667236328,8.639143943786621,3,3
1267,4,5.715469296342104,5.715469296342103,1.0104846350279908,1.0104846350279926,0,0,9.045655250549316,8.639143943786621,4,4
1267,8,4.547573746777595,4.617632087996221,1.025072290490834,1.024482039950489,1,1,9.424050331115723,8.639143943786621,7,7
1267,16,4.136806620962511,4.403011519859389,1.0311428975744803,1.0309767137029655,4,5,10.834019660949707,8.639143943786621,12,11
1267,32,3.5761710783363116,4.403011519859389,1.020306333996773,1.0309767137029655,12,21,12.039725303649902,8.639143943786621,20,11
1267,64,2.8555496284014033,4.388050671484317,1.0088840724926036,1.0322384911582094,31,53,12.92475414276123,8.639143943786621,33,11
1267,128,2.089393416087332,4.377228965859793,1.006056160342227,1.0337954441980126,62,115,14.001787185668945,8.639143943786621,66,13
1268,1,9.940627681267008,9.940627681267015,0.9380024826956542,0.9380024826956571,0,0,10.109792709350586,10.109792709350586,1,1
1268,2,8.559502955699168,8.55950295569917,0.9683819944381542,0.9683819944381558,0,0,10.522987365722656,10.109792709350586,2,2
1268,3,8.284351256355272,8.284351256355276,0.9760094108754015,0.9760094108754029,0,0,10.622478485107422,10.109792709350586,3,3
1268,4,8.117375563337164,8.117375563337166,0.981620150252704,0.981620150252705,0,0,11.164666175842285,10.109792709350586,4,4
1268,8,7.779284719449348,7.779284719449349,0.9947763310746445,0.9947763310746469,0,0,11.794904708862305,10.109792709350586,8,8
1268,16,6.4578153546050885,7.202547893896475,1.0094180906827366,1.0104118385302985,5,7,12.77346420288086,10.109792709350586,11,9
1268,32,5.595428599955637,7.147571966472699,1.0171055613150068,1.0154568590680446,13,21,13.373540878295898,10.109792709350586,19,11
1268,64,3.8142499146851634,7.095730852293894,1.0067577285812732,1.0179204542426397,33,51,13.780733108520508,10.109792709350586,31,13
1268,128,2.4555755948569,6.825481048397277,1.004843006887942,1.026429806235855,66,110,14.34614086151123,10.109792709350586,62,18
1269,1,9.466314568818035,9.466314568818037,0.9503959163303097,0.9503959163303114,0,0,9.584003448486328,9.584003448486328,1,1
1269,2,8.917912448984488,8.91791244898449,0.9652078203886583,0.9652078203886592,0,0,10.208881378173828,9.584003448486328,2,2
1269,3,8.588863104045458,8.588863104045458,0.9800370268675822,0.9800370268675823,0,0,11.438374519348145,9.584003448486328,3,3
1269,4,8.363757699735594,8.363757699735592,0.987145650424281,0.9871456504242813,0,0,11.74675464630127,9.584003448486328,4,4
1269,8,7.135481544320264,7.150103242379371,1.0151346825641485,1.0152074066087575,1,1,12.013788223266602,9.584003448486328,7,7
1269,16,6.514337074994947,6.75060316555129,1.0251972665775089,1.0290403973733608,4,5,12.610587120056152,9.584003448486328,12,11
1269,32,6.049632806914225,6.621988285106865,1.030340843722596,1.0348464723578916,11,19,13.047039031982422,9.584003448486328,21,13
1269,64,4.621206553080485,6.3083082434685505,1.032889168878258,1.0468760141240339,29,48,13.37685489654541,9.584003448486328,35,16
1269,128,2.9109793487642217,6.262137302492399,1.019590770256122,1.0492034790808498,65,108,13.861124038696289,9.584003448486328,63,20
1270,1,7.859295073211081,7.859295073211083,0.9614725478985262,0.9614725478985271,0,0,7.946200847625732,7.946200847625732,1,1
1270,2,7.063368284677854,7.063368284677854,0.977962309190187,0.9779623091901869,0,0,8.361090660095215,7.946200847625732,2,2
1270,3,6.681791768061152,6.681791768061153,0.9829387081660543,0.982938708166055,0,0,8.36214542388916,7.946200847625732,3,3
1270,4,5.657689596308103,5.657689596308102,0.9988606476396111,0.9988606476396102,0,0,8.371617317199707,7.946200847625732,4,4
1270,8,5.587120307860242,5.591040035698249,1.0003191478530826,1.0003971401046856,2,2,8.722755432128906,7.946200847625732,6,6
1270,16,5.16135862059243,5.3918369866629785,1.0072893155441676,1.0052344217792726,5,7,9.135892868041992,7.946200847625732,11,9
1270,32,4.889156777189048,5.335681009765275,1.0095915422113695,1.0073098075925353,12,20,9.49760913848877,7.946200847625732,20,12
1270,64,3.7505937803950045,5.0573883782852596,1.005092848030813,1.01552649743646,32,48,9.97424602508545,7.946200847625732,32,16
1270,128,2.0078582275284527,5.051899104181624,1.002446745885273,1.0160125700628155,64,109,10.277544975280762,7.946200847625732,64,19
1271,1,7.682558541769349,7.6825585417693265,0.9707730829192689,0.9707730829192726,0,0,7.730086803436279,7.730086803436279,1,1
1271,2,6.834437218290648,6.83443721829065,0.989533301877234,0.9895333018772372,0,0,9.020943641662598,7.730086803436279,2,2
1271,3,6.60988979226799,6.609889792267991,0.9956263567855982,0.9956263567856007,0,0,9.489400863647461,7.730086803436279,3,3
1271,4,6.5943563931389635,6.609889792267991,0.9952378302874109,0.9956263567856007,1,1,9.83798599243164,7.730086803436279,3,3
1271,8,5.900984984942411,5.972575368428342,1.0086091791647764,1.0090522744661583,2,2,9.950830459594727,7.730086803436279,6,6
1271,16,4.987610125050036,5.257160569754668,1.0219629092365239,1.0230903409436514,5,7,10.371926307678223,7.730086803436279,11,9
1271,32,4.334799528451048,5.005686719870125,1.0237033103226656,1.0287977152840029,15,23,11.21297836303711,7.730086803436279,17,9
1271,64,3.031043780671161,4.955967940054852,1.014454124229316,1.0322233177885265,25,50,12.52035903930664,7.730086803436279,39,14
1271,128,1.6809913586528245,4.924929804088232,1.0037981682549082,1.0359413903937553,66,111,13.59642219543457,7.730086803436279,62,17
1272,1,12.919348141811364,12.919348141811366,0.8923130093122843,0.8923130093122866,0,0,13.304698944091797,13.304698944091797,1,1
1272,2,11.293729324207748,11.29372932420775,0.9488518566143624,0.9488518566143647,0,0,14.021685600280762,13.304698944091797,2,2
1272,3,11.212004594515161,11.212004594515161,0.9525002814955057,0.9525002814955077,0,0,14.227768898010254,13.304698944091797,3,3
1272,4,10.715126871870071,10.715126871870073,0.9659770276533021,0.9659770276533035,0,0,14.27485466003418,13.304698944091797,4,4
1272,8,9.151444267472714,9.192992636956395,1.0129947406213344,1.0139625499678933,1,2,14.618837356567383,13.304698944091797,7,6
1272,16,8.455017410353255,8.538592327162041,1.0357909720228533,1.0363192407509014,3,5,15.666671752929688,13.304698944091797,13,11
1272,32,7.20816997021928,8.20692073717543,1.0442728705248059,1.0498808132696686,14,21,16.299917221069336,13.304698944091797,18,11
1272,64,5.801204996698891,8.014338186610932,1.0493355974479073,1.0577451463589373,28,47,16.912508010864258,13.304698944091797,36,17
1272,128,4.393251688410678,7.995627300407625,1.0421357542819,1.0607399922209189,67,107,17.592647552490234,13.304698944091797,61,21
1273,1,8.976738058207511,8.976738058207513,0.9536348325965577,0.9536348325965617,0,0,9.084689140319824,9.084689140319824,1,1
1273,2,8.447587486923217,8.447587486923222,0.9684817374873571,0.9684817374873598,0,0,9.816282272338867,9.084689140319824,2,2
1273,3,8.377652875038255,8.377652875038256,0.9715368189239616,0.9715368189239635,0,0,9.845203399658203,9.084689140319824,3,3
1273,4,7.365693947087707,7.365693947087708,0.9924883401534994,0.9924883401535001,0,0,9.963595390319824,9.084689140319824,4,4
1273,8,6.48224372271952,6.504538394088425,1.0102003820872993,1.0088253099834694,3,3,10.534968376159668,9.084689140319824,5,5
1273,16,5.769352909167857,5.911086979770788,1.0279750402104977,1.0248333640003633,3,5,11.095651626586914,9.084689140319824,13,11
1273,32,5.298832469443575,5.729170186538862,1.0269565905958764,1.0330487350797881,14,19,12.221370697021484,9.084689140319824,18,13
1273,64,3.7921763506772086,5.380007156860098,1.0163076945098737,1.0431698605883502,29,49,13.013084411621094,9.084689140319824,35,15
1273,128,2.3908744583895607,5.274762668473736,1.0068285096025258,1.0509151948946922,57,111,14.010080337524414,9.084689140319824,71,17
1274,1,5.555979906573436,5.555979906573437,0.9850440698421618,0.9850440698421633,0,0,5.574336528778076,5.574336528778076,1,1
1274,2,4.639028544994351,4.639028544994352,0.9996429531909132,0.9996429531909147,0,0,7.657443523406982,5.574336528778076,2,2
1274,3,4.452320215941943,4.452320215941943,1.0022120456053558,1.002212045605357,0,0,7.8977952003479,5.574336528778076,3,3
1274,4,4.297827823814357,4.297827823814355,1.0056363243827775,1.0056363243827786,0,0,8.406867980957031,5.574336528778076,4,4
1274,8,4.00824538203163,4.013510025838307,1.01121813383013,1.0112527991303186,1,1,8.849466323852539,5.574336528778076,7,7
1274,16,3.921214940140775,3.9668034416038447,1.0126536177082315,1.0131626762445995,6,6,9.425509452819824,5.574336528778076,10,10
1274,32,3.6568986516494464,3.915647880341157,1.0130271530383141,1.01526767612465,11,16,9.722622871398926,5.574336528778076,21,16
1274,64,2.5069158887782783,3.8234528372887473,1.0090461529516017,1.0190416552752692,26,47,10.065021514892578,5.574336528778076,38,17
1274,128,1.6316349142017703,3.759775640783365,1.0065612896291747,1.0226124428519512,65,105,10.616199493408203,5.574336528778076,63,23
1275,1,7.124403361075846,7.124403361075852,0.9759333543074353,0.9759333543074379,0,0,7.161599159240723,7.161599159240723,1,1
1275,2,5.686323002816461,5.686323002816461,0.998058886535049,0.9980588865350513,0,0,7.404852867126465,7.161599159240723,2,2
1275,3,5.371504639925512,5.3715046399255115,1.0021913253671482,1.0021913253671504,0,0,7.656923770904541,7.161599159240723,3,3
1275,4,5.354912942636139,5.354912942636138,1.0024618150432094,1.0024618150432114,0,0,7.698191165924072,7.161599159240723,4,4
1275,8,4.47698511155356,4.537351410728012,1.011015994976693,1.01144906706589,1,2,7.944209098815918,7.161599159240723,7,6
1275,16,3.9367300060563117,4.049157430986668,1.0158242532644137,1.0163067199929565,6,8,8.467958450317383,7.161599159240723,10,8
1275,32,3.2088693346348665,3.7691647406640008,1.0177551862983494,1.0215895677142248,18,21,8.890729904174805,7.161599159240723,14,11
1275,64,2.521179746594218,3.7430993645570685,1.0087213802871746,1.0224695445988097,36,50,9.435973167419434,7.161599159240723,28,14
1275,128,1.2119252089256125,3.737008872638618,1.0028341192834616,1.023321106824146,62,113,9.977510452270508,7.161599159240723,66,15
1276,1,9.069859349266675,9.069859349266679,0.950169575985036,0.9501695759850376,0,0,9.193607330322266,9.193607330322266,1,1
1276,2,7.813982264672268,7.81398226467227,0.9818288376978181,0.9818288376978196,0,0,10.847963333129883,9.193607330322266,2,2
1276,3,7.22075304725069,7.220753047250691,0.9982552811038815,0.998255281103883,0,0,11.300609588623047,9.193607330322266,3,3
1276,4,6.835758780455814,6.835758780455812,1.006636552800957,1.006636552800959,0,0,11.662446975708008,9.193607330322266,4,4
1276,8,6.657903455570662,6.6594356994524695,1.0137927644733042,1.013674388279778,1,1,12.222040176391602,9.193607330322266,7,7
1276,16,6.011537936801548,6.329862875022113,1.0265203509740297,1.0226859560281762,5,7,12.465466499328613,9.193607330322266,11,9
1276,32,5.1883316379537145,6.156363296581742,1.0234293418122546,1.02828807729216,13,20,13.077006340026855,9.193607330322266,19,12
1276,64,4.011923027133522,5.845952418828839,1.0223567400944962,1.0378493051466529,30,50,13.758794784545898,9.193607330322266,34,14
1276,128,2.3547598348564,5.527135245637857,1.0100598772742884,1.0495870323746384,60,111,14.393210411071777,9.193607330322266,68,17
1277,1,6.154185683293445,6.154185683293448,0.9748525950908179,0.9748525950908188,0,0,6.2006025314331055,6.2006025314331055,1,1
1277,2,4.851629093581807,4.851629093581807,0.9985950550415638,0.9985950550415648,0,0,8.02161979675293,6.2006025314331055,2,2
1277,3,4.8018997793885605,4.8018997793885605,1.0010443236980766,1.0010443236980775,0,0,8.931654930114746,6.2006025314331055,3,3
1277,4,4.715239581597606,4.715239581597605,1.004087516170514,1.004087516170517,0,0,9.084280967712402,6.2006025314331055,4,4
1277,8,4.347731081079858,4.494737625651134,1.0091816080455953,1.007851307890463,1,3,9.30601692199707,6.2006025314331055,7,5
1277,16,4.045493332887795,4.267300681158173,1.0157678378938297,1.013966272458616,6,10,10.113340377807617,6.2006025314331055,10,6
1277,32,3.4690002645974807,4.243124218855175,1.0107309999121914,1.0154665670316583,12,26,10.832332611083984,6.2006025314331055,20,6
1277,64,2.49546036860322,4.209946372527546,1.0080620323788576,1.0172985831670394,27,54,11.335545539855957,6.2006025314331055,37,10
1277,128,1.5226058650448,4.117487928484462,0.9984578866704835,1.0223289780501856,70,116,11.979667663574219,6.2006025314331055,58,12
1278,1,7.687360392848768,7.687360392848768,0.9657180770783591,0.9657180770783592,0,0,7.7541913986206055,7.7541913986206055,1,1
1278,2,6.590796075670706,6.590796075670707,0.9803233780795615,0.9803233780795615,0,0,8.417407035827637,7.7541913986206055,2,2
1278,3,6.407918161893857,6.407918161893857,0.9835944960322242,0.983594496032224,0,0,8.443426132202148,7.7541913986206055,3,3
1278,4,6.139656835239151,6.139656835239151,0.9885493943597314,0.9885493943597304,0,0,8.645084381103516,7.7541913986206055,4,4
1278,8,5.135199306311424,5.170080172066788,1.0123001131051201,1.0103049444689611,2,2,9.328744888305664,7.7541913986206055,6,6
1278,16,4.725585283769214,4.855255120287841,1.0170892461452783,1.015200237283488,5,6,9.630507469177246,7.7541913986206055,11,10
1278,32,4.095836950387246,4.459588682114863,1.025575608495402,1.0236088807114183,14,20,10.19035530090332,7.7541913986206055,18,12
1278,64,3.2951425720026357,4.399195529460112,1.0148911575304604,1.0255666020694407,28,49,10.863723754882812,7.7541913986206055,36,15
1278,128,1.7087838959873418,4.302887790400865,1.0064202674776264,1.0300673799667006,64,105,11.632792472839355,7.7541913986206055,64,23
1279,1,8.73311542075278,8.73311542075274,0.9542667785942559,0.954266778594259,0,0,8.841568946838379,8.841568946838379,1,1
1279,2,7.560345967812805,7.560345967812806,0.9793859590809846,0.9793859590809871,0,0,8.872410774230957,8.841568946838379,2,2
1279,3,7.110248954274887,7.110248954274888,0.9933010843168137,0.993301084316816,0,0,9.616717338562012,8.841568946838379,3,3
1279,4,6.812108670911279,6.812108670911279,1.00031952131178,1.0003195213117813,0,0,10.272069931030273,8.841568946838379,4,4
1279,8,6.219472546278854,6.387476373435218,1.0123626298636639,1.0132567421016012,2,2,11.13125228881836,8.841568946838379,6,6
1279,16,5.714146769654464,6.3264946549968855,1.0134737696156595,1.0160064110335598,5,7,11.545427322387695,8.841568946838379,11,9
1279,32,4.486733291619934,5.5662995530561,1.0200791273279999,1.0328267204377901,12,21,12.328250885009766,8.841568946838379,20,11
1279,64,3.371713816352767,5.430014240121167,1.0079030427884548,1.0401511019126284,32,50,12.900154113769531,8.841568946838379,32,14
1279,128,2.0708486563156323,5.327970129985209,1.0053492760418314,1.0432595047558328,62,111,13.524704933166504,8.841568946838379,66,17
1280,1,1.8982590371268564,1.898259037126857,0.9984743434068609,0.9984743434068631,0,0,1.898821234703064,1.898821234703064,1,1
1280,2,1.461527417263775,1.4615274172637753,0.999213609946445,0.9992136099464456,0,0,2.024611711502075,1.898821234703064,2,2
1280,3,1.3492168122085426,1.3492168122085426,0.9999104499264737,0.9999104499264747,0,0,2.1821835041046143,1.898821234703064,3,3
1280,4,1.2581292482144766,1.2581292482144768,1.0008147733973392,1.000814773397339,0,0,2.414236307144165,1.898821234703064,4,4
1280,8,1.2199567330983554,1.220015201564336,1.0012279430913253,1.0012383834376752,1,1,2.616499423980713,1.898821234703064,7,7
1280,16,1.0447787526746493,1.2054424663305765,1.0002662551617882,1.0015070728939266,5,7,3.080716609954834,1.898821234703064,11,9
1280,32,0.7276660142266488,1.151300028532922,1.0005839142566038,1.0023401021361835,13,20,3.45562744140625,1.898821234703064,19,12
1280,64,0.33013459538130524,1.0756375324914826,1.0002424089718958,1.002985490533466,26,52,3.836103677749634,1.898821234703064,38,12
1280,128,0.02336767350942868,1.0459367965760311,1.0000172562958054,1.0031396140005129,69,114,4.3336405754089355,1.898821234703064,59,14
1281,1,10.429848644981808,10.429848644981812,0.9207383117519916,0.9207383117519926,0,0,10.693852424621582,10.693852424621582,1,1
1281,2,10.001008179912205,10.001008179912205,0.9325208158087284,0.9325208158087283,0,0,11.273385047912598,10.693852424621582,2,2
1281,3,9.791537668784246,9.791537668784246,0.9405777127259013,0.940577712725901,0,0,11.709925651550293,10.693852424621582,3,3
1281,4,8.990148297917834,8.993845162956937,0.9639108502854538,0.9635786481566575,1,1,11.733648300170898,10.693852424621582,3,3
1281,8,8.45872333838123,8.465009273306533,0.9835046418469859,0.9827850450816715,1,1,12.410006523132324,10.693852424621582,7,7
1281,16,8.034835887273221,8.131830963354895,0.9973735844441177,0.9964866275586164,4,5,12.873771667480469,10.693852424621582,12,11
1281,32,6.986842196308872,8.037695255610265,0.9950001033052044,1.000589382555594,13,18,13.502178192138672,10.693852424621582,19,14
1281,64,4.844896363526541,7.397221214717359,1.0080605472771866,1.0252013339724775,30,50,14.045355796813965,10.693852424621582,34,14
1281,128,2.7174203879189602,7.104698296017597,1.009683439166368,1.0393564313163617,61,112,14.767411231994629,10.693852424621582,67,16
1282,1,8.538613786198866,8.538613786198871,0.9506677092087007,0.9506677092087025,0,0,8.666500091552734,8.666500091552734,1,1
1282,2,8.130461056248055,8.130461056248055,0.9624396847731046,0.9624396847731047,0,0,9.187978744506836,8.666500091552734,2,2
1282,3,8.107819440296256,8.107819440296256,0.9641877044954703,0.9641877044954708,0,0,10.158163070678711,8.666500091552734,3,3
1282,4,8.020484237053829,8.020484237053829,0.9685745732483839,0.9685745732483839,0,0,10.162901878356934,8.666500091552734,4,4
1282,8,7.8043341798755606,7.835571965720469,0.9733841551622027,0.9736695889335476,2,2,10.502680778503418,8.666500091552734,6,6
1282,16,7.00484080312169,7.327120212220811,0.9998036406880495,0.9939894766967217,4,6,10.854002952575684,8.666500091552734,12,10
1282,32,5.674872872108817,6.591613414593413,1.014329216351068,1.0109546938388438,13,23,11.252544403076172,8.666500091552734,19,9
1282,64,4.371130862871058,6.271245347452783,1.0015334632547381,1.017043285413639,31,52,11.841259002685547,8.666500091552734,33,12
1282,128,2.5017292515089173,6.227581525961423,0.9946720949086527,1.019746716513012,67,116,12.377031326293945,8.666500091552734,61,12
1283,1,8.395555203143113,8.395555203143115,0.9425818770362956,0.9425818770362959,0,0,8.576375007629395,8.576375007629395,1,1
1283,2,7.230500890680059,7.230500890680058,0.969024158878968,0.9690241588789675,0,0,8.994222640991211,8.576375007629395,2,2
1283,3,7.149495389417551,7.149495389417552,0.9687855850072364,0.9687855850072372,0,0,9.377239227294922,8.576375007629395,3,3
1283,4,7.144943466065627,7.149495389417552,0.9686444016340103,0.9687855850072372,1,1,9.525314331054688,8.576375007629395,3,3
1283,8,6.935375892213241,7.131919326589437,0.9709963700106279,0.9697453171728909,4,4,9.951708793640137,8.576375007629395,4,4
1283,16,6.441772881690773,6.821591737653034,0.9825066761226873,0.982770271059215,7,12,10.292454719543457,8.576375007629395,9,4
1283,32,5.392860196035375,6.462120707979626,1.001044192516116,0.9967358860921844,13,24,10.567094802856445,8.576375007629395,19,8
1283,64,4.954648537579207,6.462120707979626,0.9993503699300655,0.9967358860921844,29,56,10.966262817382812,8.576375007629395,35,8
1283,128,3.8102753554441664,6.445333908713743,0.9981471821497342,0.9987752612153886,64,117,11.356575965881348,8.576375007629395,64,11
1284,1,8.726019325336907,8.726019325336912,0.9459903968457641,0.9459903968457662,0,0,8.873186111450195,8.873186111450195,1,1
1284,2,7.438133378206142,7.438133378206144,0.9749070276995159,0.9749070276995175,0,0,9.420205116271973,8.873186111450195,2,2
1284,3,6.946319348056368,6.946319348056369,0.9869840906872254,0.9869840906872267,0,0,9.674820899963379,8.873186111450195,3,3
1284,4,6.6671286329998525,6.667128632999853,0.9917220785007308,0.9917220785007321,0,0,9.724353790283203,8.873186111450195,4,4
1284,8,5.715341062090535,5.8021111908214635,1.0109959054312934,1.0087571316354964,2,2,9.833185195922852,8.873186111450195,6,6
1284,16,4.885001105004195,5.166963285919717,1.0275032950100482,1.0241290810075503,5,7,10.34092903137207,8.873186111450195,11,9
1284,32,4.235296579406494,5.0542156965152785,1.0254750416104736,1.0285142069959674,16,21,11.063036918640137,8.873186111450195,16,11
1284,64,3.070400715810246,4.93469200701056,1.0142356653064835,1.034728915068798,28,49,11.882543563842773,8.873186111450195,36,15
1284,128,1.8198509951768131,4.81579607149332,1.0079251402947442,1.0421678310125944,58,111,12.485867500305176,8.873186111450195,70,17
1285,1,9.473474565443906,9.473474565443908,0.9526583335872083,0.9526583335872092,0,0,9.576685905456543,9.576685905456543,1,1
1285,2,8.135704902303933,8.135704902303935,0.9770952710722731,0.9770952710722736,0,0,9.585498809814453,9.576685905456543,2,2
1285,3,7.693140002865753,7.693140002865753,0.9847703266137986,0.9847703266137982,0,0,9.850236892700195,9.576685905456543,3,3
1285,4,7.042020498241423,7.042020498241424,0.9975991380889839,0.9975991380889832,0,0,9.961623191833496,9.576685905456543,4,4
1285,8,6.53796146610154,6.537961466101539,1.005343414192001,1.0053434141920004,0,0,10.344396591186523,9.576685905456543,8,8
1285,16,6.113379346021177,6.189824898541368,1.0152077212701847,1.0149263748854145,5,6,11.132880210876465,9.576685905456543,11,10
1285,32,4.924009652761229,5.988517162169703,1.022128656221438,1.0213093761356795,13,19,11.85953140258789,9.576685905456543,19,13
1285,64,3.8176572519118417,5.936451586915697,1.0129591257113892,1.025523455443957,32,46,12.41463565826416,9.576685905456543,32,18
1285,128,2.415161402751725,5.853379073699512,1.0019787907589688,1.0288172292789652,60,107,12.99342155456543,9.576685905456543,68,21
1286,1,8.011160575784716,8.011160575784686,0.957350742048949,0.9573507420489513,0,0,8.112793922424316,8.112793922424316,1,1
1286,2,5.962139933392936,5.962139933392938,0.9926381861669218,0.9926381861669242,0,0,8.212265014648438,8.112793922424316,2,2
1286,3,5.6746863610846,5.674686361084601,0.9963243258195809,0.9963243258195824,0,0,8.624242782592773,8.112793922424316,3,3
1286,4,5.463128668759336,5.463128668759337,1.0005078043226465,1.0005078043226483,0,0,8.80186939239502,8.112793922424316,4,4
1286,8,5.244704091803426,5.268829717178353,1.0041069788198205,1.0044923779246133,2,2,9.278533935546875,8.112793922424316,6,6
1286,16,4.341840471167003,4.4632651981828815,1.0157990469666967,1.0170095068206941,4,4,9.756113052368164,8.112793922424316,12,12
1286,32,4.006781723014394,4.385913892904194,1.0157317295500352,1.018862984415268,10,19,10.326513290405273,8.112793922424316,22,13
1286,64,3.0686292256929386,4.29858829812325,1.010491555759449,1.022642036523047,33,49,10.91272258758545,8.112793922424316,31,15
1286,128,1.9067669800085432,4.292672923938607,0.9988182803064244,1.023442239059237,64,111,11.566641807556152,8.112793922424316,64,17
1287,1,9.574958858871872,9.574958858871868,0.9406354107949028,0.9406354107949033,0,0,9.736135482788086,9.736135482788086,1,1
1287,2,7.418415863951628,7.418415863951628,0.9945196990783316,0.9945196990783325,0,0,10.328922271728516,9.736135482788086,2,2
1287,3,6.964998677252204,6.964998677252204,1.0019909378138792,1.0019909378138792,0,0,10.414691925048828,9.736135482788086,3,3
1287,4,6.447816221957376,6.447816221957376,1.012273485843323,1.0122734858433222,0,0,10.560386657714844,9.736135482788086,4,4
1287,8,6.0889507262049705,6.143568065079563,1.0194661325069394,1.0188801177083953,2,3,11.178913116455078,9.736135482788086,6,5
1287,16,5.824922985070491,6.0652427860452045,1.0263367419546712,1.0218606645159591,3,6,11.860060691833496,9.736135482788086,13,10
1287,32,5.1410016482858225,5.9283953314137925,1.0263565017091054,1.0253160702612103,12,19,12.496644020080566,9.736135482788086,20,13
1287,64,3.871113049913919,5.857016204674057,1.012660517822571,1.030373261755794,31,51,13.013120651245117,9.736135482788086,33,13
1287,128,2.1703600783788266,5.848457749344139,1.004004375925017,1.0310108855301576,66,112,13.456018447875977,9.736135482788086,62,16
1288,1,7.843627783989563,7.843627783989569,0.9585636428185834,0.9585636428185859,0,0,7.941703796386719,7.941703796386719,1,1
1288,2,7.414909114051508,7.414909114051511,0.9680008986048254,0.9680008986048265,0,0,9.323731422424316,7.941703796386719,2,2
1288,3,6.828942463446982,6.828942463446982,0.9809541155178392,0.9809541155178393,0,0,9.420254707336426,7.941703796386719,3,3
1288,4,6.754375902159953,6.7543759021599525,0.9847386361287844,0.9847386361287847,0,0,9.491474151611328,7.941703796386719,4,4
1288,8,6.464106334165343,6.501826589061683,0.9903459263660168,0.9907520795037065,3,3,9.901585578918457,7.941703796386719,5,5
1288,16,5.968052188755963,6.442389818004619,0.9954575681192269,0.9939254566910855,5,8,10.538458824157715,7.941703796386719,11,8
1288,32,4.703878791474201,5.588762917528502,1.0106576132404927,1.0167978888228213,12,25,10.968866348266602,7.941703796386719,20,7
1288,64,2.5981153943687603,5.341374940027759,1.004351947078883,1.0261496581563017,29,53,11.928462028503418,7.941703796386719,35,11
1288,128,1.8079284516091922,5.185916870134375,1.002459620213984,1.0298246689716848,66,114,12.888681411743164,7.941703796386719,62,14
1289,1,10.216564679029776,10.216564679029776,0.9400323717561108,0.9400323717561109,0,0,10.375011444091797,10.375011444091797,1,1
1289,2,7.6460995350041845,7.6460995350041845,0.9993162493584429,0.9993162493584405,0,0,10.483715057373047,10.375011444091797,2,2
1289,3,7.443477139155985,7.443477139155986,1.0042802229369625,1.0042802229369598,0,0,11.182271957397461,10.375011444091797,3,3
1289,4,7.439927773449339,7.4399277734493365,1.0046549415503987,1.0046549415503956,0,0,11.191431045532227,10.375011444091797,4,4
1289,8,7.066360338904474,7.250078694643582,1.009037708063873,1.007603316049847,2,3,11.890484809875488,10.375011444091797,6,5
1289,16,6.4494454350139465,6.81415950705598,1.0259434193500303,1.0225868552235207,4,7,12.235967636108398,10.375011444091797,12,9
1289,32,5.960133300734655,6.63742754021285,1.0266568445720585,1.0247606668500724,13,21,12.543130874633789,10.375011444091797,19,11
1289,64,4.679300728672546,6.401652472645704,1.0320243739016082,1.0332962770586138,26,52,12.986245155334473,10.375011444091797,38,12
1289,128,2.967359559382371,6.337378315432712,1.0142881719798753,1.037917213538122,59,110,13.356797218322754,10.375011444091797,69,18
1290,1,8.701181177842916,8.701181177842917,0.9588448847946551,0.958844884794656,0,0,8.790517807006836,8.790517807006836,1,1
1290,2,7.042149567442847,7.042149567442848,0.989636224683557,0.9896362246835579,0,0,8.892241477966309,8.790517807006836,2,2
1290,3,6.240695646099538,6.240695646099537,1.0014349656338697,1.0014349656338717,0,0,9.007576942443848,8.790517807006836,3,3
1290,4,6.088485611197171,6.088485611197171,1.0052826685764646,1.0052826685764658,0,0,9.173762321472168,8.790517807006836,4,4
1290,8,5.0880316527819005,5.17981574060671,1.0182570519277743,1.016564198197874,2,2,9.569905281066895,8.790517807006836,6,6
1290,16,4.680781344590503,4.839720630556261,1.025236990681036,1.0261870101724946,5,7,9.968317985534668,8.790517807006836,11,9
1290,32,4.016352636829588,4.677156606242072,1.0266405222079968,1.0303174874416927,11,17,10.3939847946167,8.790517807006836,21,15
1290,64,2.9949697212171165,4.637375298954806,1.0135957793649202,1.0331423519315552,32,47,11.216853141784668,8.790517807006836,32,17
1290,128,1.6752721706017328,4.605440853766623,1.0036248950232056,1.0349547973711744,57,106,11.811551094055176,8.790517807006836,71,22
1291,1,9.779075143259432,9.779075143259437,0.9360741706632563,0.9360741706632585,0,0,9.962089538574219,9.962089538574219,1,1
1291,2,8.657420542878937,8.65742054287894,0.9700712197975511,0.9700712197975533,0,0,10.870128631591797,9.962089538574219,2,2
1291,3,7.974621908098292,7.974621908098294,0.9876803302538326,0.9876803302538348,0,0,11.061338424682617,9.962089538574219,3,3
1291,4,7.971061829654099,7.971061829654101,0.9878048194109921,0.9878048194109942,0,0,11.064970016479492,9.962089538574219,4,4
1291,8,7.750776611819905,7.763066029165727,0.995355604600828,0.9953222191356286,2,2,11.952258110046387,9.962089538574219,6,6
1291,16,6.63678235765314,7.2607874690195935,1.0155229608193816,1.0178645063815412,7,7,13.192034721374512,9.962089538574219,9,9
1291,32,5.937650138058851,6.984775045090901,1.0208976659987847,1.026374935945371,12,20,13.659891128540039,9.962089538574219,20,12
1291,64,4.379874411873803,6.958666453899483,1.0010516638670905,1.0294680887687908,34,50,14.37613582611084,9.962089538574219,30,14
1291,128,2.7146550312028,6.86693090115471,1.0028593940275536,1.0355972878162967,62,110,15.290263175964355,9.962089538574219,66,18
1292,1,8.60236387878128,8.602363878781281,0.9547670113515607,0.9547670113515615,0,0,8.710649490356445,8.710649490356445,1,1
1292,2,6.963401036693293,6.963401036693295,0.9895393560227181,0.9895393560227184,0,0,9.437321662902832,8.710649490356445,2,2
1292,3,6.797498523868424,6.797498523868423,0.9920821378351059,0.9920821378351059,0,0,9.444746017456055,8.710649490356445,3,3
1292,4,6.510639192676782,6.510639192676783,0.9958097947805495,0.9958097947805501,0,0,9.973965644836426,8.710649490356445,4,4
1292,8,6.083839596688529,6.1046095450678575,1.0103021464254622,1.0102657909891448,2,2,10.269732475280762,8.710649490356445,6,6
1292,16,5.60783906442801,5.794208711356116,1.0182538324297914,1.0185023037041345,5,6,10.627120971679688,8.710649490356445,11,10
1292,32,4.64382031013645,5.592579939163696,1.0182077186487466,1.0223732323826762,11,22,11.649066925048828,8.710649490356445,21,10
1292,64,3.4166128926649573,5.5398705435592674,1.0037611819554662,1.0275093075210575,31,52,12.597887992858887,8.710649490356445,33,12
1292,128,2.1586756379377916,5.5286991740143,1.0024487453364834,1.028606949755511,58,115,13.253447532653809,8.710649490356445,70,13
1293,1,9.620301871098658,9.620301871098606,0.9500191635941576,0.9500191635941604,0,0,9.733460426330566,9.733460426330566,1,1
1293,2,8.081904464955837,8.081904464955837,0.9799543450989132,0.9799543450989141,0,0,10.0989990234375,9.733460426330566,2,2
1293,3,7.833222439150567,7.8332224391505685,0.9864830375512752,0.9864830375512763,0,0,10.477275848388672,9.733460426330566,3,3
1293,4,7.559181781126527,7.559181781126527,0.9924271633674928,0.9924271633674944,0,0,10.503494262695312,9.733460426330566,4,4
1293,8,6.03752233719497,6.123477413271754,1.0196353046935198,1.0182594938983354,2,2,10.666468620300293,9.733460426330566,6,6
1293,16,5.306291259182343,5.950283653833021,1.0277955006885975,1.0240557883936832,6,6,11.678512573242188,9.733460426330566,10,10
1293,32,4.3937532793641205,5.632483410447202,1.0270784698028737,1.0351958742166139,14,20,12.896233558654785,9.733460426330566,18,12
1293,64,2.758249452178922,5.629642800000586,1.0077777139666226,1.0357076733138688,29,52,13.593585968017578,9.733460426330566,35,12
1293,128,1.6598771355922988,5.59316421808404,1.0019136560076838,1.0389534029410614,58,114,14.459992408752441,9.733460426330566,70,14
1294,1,5.370679085985183,5.370679085985183,0.9811931885302942,0.9811931885302958,0,0,5.400036334991455,5.400036334991455,1,1
1294,2,4.424774702468588,4.424774702468588,0.9972527255401702,0.9972527255401711,0,0,6.39915657043457,5.400036334991455,2,2
1294,3,4.1985408019439,4.1985408019439,1.002674633853507,1.002674633853507,0,0,6.851075649261475,5.400036334991455,3,3
1294,4,4.090939308392072,4.090939308392072,1.0046085623110224,1.004608562311023,0,0,6.855434417724609,5.400036334991455,4,4
1294,8,3.3775057152054524,3.377505715205451,1.015112204943503,1.0151122049435037,0,0,7.366918087005615,5.400036334991455,8,8
1294,16,3.0924902725751915,3.0944775855796336,1.018960035106537,1.0193229292577866,2,3,8.070723533630371,5.400036334991455,14,13
1294,32,2.797292535034204,3.0074293312174536,1.0148426803210557,1.0212197369550466,13,15,8.700211524963379,5.400036334991455,19,17
1294,64,2.112659366242815,2.9687578999097206,1.0103064404409143,1.023957001176621,31,43,9.412677764892578,5.400036334991455,33,21
1294,128,1.1251431655538189,2.9687578999097206,1.0015105333628336,1.0239570011766208,61,107,10.376343727111816,5.400036334991455,67,21
1295,1,2.241166726123701,2.2411667261237023,0.9975904072563173,0.9975904072563189,0,0,2.242422342300415,2.242422342300415,1,1
1295,2,1.929641426726025,1.9296414267260251,0.9987956128719475,0.9987956128719486,0,0,2.3758158683776855,2.242422342300415,2,2
1295,3,1.618768061460193,1.618768061460193,1.0001593198271712,1.0001593198271723,0,0,2.4107165336608887,2.242422342300415,3,3
1295,4,1.618552989795329,1.6187680614601931,1.0001379761844242,1.0001593198271723,1,1,2.753591775894165,2.242422342300415,3,3
1295,8,1.06377453681586,1.06377453681586,1.002752541225271,1.002752541225271,0,0,2.8768370151519775,2.242422342300415,8,8
1295,16,1.0067747323982679,1.0499191299550468,1.002681700493113,1.0027265643557042,5,7,2.9825618267059326,2.242422342300415,11,9
1295,32,0.7545854001773019,0.9576623213545894,1.001472054074774,1.0028458888659633,13,20,3.3424127101898193,2.242422342300415,19,12
1295,64,0.4346954500930951,0.9158251662047178,1.000241630169961,1.003390814433959,30,50,3.8811488151550293,2.242422342300415,34,14
1295,128,0.05128545520893103,0.8797413570075837,0.9999904683713664,1.0032719359839186,60,113,4.373597621917725,2.242422342300415,68,15
1296,1,7.996419543592756,7.996419543592736,0.9642391169636184,0.964239116963619,0,0,8.069637298583984,8.069637298583984,1,1
1296,2,7.556551977179486,7.556551977179485,0.971335368635416,0.9713353686354155,0,0,8.116665840148926,8.069637298583984,2,2
1296,3,6.70545683565925,6.70545683565925,0.9874985809887113,0.9874985809887116,0,0,8.453392028808594,8.069637298583984,3,3
1296,4,6.684566543232796,6.684566543232798,0.9887039118891042,0.9887039118891047,0,0,9.071024894714355,8.069637298583984,4,4
1296,8,5.663195849994169,5.694311498200585,1.0081283435276345,1.0080356894080942,2,2,9.226764678955078,8.069637298583984,6,6
1296,16,5.321180148786297,5.607224916637805,1.0112716759240872,1.010219161971364,5,6,9.470561027526855,8.069637298583984,11,10
1296,32,4.562294713948562,5.34662489341464,1.010491705636516,1.0140983377665984,14,21,10.190692901611328,8.069637298583984,18,11
1296,64,2.948141781834901,5.1868514662879965,1.0034390142839937,1.0220422149731938,30,50,10.83684253692627,8.069637298583984,34,14
1296,128,1.7384491638816455,5.132819265918733,1.0001068805877917,1.024956128889933,66,111,11.419458389282227,8.069637298583984,62,17
1297,1,7.512159791635198,7.512159791635201,0.9698927790388078,0.9698927790388104,0,0,7.56469202041626,7.56469202041626,1,1
1297,2,6.252062856668996,6.2520628566689975,0.9906109500055612,0.9906109500055637,0,0,7.653587341308594,7.56469202041626,2,2
1297,3,6.144465548868668,6.144465548868667,0.9931620470999576,0.9931620470999594,0,0,8.072616577148438,7.56469202041626,3,3
1297,4,5.634574392971839,5.634574392971838,1.0019176084062558,1.001917608406257,0,0,8.35978889465332,7.56469202041626,4,4
1297,8,4.017514356472169,4.112523547979392,1.0216326210489637,1.021147750743489,2,2,8.680191040039062,7.56469202041626,6,6
1297,16,3.884540944649739,3.9961342693602666,1.0239399407305687,1.0239195993824828,4,6,9.203335762023926,7.56469202041626,12,10
1297,32,3.5567452428971893,3.9593821152374584,1.023777841602486,1.0254056454326705,11,19,9.731287956237793,7.56469202041626,21,13
1297,64,2.7512694704209006,3.933917007919432,1.0102390420273355,1.0270777597140128,31,49,10.630684852600098,7.56469202041626,33,15
1297,128,1.689461928803541,3.900648091884621,1.0019444559271793,1.0298539845758001,65,110,11.472280502319336,7.56469202041626,63,18
1298,1,10.847022475719603,10.847022475719605,0.929320026795879,0.9293200267958793,0,0,11.052483558654785,11.052483558654785,1,1
1298,2,9.931793752436349,9.931793752436347,0.9524185443942247,0.9524185443942242,0,0,11.091626167297363,11.052483558654785,2,2
1298,3,8.140044125837543,8.140044125837543,0.9999171003398344,0.9999171003398343,0,0,11.36012077331543,11.052483558654785,3,3
1298,4,7.854637142557112,7.854637142557112,1.0084136522784453,1.0084136522784444,0,0,11.638846397399902,11.052483558654785,4,4
1298,8,6.504410163942723,6.504410163942723,1.0338036029870055,1.0338036029870055,0,0,11.897624015808105,11.052483558654785,8,8
1298,16,5.930332705260291,6.057193288347914,1.0437694192464289,1.0440976341141777,3,4,12.427734375,11.052483558654785,13,12
1298,32,5.629084981720531,5.863124529420686,1.0495961518034307,1.0500981625306762,10,15,13.1400146484375,11.052483558654785,22,17
1298,64,4.492897086581627,5.713894379490758,1.0392467664589733,1.0575773721741528,27,43,13.841285705566406,11.052483558654785,37,21
1298,128,2.5196020148300025,5.65380153881104,1.0146157112233445,1.060996429445975,62,104,14.402787208557129,11.052483558654785,66,24
1299,1,11.518983585449632,11.518983585449625,0.9052324742956911,0.9052324742956931,0,0,11.872467994689941,11.872467994689941,1,1
1299,2,10.244295461191461,10.244295461191447,0.939374145644546,0.9393741456445476,0,0,12.021292686462402,11.872467994689941,2,2
1299,3,10.182737479415069,10.182737479415072,0.9418318375702248,0.9418318375702259,0,0,12.301557540893555,11.872467994689941,3,3
1299,4,9.93089860566506,9.930898605665062,0.950111863408594,0.9501118634085948,0,0,12.833272933959961,11.872467994689941,4,4
1299,8,9.793872081110452,9.924105940678503,0.9534249897860917,0.9512485346944829,1,2,13.012809753417969,11.872467994689941,7,6
1299,16,8.062376081035163,8.486864831977973,1.0000366595455266,0.9980549570397945,6,8,13.404354095458984,11.872467994689941,10,8
1299,32,7.04483441006642,7.47457312713767,1.0247061073987944,1.0284151149779945,18,23,13.745914459228516,11.872467994689941,14,9
1299,64,5.675408453624287,7.383275008738124,1.0215692343169998,1.0330515374675364,26,52,14.381163597106934,11.872467994689941,38,12
1299,128,3.6761858154747484,7.32747089417039,1.0127317775751679,1.0377550253043808,61,111,14.873518943786621,11.872467994689941,67,17
1300,1,7.648202609985541,7.648202609985541,0.9591456155481747,0.9591456155481747,0,0,7.748455047607422,7.748455047607422,1,1
1300,2,6.686916090479572,6.6869160904795715,0.9789187568560116,0.9789187568560112,0,0,8.296022415161133,7.748455047607422,2,2
1300,3,6.369328879057451,6.369328879057451,0.9877502299171055,0.987750229917104,0,0,8.591647148132324,7.748455047607422,3,3
1300,4,6.28119619083563,6.2811961908356295,0.9923543033237331,0.9923543033237316,0,0,9.517401695251465,7.748455047607422,4,4
1300,8,5.9649486712811814,6.089483197432129,0.9998827294344681,0.9987763352862828,2,2,9.9277982711792,7.748455047607422,6,6
1300,16,4.96269416677878,5.7032412332812354,1.011736508072149,1.0095194180034017,6,8,10.555656433105469,7.748455047607422,10,8
1300,32,4.234078590323967,5.699127942362147,1.0112883617371997,1.009802438680746,13,23,11.018335342407227,7.748455047607422,19,9
1300,64,3.428138922412662,5.331863595912402,1.0125491864705842,1.0270735928507786,29,50,11.624805450439453,7.748455047607422,35,14
1300,128,1.8245803621899024,5.192264090806075,1.0054598263786592,1.0323246341550978,63,111,12.241884231567383,7.748455047607422,65,17
1301,1,7.327304319586245,7.327304319586252,0.970960831123381,0.9709608311233833,0,0,7.380201816558838,7.380201816558838,1,1
1301,2,6.494821370938355,6.494821370938357,0.9880345617135837,0.9880345617135851,0,0,8.06346321105957,7.380201816558838,2,2
1301,3,5.223238732201055,5.223238732201053,1.0050594586908872,1.0050594586908883,0,0,8.28135871887207,7.380201816558838,3,3
1301,4,4.7936749805949095,4.793674980594908,1.0108720347950726,1.010872034795074,0,0,8.343792915344238,7.380201816558838,4,4
1301,8,4.351859367666079,4.369669902088039,1.0187872142501608,1.0194810644924752,1,1,8.582245826721191,7.380201816558838,7,7
1301,16,4.104977289232236,4.280075105520355,1.0198718297333809,1.021633892063114,4,6,9.124369621276855,7.380201816558838,12,10
1301,32,3.750753137088799,4.128378624630636,1.021326480969043,1.0252207214019506,12,20,9.635645866394043,7.380201816558838,20,12
1301,64,2.5323364872822576,4.013421393081634,1.014065044107836,1.0291504695129454,22,46,10.171727180480957,7.380201816558838,42,18
1301,128,1.3417911956154982,3.9837241581820617,1.003292723763106,1.0304774232928986,61,106,10.767356872558594,7.380201816558838,67,22
1302,1,3.6077927878975644,3.6077927878975657,0.9945939896222529,0.9945939896222545,0,0,3.6116740703582764,3.6116740703582764,1,1
1302,2,2.900762973083315,2.900762973083315,0.999600555839669,0.9996005558396707,0,0,3.8184497356414795,3.6116740703582764,2,2
1302,3,2.6155680024402646,2.6155680024402637,1.0022258788962337,1.0022258788962355,0,0,4.059024333953857,3.6116740703582764,3,3
1302,4,2.405741706815319,2.405741706815318,1.0028351653122833,1.0028351653122844,0,0,4.062806129455566,3.6116740703582764,4,4
1302,8,2.212535059233106,2.2135980428930893,1.0037488584330432,1.0037882286097095,2,2,4.298055648803711,3.6116740703582764,6,6
1302,16,1.8743581485550855,2.136479936023539,1.003631652984331,1.004889567803289,4,8,4.500362873077393,3.6116740703582764,12,8
1302,32,1.4552074015659626,2.125805709575368,1.001431803237844,1.0050581296249232,15,22,4.957014083862305,3.6116740703582764,17,10
1302,64,0.8274067914869949,2.0735688050430543,1.0016020750465073,1.0060073772897564,29,54,5.383207321166992,3.6116740703582764,35,10
1302,128,0.060792790566488904,2.0689658856195106,0.9999655624213215,1.006198279612142,62,114,6.052286624908447,3.6116740703582764,66,14
1303,1,10.936572540677096,10.93657254067709,0.9345433837451538,0.9345433837451561,0,0,11.104042053222656,11.104042053222656,1,1
1303,2,9.53809855771596,9.538098557715962,0.973721096622086,0.9737210966220877,0,0,12.024616241455078,11.104042053222656,2,2
1303,3,8.916130100891996,8.916130100891994,0.9908169559750013,0.9908169559750026,0,0,12.210612297058105,11.104042053222656,3,3
1303,4,8.510750944427357,8.51075094442736,0.9976268040378611,0.997626804037862,0,0,12.232593536376953,11.104042053222656,4,4
1303,8,7.988547319950783,7.995262876627693,1.011565599270672,1.0108418207435448,1,1,12.885034561157227,11.104042053222656,7,7
1303,16,7.218213742160424,7.635547322638113,1.0190659598391874,1.0211338167651027,5,7,13.764644622802734,11.104042053222656,11,9
1303,32,6.14746003171772,7.143458366478603,1.0346089930770128,1.0355934229256563,11,22,14.249053001403809,11.104042053222656,21,10
1303,64,4.5513116232407045,7.062657896542579,1.0175385308045406,1.0395311126350704,29,51,14.723139762878418,11.104042053222656,35,13
1303,128,3.094756980430451,6.984041734592438,1.0123836093407121,1.0454136062993689,66,110,15.447195053100586,11.104042053222656,62,18
1304,1,6.45175052938265,6.451750529382651,0.9784473795477796,0.9784473795477809,0,0,6.484294891357422,6.484294891357422,1,1
1304,2,5.090158296589994,5.090158296589995,0.9960889984317007,0.996088998431702,0,0,6.499354362487793,6.484294891357422,2,2
1304,3,4.854518323855593,4.854518323855593,0.9999286203511318,0.9999286203511328,0,0,6.675504684448242,6.484294891357422,3,3
1304,4,4.513344280388903,4.513344280388903,1.004807126109514,1.0048071261095144,0,0,6.729787349700928,6.484294891357422,4,4
1304,8,3.8305984282244463,3.84276384428501,1.0136660059259002,1.0133974294607533,2,2,7.45603609085083,6.484294891357422,6,6
1304,16,3.521899814439707,3.6682743535739406,1.0173253432362217,1.0163976542893183,5,8,7.8400187492370605,6.484294891357422,11,8
1304,32,2.8180273427849962,3.2857809379403977,1.0172441072308303,1.0216823665711416,12,19,8.544516563415527,6.484294891357422,20,13
1304,64,2.0380711520534844,3.248753779524118,1.0072507621016424,1.0221452030035052,29,50,9.33568286895752,6.484294891357422,35,14
1304,128,1.0185170432743305,3.2486351229982713,0.9997213231515119,1.022220366409622,57,113,10.103033065795898,6.484294891357422,71,15
1305,1,2.780371585947344,2.780371585947343,0.9964577576979021,0.9964577576979045,0,0,2.7825307846069336,2.7825307846069336,1,1
1305,2,2.20766581150215,2.20766581150215,1.000271630078431,1.0002716300784318,0,0,3.0128204822540283,2.7825307846069336,2,2
1305,3,1.8718306617800617,1.8718306617800615,1.0026099763589797,1.0026099763589815,0,0,3.7360150814056396,2.7825307846069336,3,3
1305,4,1.765330625458456,1.7653306254584644,1.0033704013121798,1.0033704013121802,0,0,3.751417875289917,2.7825307846069336,4,4
1305,8,1.7160483658448467,1.7295248263353182,1.0037325103645467,1.003837998513086,1,3,3.822077512741089,2.7825307846069336,7,5
1305,16,1.4307956062441727,1.53365817134149,1.0049632715896044,1.005832596082676,4,5,4.094925880432129,2.7825307846069336,12,11
1305,32,1.1001413381431935,1.507590446072923,1.0031064348846876,1.0058801887649353,15,21,4.405545234680176,2.7825307846069336,17,11
1305,64,0.7303919618408979,1.4818086017961496,1.0011620241085182,1.0063159445922667,27,50,4.762330532073975,2.7825307846069336,37,14
1305,128,0.16624183651665297,1.4785842147848511,1.0000636627223969,1.0065316576330774,62,113,5.376890182495117,2.7825307846069336,66,15
1306,1,7.20893450740678,7.2089345074067825,0.9764326365131449,0.9764326365131474,0,0,7.243517875671387,7.243517875671387,1,1
1306,2,5.93237164871816,5.932371648718161,0.9959415712761656,0.9959415712761673,0,0,7.540958881378174,7.243517875671387,2,2
1306,3,5.57364228360704,5.57364228360704,0.9992730623924386,0.99927306239244,0,0,7.542322635650635,7.243517875671387,3,3
1306,4,5.541276710818112,5.541276710818112,0.9993168316419684,0.9993168316419697,0,0,7.6606550216674805,7.243517875671387,4,4
1306,8,5.194244935951399,5.244982131387913,1.0034985947641175,1.0028675300228678,1,1,8.21971607208252,7.243517875671387,7,7
1306,16,4.241623362937231,4.285690856192158,1.0203607211408237,1.0199068415694201,6,6,9.027737617492676,7.243517875671387,10,10
1306,32,3.7885226682995423,4.269358124336192,1.015524274166291,1.0209361453925878,10,20,9.457884788513184,7.243517875671387,22,12
1306,64,2.5088413940339658,4.131920788972792,1.0055656612591148,1.0247555560454968,31,49,10.161580085754395,7.243517875671387,33,15
1306,128,1.459445682327868,4.12594040660537,1.0022073479416063,1.0251168104734125,62,109,10.869423866271973,7.243517875671387,66,19
1307,1,8.06894803387415,8.068948033874154,0.9659082965370096,0.9659082965370112,0,0,8.134437561035156,8.134437561035156,1,1
1307,2,6.352432487523059,6.35243248752306,0.9951240488890859,0.9951240488890871,0,0,8.270502090454102,8.134437561035156,2,2
1307,3,5.459158838085867,5.459158838085866,1.0103086513859059,1.0103086513859065,0,0,8.51606273651123,8.134437561035156,3,3
1307,4,5.40397831114374,5.403978311143743,1.0114689949501714,1.0114689949501723,0,0,9.049883842468262,8.134437561035156,4,4
1307,8,5.151346844166613,5.254157884589274,1.0133647765378733,1.0153182795690936,3,3,9.796953201293945,8.134437561035156,5,5
1307,16,4.727283441218636,5.0391293933247665,1.0200234095208607,1.0233240048733099,5,7,10.259181022644043,8.134437561035156,11,9
1307,32,4.254612277368312,4.9470019793470135,1.018746754092604,1.0257720075956054,15,19,10.886794090270996,8.134437561035156,17,13
1307,64,3.113609747955923,4.748867286378674,1.0147502290256825,1.0329791188926112,28,49,11.520397186279297,8.134437561035156,36,15
1307,128,1.4689741551517093,4.746397249227201,1.0010014372707554,1.0339818363022013,59,113,12.630523681640625,8.134437561035156,69,15
1308,1,10.176077698124681,10.176077698124669,0.940935845913814,0.9409358459138162,0,0,10.326373100280762,10.326373100280762,1,1
1308,2,8.813171496441221,8.813171496441221,0.9711854147328687,0.9711854147328709,0,0,10.409587860107422,10.326373100280762,2,2
1308,3,8.44695505328938,8.446955053289381,0.9803103518727301,0.9803103518727314,0,0,10.698711395263672,10.326373100280762,3,3
1308,4,8.245226652788903,8.245226652788904,0.9841970263657309,0.984197026365732,0,0,10.93878173828125,10.326373100280762,4,4
1308,8,7.712199660109423,7.712199660109424,0.9994949701641473,0.9994949701641482,0,0,11.334424018859863,10.326373100280762,8,8
1308,16,6.232244685783762,6.378112734372992,1.0356633841243763,1.0347440441809534,6,7,11.804877281188965,10.326373100280762,10,9
1308,32,5.234802338601276,6.085128848923956,1.028651284083372,1.0416525432240058,14,20,12.488341331481934,10.326373100280762,18,12
1308,64,3.494477270965675,5.928500645129986,1.0209015735354041,1.0449712490390137,27,50,13.413660049438477,10.326373100280762,37,14
1308,128,1.955054943153162,5.892264338509276,1.005810138087066,1.0485684403955666,63,112,14.287429809570312,10.326373100280762,65,16
1309,1,5.489971902242025,5.489971902242025,0.9807700480856679,0.9807700480856683,0,0,5.5203399658203125,5.5203399658203125,1,1
1309,2,4.323467888430051,4.323467888430051,0.9952404521903261,0.995240452190326,0,0,5.6169586181640625,5.5203399658203125,2,2
1309,3,4.112023406528099,4.112023406528099,0.9985326669195207,0.9985326669195201,0,0,5.885817050933838,5.5203399658203125,3,3
1309,4,4.058251633385369,4.05825163338537,0.998949986392567,0.9989499863925666,0,0,6.088773727416992,5.5203399658203125,4,4
1309,8,3.5622861733666507,3.664839867406287,1.0058580787046218,1.0055306724149065,2,3,6.875921249389648,5.5203399658203125,6,5
1309,16,3.3274249166200685,3.474280535557575,1.0100267425707754,1.0112923081733751,5,7,7.849777698516846,5.5203399658203125,11,9
1309,32,2.9288641861635876,3.3067709183928304,1.0138217362241222,1.0155187685244986,14,19,8.496806144714355,5.5203399658203125,18,13
1309,64,1.7412807529856498,3.1878828976014377,1.006038374373563,1.01774950549567,33,48,8.984418869018555,5.5203399658203125,31,16
1309,128,1.0332479645279622,3.0966000658089134,1.0019928665926967,1.0199282511961476,65,109,9.740160942077637,5.5203399658203125,63,19
1310,1,8.941966860552482,8.941966860552482,0.9540301032381951,0.9540301032381957,0,0,9.05036449432373,9.05036449432373,1,1
1310,2,7.527202372428511,7.527202372428509,0.9805233926109551,0.9805233926109544,0,0,9.142082214355469,9.05036449432373,2,2
1310,3,6.594052901910803,6.594052901910804,0.9958605909154548,0.9958605909154552,0,0,9.183321952819824,9.05036449432373,3,3
1310,4,6.259702589866432,6.259702589866432,1.0032792029395932,1.0032792029395927,0,0,9.394512176513672,9.05036449432373,4,4
1310,8,5.971871977300456,6.0610129031773505,1.0115278773015248,1.0103164370597475,2,2,10.12099838256836,9.05036449432373,6,6
1310,16,5.541003245776827,5.940141863334341,1.0198318182208386,1.0155088269295942,5,8,10.98823356628418,9.05036449432373,11,8
1310,32,4.371275932382755,5.333630117614388,1.0187092222522436,1.0258629030518762,17,22,11.444859504699707,9.05036449432373,15,10
1310,64,3.1616458710308653,5.287993054471226,1.0127878700831332,1.028215230768954,28,52,12.096085548400879,9.05036449432373,36,12
1310,128,1.8053536961332473,5.246170928244677,1.0065330666360688,1.0328212583546175,67,113,12.62851619720459,9.05036449432373,61,15
1311,1,7.990737147384486,7.9907371473844915,0.9561097544964148,0.9561097544964167,0,0,8.100749015808105,8.100749015808105,1,1
1311,2,7.5005198071974535,7.500519807197455,0.9707003754731569,0.970700375473158,0,0,8.450301170349121,8.100749015808105,2,2
1311,3,7.109131970591937,7.109131970591938,0.9782716624775201,0.9782716624775216,0,0,8.640030860900879,8.100749015808105,3,3
1311,4,6.465975749248771,6.465975749248771,0.9898816223504163,0.989881622350417,0,0,8.664093017578125,8.100749015808105,4,4
1311,8,5.972833095232846,5.979385704672572,0.9961269488801301,0.9961762822594773,1,1,8.941238403320312,8.100749015808105,7,7
1311,16,5.294330530828949,5.621799188385779,1.0049769204109325,1.003707730847489,5,7,9.342144012451172,8.100749015808105,11,9
1311,32,4.124865222986374,5.186680675077385,1.0025966419206043,1.010690270100814,15,23,9.72275161743164,8.100749015808105,17,9
1311,64,2.856920481175854,4.834855503866939,1.003677844445841,1.0177940083889132,31,50,10.112139701843262,8.100749015808105,33,14
1311,128,1.4818593043663204,4.796644404693562,1.0035544442500508,1.0208201539583153,59,111,10.645180702209473,8.100749015808105,69,17
1312,1,11.74152494133192,11.741524941331923,0.9137236103128017,0.9137236103128029,0,0,12.016505241394043,12.016505241394043,1,1
1312,2,10.578641622500083,10.57864162250008,0.9483158620380627,0.9483158620380618,0,0,12.549595832824707,12.016505241394043,2,2
1312,3,10.51425732312475,10.514257323124756,0.9513070725621606,0.95130707256216,0,0,12.716012954711914,12.016505241394043,3,3
1312,4,10.19076577464138,10.190765774641378,0.958977304944429,0.9589773049444281,0,0,12.738682746887207,12.016505241394043,4,4
1312,8,9.459420730246618,9.609861404202869,0.9805483588343888,0.9805791896436339,2,3,13.105881690979004,12.016505241394043,6,5
1312,16,7.725953438263082,8.18430256543728,1.0236100811724211,1.0176341059479177,6,7,13.331941604614258,12.016505241394043,10,9
1312,32,6.760369005249757,7.87086396000955,1.0332599266643654,1.0267670533776747,14,20,13.617827415466309,12.016505241394043,18,12
1312,64,5.763135214076295,7.682445377396671,1.0282699628351681,1.0339444053971185,27,49,14.1013822555542,12.016505241394043,37,15
1312,128,3.1371120218142847,7.4287424819334715,1.0124289933440762,1.0457936230857088,59,105,14.555887222290039,12.016505241394043,69,23
1313,1,8.249020466729801,8.249020466729803,0.960073437212157,0.9600734372121578,0,0,8.33708381652832,8.33708381652832,1,1
1313,2,7.176394903623853,7.176394903623852,0.9817343154111295,0.9817343154111293,0,0,8.636077880859375,8.33708381652832,2,2
1313,3,6.729975717856121,6.729975717856122,0.9898728703681907,0.9898728703681914,0,0,9.002107620239258,8.33708381652832,3,3
1313,4,6.593169043059643,6.593169043059643,0.9928901785853758,0.9928901785853768,0,0,9.350187301635742,8.33708381652832,4,4
1313,8,6.53461160420888,6.552716160839519,0.9956923381406227,0.9957962444355429,1,2,9.746499061584473,8.33708381652832,7,6
1313,16,5.6332885926631855,6.038264994751989,1.0118933494138678,1.0078597540380652,5,7,10.321512222290039,8.33708381652832,11,9
1313,32,4.29486384570864,5.952217659626892,1.0104093029128531,1.0116678692266161,14,19,10.85629653930664,8.33708381652832,18,13
1313,64,3.2311796612695045,5.752499045839966,1.0045994518308485,1.0185938418717333,29,51,11.267204284667969,8.33708381652832,35,13
1313,128,1.7374384152925153,5.535906323848867,1.0060140830187392,1.0281480321521042,65,110,11.90241527557373,8.33708381652832,63,18
1314,1,12.010501873456933,12.01050187345694,0.9035028320872841,0.9035028320872862,0,0,12.354055404663086,12.354055404663086,1,1
1314,2,10.843207359228138,10.843207359228103,0.9366480001915546,0.9366480001915571,0,0,12.446698188781738,12.354055404663086,2,2
1314,3,10.6094295575551,10.609429557555103,0.9408040728515747,0.9408040728515754,0,0,12.578513145446777,12.354055404663086,3,3
1314,4,10.337575350942519,10.337575350942519,0.9498250810312425,0.9498250810312427,0,0,12.632783889770508,12.354055404663086,4,4
1314,8,9.52710442578923,9.53596087248867,0.9745781375207783,0.9742060705242979,1,1,12.754229545593262,12.354055404663086,7,7
1314,16,8.544091624633555,9.151093711953342,0.992416955207603,0.9860040132058676,5,7,13.316434860229492,12.354055404663086,11,9
1314,32,7.002518500128452,8.449791480289269,1.0176755464992644,1.010928576058493,13,22,14.048130989074707,12.354055404663086,19,10
1314,64,4.839038531782805,8.192112929365559,1.0129474115301176,1.022143978493262,32,53,14.801008224487305,12.354055404663086,32,11
1314,128,2.8416220300759383,8.016380596076965,1.0076313801589172,1.0321614674075192,64,115,15.446764945983887,12.354055404663086,64,13
1315,1,9.379066557137216,9.37906655713722,0.9546420381708597,0.9546420381708618,0,0,9.476715087890625,9.476715087890625,1,1
1315,2,7.402844231878522,7.4028442318785235,0.99455693884467,0.9945569388446718,0,0,9.807188987731934,9.476715087890625,2,2
1315,3,6.895461000210156,6.895461000210156,1.0032194622449748,1.0032194622449762,0,0,10.0515718460083,9.476715087890625,3,3
1315,4,6.277076062929072,6.277076062929072,1.0122827049673837,1.012282704967384,0,0,10.091363906860352,9.476715087890625,4,4
1315,8,5.674193305457985,5.708546317036,1.024770835844183,1.0245420017681377,2,2,10.976957321166992,9.476715087890625,6,6
1315,16,5.233421865918489,5.630900807170137,1.029821875678917,1.0270783935996832,7,8,11.223004341125488,9.476715087890625,9,8
1315,32,4.399056277321779,5.487001004147672,1.0328907066613087,1.0315903830196194,12,18,11.691797256469727,9.476715087890625,20,14
1315,64,3.2624534184396894,5.345292206795504,1.0244756558493346,1.0376024197703106,28,46,12.137048721313477,9.476715087890625,36,18
1315,128,1.881410928144751,5.3141983958269075,1.0054567590577248,1.0401379208241295,64,110,12.744715690612793,9.476715087890625,64,18
1316,1,2.2487040738407558,2.248704073840756,0.9963171543480253,0.9963171543480257,0,0,2.2516133785247803,2.2516133785247803,1,1
1316,2,1.8786336407235547,1.8786336407235547,0.9989419312347905,0.9989419312347906,0,0,2.5484397411346436,2.2516133785247803,2,2
1316,3,1.6195217066749983,1.619521706674998,1.0002320551549495,1.0002320551549502,0,0,2.707446813583374,2.2516133785247803,3,3
1316,4,1.6028183399774112,1.6028183399774114,1.0003639486127154,1.0003639486127154,0,0,2.734907865524292,2.2516133785247803,4,4
1316,8,1.4194915372788182,1.4243617038549534,1.0017308138997114,1.0017050775157905,2,2,3.046861171722412,2.2516133785247803,6,6
1316,16,1.102165999925343,1.4000655200026366,1.0016455968946356,1.00231022987754,6,6,3.1471312046051025,2.2516133785247803,10,10
1316,32,0.6827378625278921,1.2023709218083023,1.0019297086919938,1.003453215685649,12,21,3.479537010192871,2.2516133785247803,20,11
1316,64,0.24196027793783842,1.095536337884323,1.0004464598319065,1.0039286780750802,32,50,3.836193084716797,2.2516133785247803,32,14
1316,128,0.01740915082792895,1.0490643136717435,0.9999822111270722,1.0047000370327415,53,111,4.412515163421631,2.2516133785247803,75,17
1317,1,8.182963373618428,8.18296337361841,0.957069664943419,0.9570696649434198,0,0,8.282471656799316,8.282471656799316,1,1
1317,2,7.834721557178096,7.8347215571780975,0.966484340087197,0.9664843400871977,0,0,9.943709373474121,8.282471656799316,2,2
1317,3,6.972436391716456,6.972436391716458,0.9816847367209292,0.9816847367209304,0,0,10.009954452514648,8.282471656799316,3,3
1317,4,6.971950744826526,6.971950744826528,0.9819081126448315,0.9819081126448317,0,0,10.746451377868652,8.282471656799316,4,4
1317,8,6.493842832333848,6.555292373306059,0.9998547139022046,0.9986436525553332,1,1,11.33556842803955,8.282471656799316,7,7
1317,16,6.001811078572058,6.340127109908607,1.0118353610335395,1.007864088511555,6,7,11.759933471679688,8.282471656799316,10,9
1317,32,5.123033723397632,6.185632695891791,1.0179863779334652,1.0190065710118836,15,19,12.273923873901367,8.282471656799316,17,13
1317,64,4.144098527184426,5.985496275908125,1.012702398524424,1.0269917535120991,32,47,12.778975486755371,8.282471656799316,32,17
1317,128,2.576605968527579,5.8694412278435335,0.9992750432563917,1.02865893818805,66,112,13.403005599975586,8.282471656799316,62,16
1318,1,3.5817446718767854,3.581744671876786,0.9919893781963571,0.9919893781963577,0,0,3.590301752090454,3.590301752090454,1,1
1318,2,3.16177318747402,3.16177318747402,0.9954616666793532,0.9954616666793532,0,0,3.7521417140960693,3.590301752090454,2,2
1318,3,3.1022504300941014,3.102250430094101,0.9960853489001649,0.9960853489001645,0,0,3.952502489089966,3.590301752090454,3,3
1318,4,3.007645335012284,3.0080610596708586,0.9974248295472703,0.9973916195408782,1,1,3.98738694190979,3.590301752090454,3,3
1318,8,2.759930824676794,2.7642634250791653,0.9994430531986589,0.9993707277801447,3,3,4.2045488357543945,3.590301752090454,5,5
1318,16,2.261552397970177,2.6868010970558687,1.0018113007891412,1.0005079266538555,6,8,4.3673095703125,3.590301752090454,10,8
1318,32,1.5287328158838258,2.5608635412734913,1.0025333718730371,1.0022272838556776,11,22,4.95217227935791,3.590301752090454,21,10
1318,64,0.887701622172578,2.496578814892474,1.0001613292794582,1.003119979142974,28,53,5.324049472808838,3.590301752090454,36,11
1318,128,0.16622983188387289,2.3820641028933123,0.9998426525208255,1.0056368786994643,62,115,5.878756999969482,3.590301752090454,66,13
1319,1,12.0626180035637,12.062618003563703,0.9061613855755651,0.9061613855755677,0,0,12.381760597229004,12.381760597229004,1,1
1319,2,10.909011023783677,10.90901102378368,0.9456151029926088,0.9456151029926103,0,0,13.36727237701416,12.381760597229004,2,2
1319,3,10.460018784651655,10.460018784651655,0.9647410452107789,0.9647410452107803,0,0,13.847428321838379,12.381760597229004,3,3
1319,4,9.987595491218716,9.987595491218716,0.9802351190737707,0.9802351190737708,0,0,14.131178855895996,12.381760597229004,4,4
1319,8,9.10229539973952,9.109431163407367,1.0067027888805318,1.006581353190203,1,1,14.464988708496094,12.381760597229004,7,7
1319,16,8.142914741588628,8.362846963836496,1.0307178881488874,1.027842027837588,4,6,14.710294723510742,12.381760597229004,12,10
1319,32,7.628175783299024,8.0075607013832,1.0402630409161373,1.0403158974330762,14,14,15.108597755432129,12.381760597229004,18,18
1319,64,6.5027738039531995,7.679695569480038,1.040569799337651,1.0576380136841546,27,40,15.642474174499512,12.381760597229004,37,24
1319,128,4.244050693177462,7.560446066625507,1.0173369440291204,1.0630843551664237,70,106,16.246675491333008,12.381760597229004,58,22
1320,1,7.71696251465468,7.716962514654684,0.965662702067389,0.9656627020673907,0,0,7.785081386566162,7.785081386566162,1,1
1320,2,6.259524365731816,6.259524365731819,0.9877911172665748,0.987791117266577,0,0,8.347176551818848,7.785081386566162,2,2
1320,3,5.884526497368956,5.884526497368956,0.9934804033168749,0.993480403316876,0,0,8.455327987670898,7.785081386566162,3,3
1320,4,5.834087144720001,5.834087144719979,0.9949128857813901,0.9949128857813909,0,0,8.758943557739258,7.785081386566162,4,4
1320,8,5.430031376495718,5.446992654604394,1.0046253622589179,1.004991481264503,1,2,9.419169425964355,7.785081386566162,7,6
1320,16,4.944289140855314,5.006308803148186,1.0130837753922828,1.0151515822617063,5,5,9.819100379943848,7.785081386566162,11,11
1320,32,4.406348932447866,4.981173328399874,1.0121567876207513,1.01717445809623,11,16,10.493186950683594,7.785081386566162,21,16
1320,64,2.9992185302947583,4.7938059883601865,1.0028729135609047,1.0174079950243384,26,50,10.992262840270996,7.785081386566162,38,14
1320,128,1.8084437358468712,4.711035558258756,1.0018708012079944,1.019531025850234,64,110,11.450889587402344,7.785081386566162,64,18
1321,1,5.366470872291283,5.3664708722912815,0.9804264659754206,0.9804264659754228,0,0,5.399842262268066,5.399842262268066,1,1
1321,2,4.477733491982122,4.477733491982123,0.9902621261645042,0.9902621261645049,0,0,5.565271377563477,5.399842262268066,2,2
1321,3,4.217639944219699,4.217639944219699,0.9944544028191817,0.9944544028191813,0,0,5.596333980560303,5.399842262268066,3,3
1321,4,4.0977359804972595,4.09773598049726,0.9948156119462754,0.9948156119462762,0,0,5.617403984069824,5.399842262268066,4,4
1321,8,3.741295588398257,3.7418254243996816,0.9991563755305289,0.999208741009195,1,1,6.451641082763672,5.399842262268066,7,7
1321,16,3.2479595182264016,3.5314411213617527,1.0038372608584325,1.0042779829625204,5,6,6.7340803146362305,5.399842262268066,11,10
1321,32,2.546998805551306,3.3112096396364583,1.0049785384609,1.0087977628757967,12,20,7.416731357574463,5.399842262268066,20,12
1321,64,1.8945697295513422,3.21095715703869,1.002615876753815,1.0117640170192974,32,50,8.180801391601562,5.399842262268066,32,14
1321,128,1.033678202151343,3.1916126904009032,1.000747013126909,1.0129631680618996,63,111,8.73289680480957,5.399842262268066,65,17
1322,1,6.381190220189455,6.381190220189443,0.9746837288153882,0.9746837288153908,0,0,6.426717758178711,6.426717758178711,1,1
1322,2,5.206047282995969,5.206047282995952,0.99115437400096,0.9911543740009621,0,0,6.77707576751709,6.426717758178711,2,2
1322,3,4.410551217727439,4.410551217727437,1.0013734187518075,1.0013734187518093,0,0,6.777760028839111,6.426717758178711,3,3
1322,4,4.310100036035631,4.31010003603563,1.0035119289120917,1.0035119289120935,0,0,6.9606757164001465,6.426717758178711,4,4
1322,8,4.0306194032931,4.038799870845504,1.0081926562687347,1.008229639900098,1,1,7.822021484375,6.426717758178711,7,7
1322,16,3.5798023107562207,3.9133715398551945,1.0099524393317194,1.0103932733914234,5,7,8.302474021911621,6.426717758178711,11,9
1322,32,3.1919628653644008,3.895851516258276,1.0056683065087402,1.0114288542789451,14,21,8.95948600769043,6.426717758178711,18,11
1322,64,2.192573967760149,3.778229052705775,1.005693200034802,1.0160507477601732,31,50,9.532905578613281,6.426717758178711,33,14
1322,128,1.0029079129250424,3.676454415016714,1.0025572947460888,1.0187790993705654,58,111,10.203660011291504,6.426717758178711,70,17
1323,1,6.801917250611044,6.801917250611046,0.9768218668895614,0.9768218668895629,0,0,6.837461471557617,6.837461471557617,1,1
1323,2,5.153614915337537,5.1536149153375375,0.996849290396087,0.9968492903960869,0,0,6.951731204986572,6.837461471557617,2,2
1323,3,4.893058313794244,4.893058313794244,0.9992057255775924,0.9992057255775934,0,0,7.175230026245117,6.837461471557617,3,3
1323,4,4.775719778848266,4.775719778848266,1.001449794093571,1.0014497940935718,0,0,7.256455898284912,6.837461471557617,4,4
1323,8,4.26423643263559,4.268162791493491,1.0075766924885876,1.0079375705646045,2,2,8.126648902893066,6.837461471557617,6,6
1323,16,3.9701999173109566,4.1130662359576675,1.0153942818441484,1.013167541066413,6,6,8.566566467285156,6.837461471557617,10,10
1323,32,3.555783779225308,4.0480325031636095,1.0120817198795335,1.0154217783899968,15,19,8.935327529907227,6.837461471557617,17,13
1323,64,2.45435049194523,4.042176217049717,1.0052744862757397,1.0161375250746547,26,47,9.359508514404297,6.837461471557617,38,17
1323,128,1.5588618319784142,3.892530973427248,1.0019227074912873,1.0197069274959556,63,113,10.081151962280273,6.837461471557617,65,15
1324,1,8.377968891111546,8.377968891111552,0.9593539740876725,0.9593539740876744,0,0,8.46715259552002,8.46715259552002,1,1
1324,2,7.431621751115838,7.431621751115839,0.9847673506253691,0.9847673506253696,0,0,9.647587776184082,8.46715259552002,2,2
1324,3,6.703023232377134,6.703023232377135,0.9982842224815899,0.9982842224815922,0,0,9.7524995803833,8.46715259552002,3,3
1324,4,6.536905638922411,6.53690563892241,1.0031895716646075,1.0031895716646073,0,0,9.846850395202637,8.46715259552002,4,4
1324,8,5.537866363331732,5.584848820614304,1.0199544314419595,1.0193090691843385,2,2,10.150578498840332,8.46715259552002,6,6
1324,16,4.9592885653584275,5.530575502458791,1.0136741160849365,1.0199569771535004,4,9,10.99278450012207,8.46715259552002,12,7
1324,32,4.50637283351786,5.525926470731967,1.0127794440638176,1.0206273617454453,16,24,11.646106719970703,8.46715259552002,16,8
1324,64,3.3936913992797733,5.498055682754297,1.0102498146784806,1.0229288037540747,30,55,12.153178215026855,8.46715259552002,34,9
1324,128,1.7191034198265318,5.438999230596354,1.0029573817670177,1.0266731023758568,64,115,12.863804817199707,8.46715259552002,64,13
1325,1,14.566073141083626,14.566073141083631,0.8439259096989713,0.843925909698974,0,0,15.28972053527832,15.28972053527832,1,1
1325,2,12.892971683798216,12.892971683798223,0.9188930076028088,0.9188930076028108,0,0,15.359612464904785,15.28972053527832,2,2
1325,3,11.676517349836544,11.676517349836548,0.9579451410575605,0.9579451410575637,0,0,15.60204792022705,15.28972053527832,3,3
1325,4,11.07396237817766,11.073962378177661,0.9751565697358264,0.9751565697358298,0,0,15.948705673217773,15.28972053527832,4,4
1325,8,10.784439908887563,10.784439908887567,0.9901413819992371,0.9901413819992406,0,0,16.562753677368164,15.28972053527832,8,8
1325,16,10.11956941674834,10.448230854526374,1.0061641181350454,1.0041515037554303,6,7,17.067943572998047,15.28972053527832,10,9
1325,32,8.721604245903752,9.959215458279548,1.03817736714896,1.027290650621689,10,20,17.505563735961914,15.28972053527832,22,12
1325,64,6.871029253646542,9.793826243462085,1.0378486690022495,1.0361083814059913,28,50,17.77824592590332,15.28972053527832,36,14
1325,128,5.070000927881798,9.6546351550433,1.017606671804023,1.0454448970435326,63,109,18.230510711669922,15.28972053527832,65,19
1326,1,8.067250097306015,8.067250097306017,0.9672269829802074,0.9672269829802083,0,0,8.129006385803223,8.129006385803223,1,1
1326,2,6.541892380281599,6.541892380281599,0.9887798202915967,0.9887798202915958,0,0,8.380834579467773,8.129006385803223,2,2
1326,3,6.380565421933022,6.38056542193302,0.9913841947425408,0.9913841947425402,0,0,8.65648365020752,8.129006385803223,3,3
1326,4,5.965355230757728,5.965355230757727,1.0007565363202013,1.0007565363201993,0,0,9.011542320251465,8.129006385803223,4,4
1326,8,5.338647630612859,5.900857576121245,1.0073262884462104,1.002094246168465,2,3,9.234503746032715,8.129006385803223,6,5
1326,16,4.69155430385232,5.220107051478858,1.016276726518251,1.0194949839272738,6,9,9.530659675598145,8.129006385803223,10,7
1326,32,3.816606929157743,5.0078124114121465,1.0191363994554943,1.0242234975886852,15,23,9.851885795593262,8.129006385803223,17,9
1326,64,2.7004524977569386,4.712346271313437,1.0153775363081174,1.031035080174792,32,53,10.442098617553711,8.129006385803223,32,11
1326,128,1.8491891442993726,4.690146375245266,1.008584848930065,1.0327857631906938,60,116,11.01205062866211,8.129006385803223,68,12
1327,1,6.51056767906271,6.510567679062709,0.9711267701708169,0.9711267701708168,0,0,6.568257808685303,6.568257808685303,1,1
1327,2,5.274627433784988,5.274627433784986,0.9931089584635345,0.9931089584635341,0,0,8.187378883361816,6.568257808685303,2,2
1327,3,4.97272627497606,4.9727262749760595,0.9980820036861888,0.9980820036861877,0,0,8.217968940734863,6.568257808685303,3,3
1327,4,4.901651040733549,4.901651040733549,0.9995387245282639,0.9995387245282625,0,0,8.277915954589844,6.568257808685303,4,4
1327,8,4.599376923642565,4.599376923642566,1.0060856820349855,1.0060856820349837,0,0,8.752120971679688,6.568257808685303,8,8
1327,16,4.1528811391493035,4.328133103505674,1.0122023025054128,1.012582442345467,5,7,9.112082481384277,6.568257808685303,11,9
1327,32,3.6831967679021096,4.177566586062666,1.0151679889923027,1.0182081268027732,14,19,9.96487808227539,6.568257808685303,18,13
1327,64,2.7611818774991375,4.060089516726916,1.0096546590329938,1.0213740405285923,26,50,10.330782890319824,6.568257808685303,38,14
1327,128,1.232097284590577,4.034905865495245,1.0017118702573402,1.0225991296800085,63,112,11.013307571411133,6.568257808685303,65,16
1328,1,9.04769168685168,9.047691686851682,0.9449231048651413,0.9449231048651415,0,0,9.199592590332031,9.199592590332031,1,1
1328,2,7.281317468591935,7.281317468591936,0.9808541785748084,0.9808541785748079,0,0,9.870338439941406,9.199592590332031,2,2
1328,3,7.147917540902338,7.147917540902337,0.9835606755510315,0.9835606755510304,0,0,10.104949951171875,9.199592590332031,3,3
1328,4,7.09323836709606,7.09323836709606,0.9858438388112749,0.985843838811275,0,0,10.307940483093262,9.199592590332031,4,4
1328,8,6.413990381997712,6.676618271769123,0.9956767363830219,0.993798619278292,2,1,10.50179386138916,9.199592590332031,6,7
1328,16,5.918140892647468,6.3561121156552005,1.0105511466937207,1.0039716282422724,5,7,10.765816688537598,9.199592590332031,11,9
1328,32,5.39486817308589,6.2219446270443886,1.015749779041499,1.0084994774630238,13,21,11.069330215454102,9.199592590332031,19,11
1328,64,4.323955756901617,5.950467645762847,1.0133561518880898,1.0177560607059775,31,51,11.395666122436523,9.199592590332031,33,13
1328,128,2.857216286332491,5.8493266121957594,1.0119339907068776,1.022537258400465,64,110,11.812031745910645,9.199592590332031,64,18
1329,1,2.134854441835973,2.1348544418359725,0.9980993960751149,0.9980993960751142,0,0,2.135688304901123,2.135688304901123,1,1
1329,2,1.8814649296652943,1.881464929665294,0.9990916199892554,0.9990916199892541,0,0,2.343069553375244,2.135688304901123,2,2
1329,3,1.6525307313308735,1.6525307313308735,0.9998197585312609,0.99981975853126,0,0,2.4893510341644287,2.135688304901123,3,3
1329,4,1.6434742092397667,1.6434742092397665,0.9998997886135135,0.9998997886135129,0,0,2.5802090167999268,2.135688304901123,4,4
1329,8,1.635499936896043,1.635499936896043,1.0000752549553034,1.000075254955302,0,0,2.780514717102051,2.135688304901123,8,8
1329,16,1.2158693957631574,1.3627014828581474,1.0016754405458166,1.0020880557063543,5,7,3.3103435039520264,2.135688304901123,11,9
1329,32,0.7764917829505585,1.3217967767448584,1.0017202408641794,1.0023024533908806,12,19,3.8356053829193115,2.135688304901123,20,13
1329,64,0.34546808359204706,1.2180922417696591,1.0001616678100604,1.0036284218029494,31,48,4.20841121673584,2.135688304901123,33,16
1329,128,0.024547392626604575,1.1524444363130706,0.9999725707397533,1.0046155949140974,64,106,4.931894779205322,2.135688304901123,64,22
1330,1,7.923736412793237,7.92373641279324,0.9686966610628808,0.9686966610628822,0,0,7.980574607849121,7.980574607849121,1,1
1330,2,6.055006811474417,6.055006811474417,0.9988438539342204,0.9988438539342217,0,0,8.250444412231445,7.980574607849121,2,2
1330,3,5.827391174940474,5.827391174940473,1.002695239062554,1.0026952390625556,0,0,8.644664764404297,7.980574607849121,3,3
1330,4,5.713228937706984,5.713228937706984,1.0052022351019523,1.005202235101953,0,0,8.786333084106445,7.980574607849121,4,4
1330,8,5.247157420008669,5.390040922888743,1.0116620488494368,1.0141873838033026,2,2,10.211928367614746,7.980574607849121,6,6
1330,16,4.57069236840524,5.375135727121965,1.0132872811907805,1.0163939286817372,5,8,10.94736385345459,7.980574607849121,11,8
1330,32,4.081833493558043,5.37458920768741,1.0097321424949186,1.0165863995059556,14,23,11.78854751586914,7.980574607849121,18,9
1330,64,2.987838645518052,5.265763760701423,1.001501846640924,1.0239857435185176,30,52,12.534696578979492,7.980574607849121,34,12
1330,128,1.8285014588422994,5.219110821651851,1.0034533912994834,1.0279547674879004,66,116,13.30598258972168,7.980574607849121,62,12
1331,1,9.298533818652867,9.298533818652878,0.9428484037578742,0.9428484037578773,0,0,9.457069396972656,9.457069396972656,1,1
1331,2,8.72227399441247,8.722273994412477,0.9588309970519887,0.9588309970519915,0,0,10.158419609069824,9.457069396972656,2,2
1331,3,8.149575868110334,8.149575868110338,0.9753912499073489,0.9753912499073507,0,0,10.283784866333008,9.457069396972656,3,3
1331,4,7.766757733444062,7.766757733444064,0.9872670591194432,0.9872670591194457,0,0,10.405254364013672,9.457069396972656,4,4
1331,8,6.732339985518008,6.756593464240279,1.007803260931222,1.007459277083615,2,2,10.881837844848633,9.457069396972656,6,6
1331,16,5.897425468099701,6.083408358613423,1.0272009900257344,1.0253233352846203,4,5,11.326324462890625,9.457069396972656,12,11
1331,32,4.494668253026751,5.422064046471176,1.031254655678693,1.0422878687152117,10,16,11.922544479370117,9.457069396972656,22,16
1331,64,3.1879511754846424,5.353628950860436,1.019467242239927,1.0457992579024222,28,47,12.362204551696777,9.457069396972656,36,17
1331,128,2.1889071293130438,5.2827765458083835,1.0102546936144523,1.0501412457730628,67,109,12.950215339660645,9.457069396972656,61,19
1332,1,9.992617207412007,9.992617207412007,0.9387264001626865,0.9387264001626866,0,0,10.153339385986328,10.153339385986328,1,1
1332,2,8.188265189347398,8.188265189347398,0.9861249801928453,0.9861249801928457,0,0,10.888120651245117,10.153339385986328,2,2
1332,3,7.744017696521328,7.744017696521328,0.9966461778554446,0.9966461778554447,0,0,11.439727783203125,10.153339385986328,3,3
1332,4,7.2892748867406505,7.2892748867406505,1.0030564666546633,1.0030564666546633,0,0,11.466836929321289,10.153339385986328,4,4
1332,8,6.315470181698772,6.352531940799801,1.0272370146500551,1.0273291418237511,1,1,12.263346672058105,10.153339385986328,7,7
1332,16,6.012898187854747,6.185869086673296,1.03132258189141,1.032838668387587,4,5,12.785710334777832,10.153339385986328,12,11
1332,32,5.3535802168962325,6.131884920159299,1.0319110916156748,1.0370000770307324,12,17,13.518194198608398,10.153339385986328,20,15
1332,64,3.8229745610473675,6.068227635945775,1.0198871790549282,1.04169744974627,27,46,14.43596076965332,10.153339385986328,37,18
1332,128,2.12074370873171,6.0403808512096555,1.0011916948552435,1.0443542640092034,61,109,15.601387977600098,10.153339385986328,67,19
1333,1,7.089684775420281,7.089684775420282,0.9688078381703819,0.968807838170383,0,0,7.149956703186035,7.149956703186035,1,1
1333,2,5.485222632035579,5.48522263203558,0.994339085858581,0.9943390858585814,0,0,7.201973915100098,7.149956703186035,2,2
1333,3,5.238900922559699,5.238900922559698,0.9985606435708527,0.998560643570853,0,0,7.215806007385254,7.149956703186035,3,3
1333,4,4.93087692737408,4.93087692737408,0.9998560698679979,0.9998560698679961,0,0,7.415812015533447,7.149956703186035,4,4
1333,8,4.329246113615019,4.419635170229255,1.0060030286973456,1.0063149041531685,2,2,8.069650650024414,7.149956703186035,6,6
1333,16,3.5545985906520214,3.77463022296228,1.0156110881609082,1.0169745236416086,6,7,8.402816772460938,7.149956703186035,10,9
1333,32,2.8265746366484716,3.4033589326179614,1.018906863705934,1.0244768261345552,15,19,9.13991641998291,7.149956703186035,17,13
1333,64,2.1676825282142764,3.291528398253029,1.0099729305452354,1.0292786159761387,26,47,9.929122924804688,7.149956703186035,38,17
1333,128,1.3540302575873144,3.2164711497704155,1.0024902509505549,1.0315118727721113,57,109,10.822741508483887,7.149956703186035,71,19
1334,1,8.569881893662568,8.569881893662574,0.9552759180785665,0.9552759180785678,0,0,8.675728797912598,8.675728797912598,1,1
1334,2,7.902131333230015,7.902131333230018,0.9778890524069699,0.9778890524069714,0,0,10.423074722290039,8.675728797912598,2,2
1334,3,6.275489291023293,6.275489291023299,1.0128578933895305,1.0128578933895322,0,0,10.451691627502441,8.675728797912598,3,3
1334,4,5.969468662943081,5.969468662943079,1.0202725320596662,1.0202725320596666,0,0,10.494832038879395,8.675728797912598,4,4
1334,8,5.525487773208496,5.529515717287965,1.0277692552900697,1.0277572485506126,1,2,10.909331321716309,8.675728797912598,7,6
1334,16,5.207462441972712,5.467468705414979,1.0259733002167122,1.028278839235902,7,8,11.356558799743652,8.675728797912598,9,8
1334,32,4.456244645627272,5.279537786006959,1.035024224827446,1.0364122636943736,10,20,11.98686408996582,8.675728797912598,22,12
1334,64,3.5957389227594545,5.205936217455111,1.020421432357178,1.041033769312011,26,50,12.788865089416504,8.675728797912598,38,14
1334,128,2.123827145262175,5.188889996919322,1.0085178262017946,1.0422470900234098,65,113,13.322871208190918,8.675728797912598,63,15
1335,1,9.591962752855478,9.59196275285548,0.9436468761455752,0.9436468761455759,0,0,9.739686965942383,9.739686965942383,1,1
1335,2,7.142145271043863,7.142145271043863,0.9949726948837814,0.9949726948837812,0,0,9.804569244384766,9.739686965942383,2,2
1335,3,7.109798602506411,7.109798602506411,0.9961361455858834,0.9961361455858837,0,0,9.972174644470215,9.739686965942383,3,3
1335,4,6.381481619404347,6.381481619404348,1.0059655043742823,1.0059655043742828,0,0,9.975232124328613,9.739686965942383,4,4
1335,8,6.036199800698539,6.036199800698538,1.0116958007632981,1.011695800763299,0,0,10.37608814239502,9.739686965942383,8,8
1335,16,5.628033215295718,5.644984054481503,1.0235684445936588,1.0232596330083956,3,3,11.01865291595459,9.739686965942383,13,13
1335,32,5.298663573937,5.439040409931456,1.028480286358538,1.0314353583864153,11,11,11.502690315246582,9.739686965942383,21,21
1335,64,4.345132252771906,5.358659173717932,1.0178371784988043,1.035298785036391,33,44,12.331023216247559,9.739686965942383,31,20
1335,128,2.890581783229444,5.314640380698211,1.006523919658477,1.039480716882373,66,102,13.169407844543457,9.739686965942383,62,26
1336,1,8.831708007101213,8.831708007101216,0.9509281435717571,0.9509281435717591,0,0,8.954180717468262,8.954180717468262,1,1
1336,2,6.9095579896208035,6.909557989620804,0.9870618102064169,0.9870618102064181,0,0,8.993102073669434,8.954180717468262,2,2
1336,3,6.077130396378976,6.077130396378975,1.0038611355829063,1.0038611355829077,0,0,9.3485689163208,8.954180717468262,3,3
1336,4,5.716782857186809,5.716782857186808,1.0111922864743526,1.0111922864743548,0,0,9.472146034240723,8.954180717468262,4,4
1336,8,5.406255281775973,5.407204779832819,1.0167533136191216,1.0167493650273312,1,1,9.970643997192383,8.954180717468262,7,7
1336,16,5.094953679563219,5.249848502238021,1.021458385916382,1.0219348472038898,3,5,10.5143461227417,8.954180717468262,13,11
1336,32,4.427263885529691,5.158564917970992,1.0264173214358727,1.025671442474425,13,18,11.519096374511719,8.954180717468262,19,14
1336,64,2.9482938409282817,5.103944285453623,1.0085965531554504,1.0296771526562143,27,45,12.217368125915527,8.954180717468262,37,19
1336,128,1.9307093757668112,5.001602426400272,1.0049537542673845,1.0334288410206904,61,108,13.021522521972656,8.954180717468262,67,20
1337,1,11.12018130104261,11.120181301042615,0.930655397733554,0.9306553977335565,0,0,11.315595626831055,11.315595626831055,1,1
1337,2,8.358047711758184,8.358047711758182,1.0013597558416596,1.0013597558416618,0,0,11.841282844543457,11.315595626831055,2,2
1337,3,8.228472407102794,8.228472407102792,1.006124626930696,1.0061246269306983,0,0,12.919779777526855,11.315595626831055,3,3
1337,4,8.16966773093417,8.169667730934169,1.00860449595543,1.0086044959554326,0,0,12.973834037780762,11.315595626831055,4,4
1337,8,7.102318547110483,7.121800077814407,1.0330607201303252,1.033257814377818,3,3,13.56951904296875,11.315595626831055,5,5
1337,16,6.88659183131985,7.022222655641083,1.035736029317098,1.0363443573619076,3,8,14.451064109802246,11.315595626831055,13,8
1337,32,6.0083677531874145,6.693897494832637,1.0431777766394812,1.0533717580327444,12,21,14.963661193847656,11.315595626831055,20,11
1337,64,4.915369547855812,6.663272240145645,1.0286475664925403,1.0560282024226912,33,52,15.55199909210205,11.315595626831055,31,12
1337,128,3.3685995555599977,6.642509256794267,1.0174995070487656,1.0582177917915228,57,113,16.20036506652832,11.315595626831055,71,15
1338,1,3.017796740410419,3.017796740410419,0.9968047175895837,0.9968047175895856,0,0,3.0194225311279297,3.0194225311279297,1,1
1338,2,2.49758077204534,2.4975807720453407,0.9994798278826061,0.9994798278826079,0,0,3.115297555923462,3.0194225311279297,2,2
1338,3,2.2944141528784545,2.2944141528784545,0.9999261434110083,0.9999261434110096,0,0,3.341916084289551,3.0194225311279297,3,3
1338,4,2.283382133038499,2.2833821330385056,1.00021694442169,1.0002169444216922,0,0,3.3703842163085938,3.0194225311279297,4,4
1338,8,1.8198753641772472,2.0112547428054266,1.0013224727393446,1.0018063371872372,2,4,3.6170008182525635,3.0194225311279297,6,4
1338,16,1.7167220884826373,2.011234223214934,1.0008093087830605,1.001808414923549,6,11,3.8115193843841553,3.0194225311279297,10,5
1338,32,1.2608846342100377,1.916464072217812,1.001370868631812,1.004102845161454,15,23,4.125620365142822,3.0194225311279297,17,9
1338,64,0.46684086300468214,1.9044560736697156,1.0000925880734735,1.0040757625720407,32,52,4.421008586883545,3.0194225311279297,32,12
1338,128,0.03548436143475238,1.8639219884821863,1.0000310217413892,1.0047688299286683,66,114,4.885350704193115,3.0194225311279297,62,14
1339,1,8.478802708533635,8.478802708533642,0.9574432765311819,0.9574432765311849,0,0,8.574369430541992,8.574369430541992,1,1
1339,2,7.427942922040957,7.427942922040958,0.9822390296605111,0.982239029660513,0,0,9.036368370056152,8.574369430541992,2,2
1339,3,7.161364873342997,7.161364873342996,0.9923486527193733,0.992348652719375,0,0,9.884357452392578,8.574369430541992,3,3
1339,4,6.997484752109646,6.997484752109645,0.9994293175451113,0.9994293175451123,0,0,10.473782539367676,8.574369430541992,4,4
1339,8,6.181445373255594,6.181581899781028,1.0166399126433379,1.0167112385293264,1,1,11.575614929199219,8.574369430541992,7,7
1339,16,5.229323119935635,5.836546119957431,1.0206594354545862,1.0282161261733374,5,7,12.23424243927002,8.574369430541992,11,9
1339,32,4.420960134637886,5.591831266750633,1.0241273495003425,1.035565488525366,11,22,12.758265495300293,8.574369430541992,21,10
1339,64,3.647210472318173,5.500527258033845,1.020618892095471,1.040303189181435,29,48,13.378107070922852,8.574369430541992,35,16
1339,128,2.1574825454040187,5.447563908191861,1.013209590792649,1.0446130390764263,68,111,14.081425666809082,8.574369430541992,60,17
1340,1,9.937661345369195,9.937661345369204,0.9394819819149391,0.939481981914942,0,0,10.101988792419434,10.101988792419434,1,1
1340,2,8.697895830457092,8.697895830457094,0.9681799773690749,0.968179977369076,0,0,10.32162857055664,10.101988792419434,2,2
1340,3,8.04792523820471,8.047925238204702,0.981620947792275,0.9816209477922772,0,0,10.363000869750977,10.101988792419434,3,3
1340,4,7.746036950971104,7.746036950971106,0.9898799449139635,0.9898799449139647,0,0,10.62185287475586,10.101988792419434,4,4
1340,8,6.992086644527118,6.9934873310635846,1.0079889843774965,1.0078586410268082,1,1,11.14315128326416,10.101988792419434,7,7
1340,16,6.4174123327537185,6.683091454164794,1.0180464622532128,1.0168159495485787,3,5,11.677772521972656,10.101988792419434,13,11
1340,32,5.569354266015315,6.218111085573297,1.0306832809641864,1.0317303442311625,12,18,12.390417098999023,10.101988792419434,20,14
1340,64,3.9940809327688,6.200432936546687,1.0179679613503145,1.033652740228083,28,48,13.172401428222656,10.101988792419434,36,16
1340,128,2.4287867987142424,6.151213693198673,1.003104926248771,1.0386465598361347,69,109,13.902046203613281,10.101988792419434,59,19
1341,1,11.28175782999581,11.281757829995813,0.9204060948952343,0.9204060948952356,0,0,11.534680366516113,11.534680366516113,1,1
1341,2,8.981060207490474,8.981060207490474,0.9836309504175966,0.9836309504175967,0,0,11.58591079711914,11.534680366516113,2,2
1341,3,8.547154652220284,8.547154652220284,0.993232007495011,0.9932320074950107,0,0,11.615964889526367,11.534680366516113,3,3
1341,4,7.2477190563677265,7.247719056367726,1.01831416058369,1.0183141605836905,0,0,11.685824394226074,11.534680366516113,4,4
1341,8,6.451818421756329,6.461108442759622,1.0334403835064894,1.033100910377065,1,1,12.034934997558594,11.534680366516113,7,7
1341,16,6.154867861888206,6.400032411971135,1.0362808217261532,1.0356414025200722,5,6,12.598909378051758,11.534680366516113,11,10
1341,32,5.524378480555396,6.209014799792345,1.0417076185343008,1.0431289170999751,13,16,13.107341766357422,11.534680366516113,19,16
1341,64,4.210772202921922,6.076386218263113,1.03242068071319,1.0500082457493516,30,43,13.829971313476562,11.534680366516113,34,21
1341,128,2.738089984394739,5.994536863799156,1.0133483466009687,1.0541204513572073,61,107,14.459702491760254,11.534680366516113,67,21
1342,1,7.765597242928004,7.765597242928004,0.9655913650387772,0.9655913650387774,0,0,7.834208011627197,7.834208011627197,1,1
1342,2,5.811876751010142,5.811876751010141,0.9992976330224694,0.9992976330224693,0,0,8.387487411499023,7.834208011627197,2,2
1342,3,5.6980547258423915,5.6980547258423915,1.000254017503048,1.0002540175030488,0,0,8.89791202545166,7.834208011627197,3,3
1342,4,5.685512318706661,5.685512318706661,1.0006692634161574,1.0006692634161574,0,0,8.976800918579102,7.834208011627197,4,4
1342,8,5.438868759464916,5.450247398642206,1.006700632896786,1.0065161476133282,1,1,9.478673934936523,7.834208011627197,7,7
1342,16,4.523155651216089,5.0117474540940625,1.0169469385761627,1.0184709876427456,2,5,9.794516563415527,7.834208011627197,14,11
1342,32,3.987021105684685,4.894464803496713,1.0195462781974527,1.0210444095098374,11,20,10.315445899963379,7.834208011627197,21,12
1342,64,2.7109217325788153,4.887659387012852,1.009165161870599,1.0215220502976083,29,50,10.927361488342285,7.834208011627197,35,14
1342,128,1.622341161655466,4.819607130183473,1.0009133840199622,1.0244817024178436,59,114,11.81765079498291,7.834208011627197,69,14
1343,1,6.3515090891554085,6.3515090891554085,0.9773666411263982,0.9773666411263982,0,0,6.388325214385986,6.388325214385986,1,1
1343,2,5.778503947648536,5.778503947648536,0.9866720806102974,0.9866720806102967,0,0,6.867597579956055,6.388325214385986,2,2
1343,3,5.53745313044395,5.537453130443949,0.9917433079944011,0.9917433079944007,0,0,6.9572649002075195,6.388325214385986,3,3
1343,4,5.458859973902332,5.458859973902332,0.9940001843418378,0.9940001843418368,0,0,7.125637054443359,6.388325214385986,4,4
1343,8,4.105094932988595,4.114132027307827,1.0094768965744767,1.0098453234643425,2,2,7.535250186920166,6.388325214385986,6,6
1343,16,3.5148447268338234,3.706454007776471,1.0143988788429767,1.0162834698153924,5,6,8.398045539855957,6.388325214385986,11,10
1343,32,2.7453258873658744,3.6597537013118657,1.0064349111726583,1.0170720192508855,13,19,8.679069519042969,6.388325214385986,19,13
1343,64,1.851195547215113,3.63274781482814,1.0051924476096508,1.0188442436931209,27,48,9.273933410644531,6.388325214385986,37,16
1343,128,0.9598232834123621,3.580666976217789,0.999889426253354,1.0208790754337005,63,114,9.98366641998291,6.388325214385986,65,14
1344,1,7.997687549167277,7.997687549167277,0.9617703178931558,0.9617703178931565,0,0,8.081336975097656,8.081336975097656,1,1
1344,2,7.40445421311039,7.404454213110391,0.9727780477376207,0.9727780477376209,0,0,8.417570114135742,8.081336975097656,2,2
1344,3,6.855370943275844,6.855370943275847,0.9839016079885696,0.9839016079885682,0,0,8.945856094360352,8.081336975097656,3,3
1344,4,6.798319066704275,6.798319066704275,0.9857170692835335,0.9857170692835331,0,0,9.045697212219238,8.081336975097656,4,4
1344,8,5.519992172360824,5.6584570982209526,1.0074331604246756,1.0052306409545602,1,2,9.686115264892578,8.081336975097656,7,6
1344,16,4.952154589133458,5.578990279569047,1.008861974310341,1.008800220963519,6,8,10.174713134765625,8.081336975097656,10,8
1344,32,4.395974970983525,5.444548929903375,1.0070864246678504,1.0137390486823248,15,22,10.74442195892334,8.081336975097656,17,10
1344,64,3.545913946292184,5.36659068535609,1.0012792976475902,1.019233737384083,32,53,11.317331314086914,8.081336975097656,32,11
1344,128,1.5486788608449036,5.211445734748417,0.9994728691329158,1.0235077236459074,67,114,11.904340744018555,8.081336975097656,61,14
1345,1,8.426040026118242,8.426040026118244,0.9577009848662273,0.9577009848662283,0,0,8.524023056030273,8.524023056030273,1,1
1345,2,7.466327515542169,7.46632751554217,0.9813082773581292,0.9813082773581298,0,0,9.62786865234375,8.524023056030273,2,2
1345,3,6.345513443241062,6.345513443241061,1.0063199018307842,1.006319901830784,0,0,9.883356094360352,8.524023056030273,3,3
1345,4,6.3123197125439106,6.345513443241061,1.005406323820936,1.006319901830784,1,1,10.010893821716309,8.524023056030273,3,3
1345,8,5.961041083126015,6.021586287880792,1.0115536563913732,1.0124551970782107,2,2,10.58870792388916,8.524023056030273,6,6
1345,16,5.339508998854454,5.537582153120673,1.0201217776234348,1.0208850236854083,7,7,11.192207336425781,8.524023056030273,9,9
1345,32,4.532029079420439,5.4642459455971775,1.0141012844975155,1.0250131879308608,14,22,12.427781105041504,8.524023056030273,18,10
1345,64,3.2709077262391033,5.446806383367609,1.0124720178348596,1.0273703772006972,30,52,13.450051307678223,8.524023056030273,34,12
1345,128,1.8281525383057893,5.440797552568054,1.001307510178786,1.0290332469640908,62,114,14.78916072845459,8.524023056030273,66,14
1346,1,5.891483323181314,5.8914833231813155,0.9885992940555375,0.9885992940555391,0,0,5.9015398025512695,5.9015398025512695,1,1
1346,2,5.170620460362136,5.170620460362136,0.9985713940004071,0.9985713940004083,0,0,6.151832580566406,5.9015398025512695,2,2
1346,3,4.566462259244396,4.566462259244395,1.002525952791126,1.0025259527911268,0,0,6.179379940032959,5.9015398025512695,3,3
1346,4,4.490378938143275,4.490378938143274,1.0034005953402723,1.0034005953402731,0,0,6.979711055755615,5.9015398025512695,4,4
1346,8,3.959873225917812,4.132727322136144,1.0084135170964386,1.0091096267874848,1,1,7.3507914543151855,5.9015398025512695,7,7
1346,16,3.7001439715762423,3.8725841400319103,1.0124613019352628,1.012251447953227,5,8,7.621167182922363,5.9015398025512695,11,8
1346,32,3.0273494818084967,3.6390906221335086,1.014290816187676,1.0160723131698233,14,21,8.304388046264648,5.9015398025512695,18,11
1346,64,2.131957153983217,3.5185355259806315,1.007171279612715,1.0179975407400286,32,52,8.879918098449707,5.9015398025512695,32,12
1346,128,0.8804563486529383,3.403846767836482,1.0014282103289256,1.0205352206573592,63,115,9.632194519042969,5.9015398025512695,65,13
1347,1,6.983286435031679,6.983286435031675,0.9699174885522053,0.9699174885522075,0,0,7.0431365966796875,7.0431365966796875,1,1
1347,2,6.062056061472613,6.062056061472615,0.9883799164716154,0.9883799164716172,0,0,7.916200637817383,7.0431365966796875,2,2
1347,3,5.427950394442849,5.42795039444285,0.99873924917202,0.9987392491720226,0,0,8.236004829406738,7.0431365966796875,3,3
1347,4,5.4047734246335635,5.4047734246335635,0.9994523402652017,0.9994523402652038,0,0,8.424445152282715,7.0431365966796875,4,4
1347,8,4.791060945279393,4.916176871396173,1.008004917660485,1.008014807896846,3,3,9.331850051879883,7.0431365966796875,5,5
1347,16,4.104321174757929,4.656711599417372,1.013272557200213,1.0149945365222515,5,8,9.6629638671875,7.0431365966796875,11,8
1347,32,3.523127492971545,4.529852242161084,1.0116667452845143,1.0194699077326113,15,22,10.160439491271973,7.0431365966796875,17,10
1347,64,2.6392205781251215,4.377818236090615,1.0060950333505532,1.0228345459015182,28,51,10.714988708496094,7.0431365966796875,36,13
1347,128,1.4642285943828106,4.353359173104739,1.0007941672117449,1.0240692429313782,67,114,11.36500072479248,7.0431365966796875,61,14
1348,1,12.484368492895536,12.484368492895543,0.9174872144154679,0.9174872144154722,0,0,12.719539642333984,12.719539642333984,1,1
1348,2,10.317895276844778,10.31789527684478,0.9744802170784478,0.9744802170784501,0,0,12.77597713470459,12.719539642333984,2,2
1348,3,9.869693614801827,9.869693614801827,0.9872781203862535,0.9872781203862544,0,0,13.926351547241211,12.719539642333984,3,3
1348,4,9.838312409807719,9.83831240980772,0.9887679251571578,0.9887679251571592,0,0,14.102314949035645,12.719539642333984,4,4
1348,8,9.393063047979448,9.445062109955463,0.9994256393181653,1.0009884275947092,1,3,14.933626174926758,12.719539642333984,7,5
1348,16,8.605078521929476,9.2968964361448,1.0148567720997592,1.0116912735021868,6,8,15.63774585723877,12.719539642333984,10,8
1348,32,6.954845932428844,9.127816480843869,1.0313998579167856,1.0233021696877505,13,23,16.231563568115234,12.719539642333984,19,9
1348,64,5.590393013121589,8.347074795834796,1.025172202822475,1.0555402608906252,30,54,17.083179473876953,12.719539642333984,34,10
1348,128,3.350936087383602,8.205168428372396,1.0114601548094075,1.0644324927961708,63,114,17.721654891967773,12.719539642333984,65,14
1349,1,9.03271648366685,9.032716483666853,0.9535753130343179,0.9535753130343204,0,0,9.139331817626953,9.139331817626953,1,1
1349,2,6.512583091323367,6.512583091323367,1.0027328575382972,1.002732857538299,0,0,9.140518188476562,9.139331817626953,2,2
1349,3,6.260594907878419,6.260594907878419,1.007573923744024,1.007573923744025,0,0,9.318887710571289,9.139331817626953,3,3
1349,4,6.067988388808799,6.0679883888088,1.010603014865061,1.0106030148650618,0,0,9.36539077758789,9.139331817626953,4,4
1349,8,5.638952801908587,5.6505014713246995,1.017421123811076,1.017255059765213,1,1,10.050843238830566,9.139331817626953,7,7
1349,16,5.313624125431735,5.501907226047172,1.0222554154727888,1.0209485703007803,4,4,10.689836502075195,9.139331817626953,12,12
1349,32,4.34748097251233,5.3139370473690155,1.0213444792271364,1.0253400516050168,13,16,11.569687843322754,9.139331817626953,19,16
1349,64,3.349039579776375,5.162217677867071,1.014739131859094,1.030387993845232,31,47,12.281834602355957,9.139331817626953,33,17
1349,128,2.175210924139425,5.140802108076251,1.0081020811781534,1.0330283165599843,56,108,12.697528839111328,9.139331817626953,72,20
1350,1,2.6721519543792374,2.6721519543792347,0.9962472263905668,0.9962472263905675,0,0,2.6746675968170166,2.6746675968170166,1,1
1350,2,2.0362560251767086,2.0362560251767086,0.9997041241082794,0.9997041241082791,0,0,2.793957471847534,2.6746675968170166,2,2
1350,3,2.034556940188095,2.034556940188095,0.999688262198487,0.9996882621984882,0,0,2.804555654525757,2.6746675968170166,3,3
1350,4,1.9812686681905858,1.9823311865367423,0.9996289931967309,0.9996198173972733,1,1,2.8522019386291504,2.6746675968170166,3,3
1350,8,1.7989519727131622,1.832107403109338,1.0001603690366185,0.9997548706449862,2,2,2.991056442260742,2.6746675968170166,6,6
1350,16,1.5687270208241224,1.675672605213931,1.0007609022906105,1.0008427773643058,3,4,3.2836859226226807,2.6746675968170166,13,12
1350,32,1.1266572537390245,1.5254954713570534,1.0006567165413103,1.0014218778500616,15,17,3.4989514350891113,2.6746675968170166,17,15
1350,64,0.4037868505474593,1.3132420326312715,0.9997177977100842,1.0022608027951612,30,51,3.79783034324646,2.6746675968170166,34,13
1350,128,0.028159924196331808,1.2769263759437581,1.000001264539073,1.0030944472925796,71,115,4.278244495391846,2.6746675968170166,57,13
1351,1,3.6563779338833102,3.656377933883311,0.9951833845742418,0.9951833845742427,0,0,3.6593995094299316,3.6593995094299316,1,1
1351,2,3.145371780295802,3.145371780295799,0.9992258958065734,0.9992258958065746,0,0,3.817974328994751,3.6593995094299316,2,2
1351,3,2.9654662217663947,2.9654662217663947,1.000662994411739,1.0006629944117398,0,0,3.822275161743164,3.6593995094299316,3,3
1351,4,2.8035944799386354,2.8035944799386354,1.0016916885257823,1.0016916885257825,0,0,4.037761688232422,3.6593995094299316,4,4
1351,8,2.7118959464477674,2.7227322366378575,1.0022149637510676,1.0024844163297073,1,1,4.5660786628723145,3.6593995094299316,7,7
1351,16,2.1372975312632105,2.1642903533306295,1.0081454078034966,1.0087857954460488,3,3,4.937424182891846,3.6593995094299316,13,13
1351,32,1.5268886775006658,2.15422659879486,1.0038894986293325,1.009157186670938,14,19,5.4115118980407715,3.6593995094299316,18,13
1351,64,0.8296641278452574,2.135889838426878,1.0010862146720505,1.0100288389622385,32,48,6.062127590179443,3.6593995094299316,32,16
1351,128,0.18258998434582577,2.116175075916257,0.9999498470650101,1.0103764269701645,68,109,6.577081680297852,3.6593995094299316,60,19
1352,1,13.132795813044755,13.13279581304472,0.9001303257882542,0.9001303257882584,0,0,13.451949119567871,13.451949119567871,1,1
1352,2,10.39581362083479,10.39581362083479,0.9747548561964567,0.9747548561964586,0,0,13.518539428710938,13.451949119567871,2,2
1352,3,10.32590811945783,10.325908119457832,0.9772822898559412,0.9772822898559437,0,0,14.552125930786133,13.451949119567871,3,3
1352,4,10.1499586477933,10.149958647793301,0.9882100928341317,0.9882100928341332,0,0,15.3731689453125,13.451949119567871,4,4
1352,8,9.409327367070446,9.41212663672601,1.020165478666141,1.0204928680000473,1,1,16.45195198059082,13.451949119567871,7,7
1352,16,8.9508287924375,9.266276528530682,1.0275460547774489,1.0300582444493835,5,7,17.0394287109375,13.451949119567871,11,9
1352,32,7.929320806447526,8.754880784914372,1.0369842879131128,1.0514882058131865,14,22,17.904760360717773,13.451949119567871,18,10
1352,64,6.072374138592352,8.70462494320263,1.04351633368882,1.0576261587606774,30,49,18.631853103637695,13.451949119567871,34,15
1352,128,4.225078599462741,8.680177064101379,1.019502105285878,1.0631509029149164,61,113,19.330463409423828,13.451949119567871,67,15
1353,1,6.163526371741832,6.163526371741832,0.9793619486894284,0.9793619486894308,0,0,6.194414138793945,6.194414138793945,1,1
1353,2,5.141153026422605,5.141153026422605,0.9967178394349014,0.9967178394349034,0,0,7.593728065490723,6.194414138793945,2,2
1353,3,4.862315226799605,4.862315226799604,1.0014369857563568,1.0014369857563583,0,0,7.817126750946045,6.194414138793945,3,3
1353,4,4.411690769418227,4.411690769418225,1.007457398453678,1.00745739845368,0,0,7.897658824920654,6.194414138793945,4,4
1353,8,4.196149546236148,4.2056099649928145,1.0110054204338867,1.0118222126836176,1,1,8.791543006896973,6.194414138793945,7,7
1353,16,3.833053113486748,4.142329119710518,1.0095486868444454,1.0151975746960933,6,6,9.591333389282227,6.194414138793945,10,10
1353,32,3.2617271083554864,4.064272234166948,1.009358186372266,1.0180538940624206,12,20,10.056486129760742,6.194414138793945,20,12
1353,64,2.661788477614545,4.019748934689931,1.0052111226841665,1.019715801954102,34,51,10.57349967956543,6.194414138793945,30,13
1353,128,1.257658673317663,4.014019670216849,1.0004375023682228,1.0209709523694706,58,111,11.479682922363281,6.194414138793945,70,17
1354,1,12.82438452496642,12.824384524966424,0.9031729075078635,0.9031729075078647,0,0,13.145506858825684,13.145506858825684,1,1
1354,2,11.363498377825659,11.36349837782566,0.9447765787721379,0.9447765787721386,0,0,13.186238288879395,13.145506858825684,2,2
1354,3,9.64536579817674,9.64536579817674,0.9873397002698432,0.9873397002698427,0,0,13.230207443237305,13.145506858825684,3,3
1354,4,9.535260891495602,9.5352608914956,0.9913959083085238,0.9913959083085223,0,0,13.614559173583984,13.145506858825684,4,4
1354,8,7.964841133766448,8.289146478779362,1.0329491291394801,1.0272747404152014,2,2,14.032602310180664,13.145506858825684,6,6
1354,16,7.695755514947017,8.162576295283218,1.0383873487292017,1.0309838553179038,5,8,14.318582534790039,13.145506858825684,11,8
1354,32,7.015385356019525,7.89570950400722,1.0471747501987838,1.040670583047267,12,20,14.854188919067383,13.145506858825684,20,12
1354,64,5.541797525439143,7.744818345403643,1.0361896972796678,1.0449572708565928,33,51,15.22868537902832,13.145506858825684,31,13
1354,128,3.6392054596439007,7.607375293370897,1.0204964463159325,1.0545786129454398,64,109,15.670024871826172,13.145506858825684,64,19
1355,1,7.241601829411937,7.241601829411937,0.9708181691451226,0.9708181691451228,0,0,7.2960686683654785,7.2960686683654785,1,1
1355,2,7.20319738656858,7.20319738656858,0.9730635404470163,0.9730635404470164,0,0,8.612276077270508,7.2960686683654785,2,2
1355,3,6.014528968548716,6.031800742083048,0.9911592750973406,0.9918596021110136,1,1,8.806901931762695,7.2960686683654785,2,2
1355,4,5.284680853398383,5.617972565687361,1.0022630403784405,1.0008476357660567,1,1,8.810846328735352,7.2960686683654785,3,3
1355,8,4.742018894075987,5.0671503183329385,1.0100517839236691,1.0091703627712176,1,1,8.90785026550293,7.2960686683654785,7,7
1355,16,4.552692698091602,4.936844236205165,1.0149199357725696,1.0135454260124508,5,6,9.156622886657715,7.2960686683654785,11,10
1355,32,4.180855609537116,4.826089671934111,1.0162238013211748,1.0160194595885448,13,20,9.630135536193848,7.2960686683654785,19,12
1355,64,2.963921688168079,4.787898974807757,1.0097097575254654,1.0176419717898946,29,49,10.056396484375,7.2960686683654785,35,15
1355,128,1.7832339853182473,4.6043320535769725,1.0039175892044294,1.0237414880502853,65,111,10.465751647949219,7.2960686683654785,63,17
1356,1,7.988513832571148,7.9885138325711385,0.9626115615398437,0.962611561539847,0,0,8.067992210388184,8.067992210388184,1,1
1356,2,6.9062286049347845,6.906228604934781,0.9779505792082936,0.9779505792082962,0,0,8.641984939575195,8.067992210388184,2,2
1356,3,6.723988696909171,6.723988696909172,0.9827185598393202,0.9827185598393222,0,0,9.87744426727295,8.067992210388184,3,3
1356,4,6.181441036183913,6.181441036183914,0.9972635935061211,0.9972635935061234,0,0,9.999835014343262,8.067992210388184,4,4
1356,8,5.6127976002694835,5.705462402944544,1.0057939345542106,1.0087252068173402,2,2,10.567161560058594,8.067992210388184,6,6
1356,16,5.139757690698558,5.31197410663678,1.0188362416206238,1.021148926076143,6,6,10.969818115234375,8.067992210388184,10,10
1356,32,4.584713148531236,5.194728275441628,1.0267950935591668,1.0262012529277644,12,17,11.247751235961914,8.067992210388184,20,15
1356,64,3.7537740330965366,4.964729225916037,1.022143409337921,1.0308683247966584,29,47,11.869596481323242,8.067992210388184,35,17
1356,128,2.21346732679789,4.937812630382602,1.0070794321111507,1.0330674723387494,58,108,12.271958351135254,8.067992210388184,70,20
1357,1,7.042302500991714,7.042302500991713,0.9703068785558502,0.9703068785558498,0,0,7.098649501800537,7.098649501800537,1,1
1357,2,6.040270052688384,6.040270052688384,0.983579990862028,0.9835799908620274,0,0,7.207998752593994,7.098649501800537,2,2
1357,3,5.735999390950729,5.735999390950729,0.9879295631407374,0.9879295631407368,0,0,7.516936302185059,7.098649501800537,3,3
1357,4,5.632679766918332,5.632679766918332,0.9912173010730656,0.9912173010730652,0,0,7.961684226989746,7.098649501800537,4,4
1357,8,5.252048983268309,5.272860828419718,0.9987371565870382,0.9996842842733549,1,1,8.958856582641602,7.098649501800537,7,7
1357,16,4.850653172093021,5.228364925723769,1.0019203510196852,1.002130977890281,4,8,9.438212394714355,7.098649501800537,12,8
1357,32,4.061357265311155,4.881289465742249,1.0081919961277344,1.0103089910229037,15,21,10.285909652709961,7.098649501800537,17,11
1357,64,2.476104167317091,4.717802181648555,1.0072666465197562,1.0177879040712716,28,49,11.03670597076416,7.098649501800537,36,15
1357,128,1.597540582096398,4.528454891809295,1.002854173410317,1.022757249601281,66,113,11.69966983795166,7.098649501800537,62,15
1358,1,2.875319730864603,2.8753197308646037,0.9964596088769543,0.9964596088769554,0,0,2.877429723739624,2.877429723739624,1,1
1358,2,2.5431802586343717,2.543180258634372,0.9995040365832277,0.9995040365832284,0,0,3.0516276359558105,2.877429723739624,2,2
1358,3,2.421279950740799,2.4212799507407987,1.0007150855909357,1.0007150855909364,0,0,3.471801519393921,2.877429723739624,3,3
1358,4,2.415151686855945,2.4212799507407987,1.0004656516494899,1.0007150855909364,1,1,3.5327491760253906,2.877429723739624,3,3
1358,8,2.058577393193138,2.2346673705880433,1.002769989526508,1.0025581395524306,2,3,3.572152853012085,2.877429723739624,6,5
1358,16,1.872018205795901,2.222077048300432,1.0028775237168652,1.0025919212818755,6,8,3.858823537826538,2.877429723739624,10,8
1358,32,1.2386792069814077,2.0759555537868293,1.0018184443388358,1.0039772010764747,14,22,4.242371082305908,2.877429723739624,18,10
1358,64,0.5641047107259691,2.0759551935550964,1.0003476476820397,1.003977563451119,34,54,4.587941646575928,2.877429723739624,30,10
1358,128,0.035588691029305584,2.050057781450067,1.0000021173144393,1.0045451783219514,56,119,5.062732219696045,2.877429723739624,72,9
1359,1,3.788214626852338,3.788214626852338,0.9905424244082612,0.9905424244082622,0,0,3.799313545227051,3.799313545227051,1,1
1359,2,2.7052015994346412,2.7052015994346412,0.99957545818149,0.9995754581814906,0,0,4.054173946380615,3.799313545227051,2,2
1359,3,2.4092331041107355,2.409233104110735,1.0033033148530437,1.0033033148530444,0,0,4.8868231773376465,3.799313545227051,3,3
1359,4,2.189125074009702,2.1891250740097017,1.0053572968766682,1.0053572968766684,0,0,5.251869201660156,3.799313545227051,4,4
1359,8,2.146779431052784,2.1589311561549254,1.005600719029433,1.0060980235747274,2,2,6.257984638214111,3.799313545227051,6,6
1359,16,1.975050565876491,2.149190980160708,1.003968796188325,1.006795841825465,6,7,6.580200672149658,3.799313545227051,10,9
1359,32,1.4845993916985452,2.1019809384693535,1.0015077767066458,1.0077330035048486,14,22,7.1362504959106445,3.799313545227051,18,10
1359,64,1.0602317345035515,2.097942745699627,1.0009355171195922,1.0081863916450617,30,54,7.906850337982178,3.799313545227051,34,10
1359,128,0.42426346232296913,2.097496153007176,0.9996926395229078,1.008339946777875,58,117,8.571721076965332,3.799313545227051,70,11
1360,1,2.7797917487654886,2.7797917487654886,0.9959192641034929,0.9959192641034931,0,0,2.7826693058013916,2.7826693058013916,1,1
1360,2,2.5902273390134796,2.59022733901348,0.9971315964738854,0.9971315964738857,0,0,3.0974838733673096,2.7826693058013916,2,2
1360,3,2.5665552604291224,2.5665552604291233,0.9977129644331186,0.9977129644331189,0,0,3.100264549255371,2.7826693058013916,3,3
1360,4,2.4878320648502243,2.4878320648502177,0.9972235729544677,0.9972235729544681,0,0,3.120586395263672,2.7826693058013916,4,4
1360,8,2.184229191671289,2.21083926830869,0.9991506992771878,0.9994637505276904,2,3,3.261845111846924,2.7826693058013916,6,5
1360,16,1.8441570128422757,1.9982808591905532,1.00241515750088,1.0014589964575185,4,9,3.4948551654815674,2.7826693058013916,12,7
1360,32,1.1904296139065447,1.893833862724312,1.000698047585555,1.0018280550266245,16,23,3.7815113067626953,2.7826693058013916,16,9
1360,64,0.4534867411444972,1.6883323445673772,1.0006189323810548,1.0037823206556504,31,54,4.260567665100098,2.7826693058013916,33,10
1360,128,0.02176108617000854,1.6199159508958787,1.0000068061744976,1.0044427618408815,63,118,4.795004844665527,2.7826693058013916,65,10
1361,1,4.3721519612027295,4.372151961202713,0.9890913190464846,0.9890913190464852,0,0,4.384947776794434,4.384947776794434,1,1
1361,2,4.1402111699660376,4.140211169966038,0.9939057550683053,0.9939057550683059,0,0,5.58790922164917,4.384947776794434,2,2
1361,3,3.508092505144936,3.508092505144936,1.000040398345226,1.0000403983452268,0,0,6.1214141845703125,4.384947776794434,3,3
1361,4,3.11629695691477,3.1829975199125915,1.0060303631701206,1.0057002157428832,1,1,6.1243672370910645,4.384947776794434,3,3
1361,8,3.0239882650145935,3.076482904165014,1.0072018815418862,1.0070906168520115,2,2,6.6762542724609375,4.384947776794434,6,6
1361,16,2.7541892988091075,3.0639349627282724,1.006691517354442,1.007906588963388,7,8,6.98775053024292,4.384947776794434,9,8
1361,32,2.1542785211246547,2.786004154297248,1.0058967233336282,1.0105155409968387,14,23,7.668553829193115,4.384947776794434,18,9
1361,64,1.2683926587216623,2.655522024470509,1.0043224706722236,1.0148433613209569,31,53,8.20802116394043,4.384947776794434,33,11
1361,128,0.5154375252890491,2.6411639402657987,1.000531895065858,1.0162069123778636,63,115,9.041927337646484,4.384947776794434,65,13
1362,1,9.185899393508107,9.185899393508086,0.9518681577390511,0.9518681577390538,0,0,9.297195434570312,9.297195434570312,1,1
1362,2,7.7600749835742295,7.76007498357423,0.9839067964603372,0.9839067964603387,0,0,9.750547409057617,9.297195434570312,2,2
1362,3,7.286056600906964,7.286056600906965,0.9936121434178258,0.9936121434178259,0,0,10.216092109680176,9.297195434570312,3,3
1362,4,7.136172761890883,7.136172761890883,0.9977198144729309,0.9977198144729317,0,0,10.362622261047363,9.297195434570312,4,4
1362,8,6.481207614363624,6.5037057084147,1.0154786913025073,1.0162344559695122,1,1,11.76688289642334,9.297195434570312,7,7
1362,16,5.667537806437213,5.84964147504506,1.0307384473081538,1.0311967281505994,6,8,12.561643600463867,9.297195434570312,10,8
1362,32,4.855204709156892,5.781432441784607,1.0238840481578821,1.0340318230807648,16,23,13.586470603942871,9.297195434570312,16,9
1362,64,3.393909115834691,5.6769576804565505,1.0164625793049016,1.0407161642218643,32,52,14.496719360351562,9.297195434570312,32,12
1362,128,2.2244925934742255,5.5902146050362225,1.006394793137495,1.0434773275528229,61,116,15.442683219909668,9.297195434570312,67,12
1363,1,9.597741005951699,9.597741005951695,0.9421654651666478,0.9421654651666483,0,0,9.755534172058105,9.755534172058105,1,1
1363,2,8.386581275686131,8.38658127568613,0.9641662506512805,0.9641662506512798,0,0,10.100953102111816,9.755534172058105,2,2
1363,3,8.180769873267055,8.180769873267055,0.9684226432877769,0.9684226432877763,0,0,10.13316822052002,9.755534172058105,3,3
1363,4,7.114741483162073,7.1147414831620726,0.9935710918923877,0.9935710918923879,0,0,10.14565658569336,9.755534172058105,4,4
1363,8,6.490240446318634,6.536521130141593,1.0046260663256927,1.0048230349523757,1,3,10.415087699890137,9.755534172058105,7,5
1363,16,5.938841136059848,6.147754216482396,1.015295331969763,1.0135332887421522,6,9,10.631552696228027,9.755534172058105,10,7
1363,32,5.003777450889518,5.955430912417499,1.0148864878680164,1.0178786999321146,11,23,11.344432830810547,9.755534172058105,21,9
1363,64,3.565320615092716,5.710596524702229,1.0173734590099643,1.0272181808341692,30,47,11.761977195739746,9.755534172058105,34,17
1363,128,2.007861749004872,5.653503570940317,1.0036557991331283,1.0285549445551818,59,111,12.365174293518066,9.755534172058105,69,17
1364,1,11.841012228513561,11.841012228513556,0.901628606479441,0.9016286064794419,0,0,12.203245162963867,12.203245162963867,1,1
1364,2,10.46248672887557,10.462486728875563,0.9287650776504404,0.928765077650441,0,0,12.379990577697754,12.203245162963867,2,2
1364,3,9.609231704924243,9.609231704924243,0.9575772445980393,0.9575772445980391,0,0,12.4944486618042,12.203245162963867,3,3
1364,4,9.59503459119823,9.59503459119823,0.9574330295107218,0.9574330295107212,0,0,12.558056831359863,12.203245162963867,4,4
1364,8,9.174577479283956,9.178039178304335,0.9731601755431902,0.9726987801801477,2,2,12.670273780822754,12.203245162963867,6,6
1364,16,8.139868255026318,8.224045247789839,1.0041588693518293,1.0018086291078805,7,8,12.966142654418945,12.203245162963867,9,8
1364,32,7.108252681158153,7.496015569885774,1.0229799114478044,1.0244116657858449,14,21,13.349323272705078,12.203245162963867,18,11
1364,64,6.523602473634471,7.3942041615613086,1.0269763791408357,1.0293340608971004,31,46,13.706353187561035,12.203245162963867,33,18
1364,128,4.50039454422179,7.158092888351607,1.024486639448146,1.0378581344089959,59,107,14.06059455871582,12.203245162963867,69,21
1365,1,9.962155459771378,9.962155459771383,0.9431493843654266,0.9431493843654282,0,0,10.10855484008789,10.10855484008789,1,1
1365,2,8.529469114149913,8.529469114149915,0.9780720524031954,0.9780720524031965,0,0,10.812373161315918,10.10855484008789,2,2
1365,3,8.526360247707832,8.526360247707832,0.9784094256557091,0.9784094256557088,0,0,11.254448890686035,10.10855484008789,3,3
1365,4,8.213979043298796,8.213979043298798,0.9880280312722496,0.9880280312722501,0,0,11.354222297668457,10.10855484008789,4,4
1365,8,7.082801598300986,7.151659958024417,1.0196398250883405,1.0191872514060094,2,2,12.45982837677002,10.10855484008789,6,6
1365,16,6.71219184608119,6.814817633199427,1.0337228482332286,1.0337288599388308,5,7,13.022241592407227,10.10855484008789,11,9
1365,32,5.49964393859551,6.669060108972671,1.0377971730504107,1.0419749329159815,12,16,13.948837280273438,10.10855484008789,20,16
1365,64,4.098148383647974,6.509660388903138,1.0224016159687284,1.047314652658728,35,48,14.830955505371094,10.10855484008789,29,16
1365,128,2.411146953260767,6.436545927812162,1.0071316896322082,1.0517100500883305,63,112,15.733853340148926,10.10855484008789,65,16
1366,1,6.240570496352498,6.240570496352498,0.975281134499442,0.975281134499442,0,0,6.285828590393066,6.285828590393066,1,1
1366,2,5.912442071619408,5.912442071619406,0.9807937441742053,0.9807937441742054,0,0,6.852741718292236,6.285828590393066,2,2
1366,3,5.900115775615565,5.912442071619406,0.9806864288003895,0.9807937441742054,1,1,7.732728958129883,6.285828590393066,2,2
1366,4,4.66909688240616,4.913537410065308,0.9970750755421777,0.9952276903169963,1,1,7.75924015045166,6.285828590393066,3,3
1366,8,4.488289190342224,4.692647442914439,1.0022438081087341,1.001670789544968,4,4,8.227517127990723,6.285828590393066,4,4
1366,16,3.9702769850610884,4.565509210051033,1.0057905402787914,1.0056694802296475,6,9,9.566040992736816,6.285828590393066,10,7
1366,32,3.1705083774403375,4.496231485990603,1.0041053030364562,1.0085392667506279,16,23,9.927523612976074,6.285828590393066,16,9
1366,64,2.4349823848606835,4.440662627909876,1.0024864064177645,1.0111980600417672,24,54,10.315254211425781,6.285828590393066,40,10
1366,128,1.4920371435268251,4.438263511869147,1.0003772569787968,1.011659782378667,55,114,10.789593696594238,6.285828590393066,73,14
1367,1,9.065147234042849,9.065147234042852,0.9482427873551237,0.9482427873551275,0,0,9.196517944335938,9.196517944335938,1,1
1367,2,7.278135419849097,7.2781354198490975,0.9863963677011249,0.9863963677011272,0,0,9.360662460327148,9.196517944335938,2,2
1367,3,7.033091855175423,7.0330918551754245,0.9906808905550898,0.9906808905550919,0,0,9.47039794921875,9.196517944335938,3,3
1367,4,6.387449694996354,6.387449694996353,1.0046475564772124,1.0046475564772144,0,0,10.138060569763184,9.196517944335938,4,4
1367,8,6.142963492688595,6.1571907447328105,1.0114788672782251,1.0108588953133586,2,2,10.641319274902344,9.196517944335938,6,6
1367,16,5.342125635872342,5.559396785277159,1.0278955282848434,1.0257020056157722,6,7,10.978741645812988,9.196517944335938,10,9
1367,32,4.650395340704583,5.293188960442467,1.0346134505200533,1.0328774800556118,15,16,11.576189041137695,9.196517944335938,17,16
1367,64,3.7715038788091353,5.124283260447058,1.0260213486775007,1.0395648736525964,25,47,12.262260437011719,9.196517944335938,39,17
1367,128,2.3027970910790856,5.071240447810454,1.0063227563531185,1.0439953488741875,64,110,12.87785816192627,9.196517944335938,64,18
1368,1,3.2654019464222683,3.265401946422269,0.994726799117574,0.9947267991175754,0,0,3.269542932510376,3.269542932510376,1,1
1368,2,2.632297495229763,2.6322974952297638,0.9989477455740707,0.9989477455740716,0,0,3.358109712600708,3.269542932510376,2,2
1368,3,2.350486535186118,2.3504865351861133,0.9977386082479648,0.9977386082479656,0,0,3.457000255584717,3.269542932510376,3,3
1368,4,2.2728850443603497,2.27288504436035,0.9985509830911683,0.9985509830911692,0,0,3.5949811935424805,3.269542932510376,4,4
1368,8,2.06285216306542,2.244713161061626,0.9992411309006064,0.9997219641364665,2,3,3.8814496994018555,3.269542932510376,6,5
1368,16,1.8773058422098023,2.241991078468095,0.9986105346484317,0.9998988884894681,7,9,4.077386856079102,3.269542932510376,9,7
1368,32,1.1308106513074376,2.1203603454411852,0.9994916719431501,1.0021642541167461,16,25,4.6916728019714355,3.269542932510376,16,7
1368,64,0.5364815061381081,1.8881631025582648,1.000048512513732,1.0039324424480323,31,54,5.273715972900391,3.269542932510376,33,10
1368,128,0.02468309692995159,1.874470798096902,0.9999803964545595,1.0046101630291944,65,117,5.882317543029785,3.269542932510376,63,11
1369,1,5.588659561714771,5.588659561714775,0.9796950500136217,0.9796950500136232,0,0,5.622692584991455,5.622692584991455,1,1
1369,2,4.629490562488537,4.629490562488538,0.9932906693320186,0.9932906693320187,0,0,5.865053653717041,5.622692584991455,2,2
1369,3,4.229648648485216,4.229648648485216,0.9992907306984689,0.9992907306984691,0,0,6.20243501663208,5.622692584991455,3,3
1369,4,3.8064867025416214,3.806486702541622,1.004019977701436,1.0040199777014365,0,0,6.537118911743164,5.622692584991455,4,4
1369,8,3.2808319113044084,3.505046447441344,1.0096015618788723,1.0097956407574402,2,3,7.355042457580566,5.622692584991455,6,5
1369,16,3.0241686323486188,3.41212778694017,1.009569930920417,1.0109796182074722,6,8,8.174261093139648,5.622692584991455,10,8
1369,32,2.7336443572342994,3.2922287487834665,1.007288961785235,1.014171138498826,15,24,9.086674690246582,5.622692584991455,17,8
1369,64,1.837906736822618,3.2672442972930624,1.0011417775810367,1.015208911372801,23,54,9.664844512939453,5.622692584991455,41,10
1369,128,1.1094046878809745,3.2612373706618016,0.9997863209795036,1.015976949952738,64,118,10.574250221252441,5.622692584991455,64,10
1370,1,8.373483087251659,8.373483087251655,0.9501610278447573,0.9501610278447596,0,0,8.50834846496582,8.50834846496582,1,1
1370,2,7.381075689583529,7.38107568958353,0.978166496356595,0.9781664963565964,0,0,10.025626182556152,8.50834846496582,2,2
1370,3,7.1054192286001605,7.105419228600162,0.9844242503712497,0.9844242503712499,0,0,10.051226615905762,8.50834846496582,3,3
1370,4,6.953663949538301,6.953663949538303,0.9876656531294283,0.9876656531294294,0,0,10.101705551147461,8.50834846496582,4,4
1370,8,6.4666758586179025,6.672002435297685,0.9980655159337257,0.9976195914687747,1,2,10.523553848266602,8.50834846496582,7,6
1370,16,5.673803111596102,6.074394334344943,1.0144993858225144,1.0164498269180637,5,6,11.030294418334961,8.50834846496582,11,10
1370,32,5.151956264550163,6.062522496310071,1.014227823029482,1.0172536018839218,12,21,11.420143127441406,8.50834846496582,20,11
1370,64,4.243957294524751,5.761991641802913,1.0187006044563898,1.027852700117722,26,49,11.887426376342773,8.50834846496582,38,15
1370,128,2.410666671288017,5.703840507795889,1.010314211164982,1.0305469310513797,60,110,12.518582344055176,8.50834846496582,68,18
1371,1,8.173476943785424,8.173476943785428,0.9596141699344027,0.9596141699344042,0,0,8.259969711303711,8.259969711303711,1,1
1371,2,6.284537984380924,6.284537984380923,0.9912584036707117,0.991258403670713,0,0,8.30224895477295,8.259969711303711,2,2
1371,3,5.572694195933311,5.57269419593331,1.0028086454161262,1.0028086454161274,0,0,8.541300773620605,8.259969711303711,3,3
1371,4,5.486735848154637,5.486735848154636,1.005548787559432,1.005548787559433,0,0,8.568538665771484,8.259969711303711,4,4
1371,8,5.087212182857441,5.1949906910989485,1.011986990334878,1.0110837835768982,2,2,9.106342315673828,8.259969711303711,6,6
1371,16,4.620706421417392,4.937395751636286,1.0142003202646617,1.0163291589401398,6,6,9.97457504272461,8.259969711303711,10,10
1371,32,3.859558781723671,4.578069526476212,1.0201385780885057,1.0266008626633296,16,16,10.753811836242676,8.259969711303711,16,16
1371,64,3.0331649349466794,4.554717868761259,1.0096975578815377,1.0289254478482077,31,46,11.586824417114258,8.259969711303711,33,18
1371,128,1.8132568436739591,4.4232483378805085,1.0041935800531718,1.0326282432061287,61,106,12.459360122680664,8.259969711303711,67,22
1372,1,10.744019108537426,10.744019108537431,0.9314793833881563,0.9314793833881586,0,0,10.935508728027344,10.935508728027344,1,1
1372,2,9.919126258377215,9.919126258377215,0.9492054487144637,0.9492054487144654,0,0,11.76880931854248,10.935508728027344,2,2
1372,3,8.425491939235146,8.42549193923515,0.9846168190511712,0.9846168190511734,0,0,11.78177547454834,10.935508728027344,3,3
1372,4,8.37496359549948,8.374963595499478,0.986177816194959,0.9861778161949615,0,0,11.95545482635498,10.935508728027344,4,4
1372,8,7.278798839591537,7.355476478095098,1.0120101058755813,1.0091190286561715,1,1,12.120280265808105,10.935508728027344,7,7
1372,16,6.389313679941786,6.45882783833471,1.0339397963640595,1.0318102370057614,6,7,12.49229907989502,10.935508728027344,10,9
1372,32,5.438472914324976,6.175087176811703,1.0393152024044565,1.0403597775902558,14,18,12.94751262664795,10.935508728027344,18,14
1372,64,4.326980538611591,6.023412626063302,1.0304628804214706,1.0462425265302662,31,47,13.459176063537598,10.935508728027344,33,17
1372,128,3.0712466633634703,6.004497922970368,1.0214081079458692,1.0478781846144054,65,110,13.884394645690918,10.935508728027344,63,18
1373,1,6.8944242933038336,6.894424293303837,0.9682895036476372,0.9682895036476388,0,0,6.960164546966553,6.960164546966553,1,1
1373,2,5.357547758109607,5.357547758109608,0.9943995679980058,0.9943995679980067,0,0,7.2956109046936035,6.960164546966553,2,2
1373,3,5.051935655181766,5.051935655181767,0.9973534634482173,0.9973534634482177,0,0,7.471661567687988,6.960164546966553,3,3
1373,4,5.0490060282624825,5.051935655181767,0.9972792436901576,0.9973534634482177,1,1,7.596278190612793,6.960164546966553,3,3
1373,8,4.713124318787577,4.798815069581179,1.0031524146414035,1.002987347536596,2,2,7.990686893463135,6.960164546966553,6,6
1373,16,4.048230429304663,4.1899736269434005,1.0120765326699335,1.013034221522938,6,6,8.279887199401855,6.960164546966553,10,10
1373,32,3.47319391846227,3.9852728261387127,1.0147670566040317,1.018504143749308,14,20,8.854631423950195,6.960164546966553,18,12
1373,64,2.6911984752569102,3.982109567631537,1.006494878007843,1.0189330187311834,31,50,9.7138671875,6.960164546966553,33,14
1373,128,1.4532806757358376,3.9208943243610515,1.0029142282157166,1.0235161009061153,57,109,10.464620590209961,6.960164546966553,71,19
1374,1,9.65469596840204,9.654695968402041,0.9373097476283648,0.9373097476283676,0,0,9.830228805541992,9.830228805541992,1,1
1374,2,7.5494103052597525,7.549410305259755,0.9882198852917232,0.9882198852917254,0,0,10.125885009765625,9.830228805541992,2,2
1374,3,6.994943074456403,6.994943074456402,0.9996019067490058,0.9996019067490074,0,0,10.572360038757324,9.830228805541992,3,3
1374,4,6.805250829230753,6.8052508292307525,1.0049293512835025,1.0049293512835042,0,0,11.017359733581543,9.830228805541992,4,4
1374,8,6.649630464615594,6.703201460917883,1.010442773749986,1.0136981346785372,1,1,12.730822563171387,9.830228805541992,7,7
1374,16,6.385626918442839,6.577615056110261,1.0126403716005432,1.020463825507203,7,6,13.23078441619873,9.830228805541992,9,10
1374,32,5.226543901562974,6.27413094387149,1.0284041882676598,1.034581152642395,15,19,13.820988655090332,9.830228805541992,17,13
1374,64,3.752591441792427,6.258465826187353,1.012597674184383,1.0351450042950454,31,49,14.685959815979004,9.830228805541992,33,15
1374,128,2.222500840828478,6.202987700806312,1.002816956486331,1.0394395008335666,66,109,15.378809928894043,9.830228805541992,62,19
1375,1,6.05491429967334,6.054914299673321,0.9729742882054885,0.9729742882054898,0,0,6.1084675788879395,6.1084675788879395,1,1
1375,2,6.0384204267902435,6.054914299673321,0.9712041712926547,0.9729742882054898,1,1,10.38074779510498,6.1084675788879395,1,1
1375,3,6.037675011405432,6.054914299673321,0.9709916707336864,0.9729742882054898,2,2,10.456188201904297,6.1084675788879395,1,1
1375,4,5.966832775641774,6.049334334843743,0.9716890036343755,0.9740001023111238,2,2,10.948484420776367,6.1084675788879395,2,2
1375,8,5.67373390991541,5.91503003367099,0.9813229898257705,0.9808541924566166,2,5,11.185442924499512,6.1084675788879395,6,3
1375,16,5.432969246305837,5.9050169016104626,0.9814149935702869,0.9824987403756001,7,12,11.931082725524902,6.1084675788879395,9,4
1375,32,4.443246711953694,5.676082798528234,1.0036552512839787,0.9965219041947546,15,25,12.67664909362793,6.1084675788879395,17,7
1375,64,3.2310112655894563,5.2681254291587685,1.0061224530083195,1.0081904379609514,33,56,13.312849998474121,6.1084675788879395,31,8
1375,128,2.270432282581085,5.174763875483356,1.0038138578392568,1.0152511423486095,60,117,13.847582817077637,6.1084675788879395,68,11
1376,1,9.576429484337142,9.576429484337137,0.9305824669472429,0.9305824669472456,0,0,9.803564071655273,9.803564071655273,1,1
1376,2,8.496795420722318,8.496795420722318,0.9620533633016202,0.962053363301621,0,0,10.498814582824707,9.803564071655273,2,2
1376,3,8.342702542078118,8.342702542078118,0.9676416288746317,0.9676416288746316,0,0,10.641554832458496,9.803564071655273,3,3
1376,4,7.738059216465476,7.738059216465476,0.9816425763280117,0.9816425763280103,0,0,10.676392555236816,9.803564071655273,4,4
1376,8,6.893536415976695,6.928640882884733,1.0032577327542382,1.0030000581637406,1,1,11.07003402709961,9.803564071655273,7,7
1376,16,6.120565902210398,6.565552172171918,1.0175842304033806,1.0150330627766402,4,6,11.68025016784668,9.803564071655273,12,10
1376,32,5.350929580708005,6.348047236891809,1.0149346601011335,1.0219993477763136,13,18,12.441503524780273,9.803564071655273,19,14
1376,64,4.3739821798036544,6.282149938146282,1.0121429670174078,1.0276599773819488,29,48,13.064545631408691,9.803564071655273,35,16
1376,128,2.6557112972235832,5.971903624441166,1.0065189420848557,1.0416115111007187,54,109,13.65837574005127,9.803564071655273,74,19
1377,1,11.200081029908672,11.200081029908679,0.9317371656619257,0.9317371656619307,0,0,11.37818431854248,11.37818431854248,1,1
1377,2,10.410876539062865,10.41087653906287,0.9573704132822989,0.9573704132823024,0,0,12.451346397399902,11.37818431854248,2,2
1377,3,9.219980946659325,9.219980946659325,0.9935658234195677,0.993565823419569,0,0,13.22730541229248,11.37818431854248,3,3
1377,4,8.976208238618595,8.976208238618595,0.997948200165581,0.9979482001655824,0,0,13.51629638671875,11.37818431854248,4,4
1377,8,8.526928304989832,8.702416427741728,1.0105886600583596,1.0081135366409248,2,3,14.543440818786621,11.37818431854248,6,5
1377,16,8.311879244594918,8.702359913431415,1.0104054606799222,1.008221570271495,8,10,14.939152717590332,11.37818431854248,8,6
1377,32,6.71945786254652,8.386148723103183,1.0277465204691603,1.0238092393467042,12,24,15.752893447875977,11.37818431854248,20,8
1377,64,5.473228119827377,8.300956089942076,1.0076076379431427,1.0292150075579114,29,51,16.705677032470703,11.37818431854248,35,13
1377,128,3.6016256990017865,8.297853481913222,1.0019026688125192,1.0298925083765549,64,114,17.52024269104004,11.37818431854248,64,14
1378,1,9.149012257585044,9.149012257585047,0.9400294165808672,0.9400294165808684,0,0,9.32847785949707,9.32847785949707,1,1
1378,2,7.516741355172396,7.516741355172395,0.9743906911369096,0.9743906911369093,0,0,9.344400405883789,9.32847785949707,2,2
1378,3,6.98765283867026,6.987652838670259,0.9857389367375926,0.9857389367375917,0,0,9.766307830810547,9.32847785949707,3,3
1378,4,6.702056293960404,6.702056293960404,0.9916068671829853,0.9916068671829854,0,0,9.962494850158691,9.32847785949707,4,4
1378,8,6.282692051024789,6.36941303164204,0.9984792128257161,0.9987417174033387,3,3,10.252017974853516,9.32847785949707,5,5
1378,16,5.819850301355881,6.166987130361116,1.0051898336076943,1.0048419520779588,5,7,10.953614234924316,9.32847785949707,11,9
1378,32,4.894936048613333,6.084322056383126,1.0094481772543378,1.0100819992677859,14,20,11.272358894348145,9.32847785949707,18,12
1378,64,3.7933437660534666,6.062652802250363,1.0116876681362383,1.0122069847097381,30,48,11.673139572143555,9.32847785949707,34,16
1378,128,2.2348177042748203,5.85677171214342,1.004768860604365,1.0226865204039792,61,111,12.248800277709961,9.32847785949707,67,17
1379,1,8.251202998437027,8.251202998437027,0.9454041509852519,0.9454041509852522,0,0,8.40996265411377,8.40996265411377,1,1
1379,2,6.833366686853549,6.833366686853546,0.9791895085020603,0.9791895085020591,0,0,8.764017105102539,8.40996265411377,2,2
1379,3,6.350057223892099,6.350057223892101,0.9894621148240887,0.9894621148240884,0,0,9.08098316192627,8.40996265411377,3,3
1379,4,6.291740091356522,6.350057223892101,0.9882207115088361,0.9894621148240884,1,1,9.239534378051758,8.40996265411377,3,3
1379,8,5.90344710957162,6.009387431722521,1.0046376555943626,1.0048932836441442,1,1,10.032405853271484,8.40996265411377,7,7
1379,16,5.007956860607585,5.459787707565434,1.0117832262091144,1.0148726230429892,4,6,10.684771537780762,8.40996265411377,12,10
1379,32,4.131272512800476,5.341282564741711,1.0175273660276016,1.0201722841409562,13,18,11.394930839538574,8.40996265411377,19,14
1379,64,3.538915714839455,5.259086885240543,1.0113513520477864,1.0242149129516502,29,48,12.127925872802734,8.40996265411377,35,16
1379,128,2.6102427568932907,5.2268287186986635,1.0061322420493295,1.0273966842825322,65,108,13.006624221801758,8.40996265411377,63,20
1380,1,7.295737724103916,7.295737724103917,0.962060687992681,0.9620606879926816,0,0,7.383955001831055,7.383955001831055,1,1
1380,2,6.440283106520151,6.440283106520152,0.9766964804278716,0.9766964804278717,0,0,7.500951290130615,7.383955001831055,2,2
1380,3,5.8225784541799195,5.822578454179919,0.9867634736025832,0.9867634736025831,0,0,7.648265838623047,7.383955001831055,3,3
1380,4,5.561967978085039,5.561967978085038,0.9901790361299252,0.9901790361299254,0,0,7.691364765167236,7.383955001831055,4,4
1380,8,5.311116349201883,5.377391175366662,0.9935097068573621,0.994112835973586,1,2,8.660223960876465,7.383955001831055,7,6
1380,16,4.7181516045810605,4.923976076031587,1.0029641777399123,1.0020280762078955,6,9,9.251161575317383,7.383955001831055,10,7
1380,32,4.076795549423963,4.666829772708209,1.0071417167696786,1.0090049813405462,13,21,9.91742992401123,7.383955001831055,19,11
1380,64,2.776035747923211,4.48724570163225,1.0048461225370975,1.0139611389438632,31,49,10.475789070129395,7.383955001831055,33,15
1380,128,1.4049049456486307,4.373055313788512,1.0005620117140417,1.0171183013068201,67,112,11.256365776062012,7.383955001831055,61,16
1381,1,9.883063655217528,9.883063655217535,0.9365689386400735,0.9365689386400764,0,0,10.060659408569336,10.060659408569336,1,1
1381,2,8.223713346884532,8.22371334688453,0.9757197265916936,0.9757197265916939,0,0,10.594489097595215,10.060659408569336,2,2
1381,3,7.772173717397465,7.772173717397465,0.9852680410630074,0.9852680410630072,0,0,10.73220443725586,10.060659408569336,3,3
1381,4,7.62149172449564,7.621491724495638,0.9920563667437705,0.9920563667437701,0,0,11.750619888305664,10.060659408569336,4,4
1381,8,6.488988358851862,6.688927993477553,1.0213987707777135,1.017738249771031,2,2,12.072608947753906,10.060659408569336,6,6
1381,16,5.58138965629634,5.8826382844045675,1.0385675278016095,1.0365812325115857,6,8,12.500904083251953,10.060659408569336,10,8
1381,32,5.02619038737406,5.861790455434538,1.0378756255551709,1.038191754525109,16,18,13.483819961547852,10.060659408569336,16,14
1381,64,4.063212754310972,5.71159448908412,1.0198479557693132,1.0504759962595358,29,48,14.526355743408203,10.060659408569336,35,16
1381,128,2.568342946739687,5.652411718090026,1.0082901982263142,1.0540587778342634,66,109,15.459722518920898,10.060659408569336,62,19
1382,1,9.188080075237208,9.188080075237213,0.9535320866154313,0.953532086615433,0,0,9.292779922485352,9.292779922485352,1,1
1382,2,8.163180109302617,8.163180109302619,0.9781794310980099,0.978179431098011,0,0,10.16733455657959,9.292779922485352,2,2
1382,3,7.685619314393015,7.6856193143930165,0.9883613472250445,0.9883613472250459,0,0,10.409923553466797,9.292779922485352,3,3
1382,4,7.548950230711335,7.548950230711335,0.9918694188687327,0.9918694188687338,0,0,10.591642379760742,9.292779922485352,4,4
1382,8,6.585687355588632,6.63101063337054,1.0141510386517527,1.0135261995478546,1,1,10.965657234191895,9.292779922485352,7,7
1382,16,5.9517156048254,6.3003043761713835,1.0241597753074898,1.0211592366980806,5,7,11.46304702758789,9.292779922485352,11,9
1382,32,5.299557350155075,6.107183359790199,1.028286892613052,1.0292587485674343,15,18,12.041926383972168,9.292779922485352,17,14
1382,64,3.8786115458626638,5.7462148983767305,1.0236668114029606,1.0419894879235314,29,47,12.74623966217041,9.292779922485352,35,17
1382,128,2.317461505019013,5.626704211629521,1.0117016830157044,1.0470057960881118,65,113,13.579586029052734,9.292779922485352,63,15
1383,1,8.866782739683524,8.866782739683524,0.9461125214608609,0.9461125214608608,0,0,9.014219284057617,9.014219284057617,1,1
1383,2,8.393549975926955,8.393549975926957,0.9608879245833838,0.9608879245833837,0,0,9.16528606414795,9.014219284057617,2,2
1383,3,8.223273970230055,8.223273970230053,0.9644019237781106,0.9644019237781094,0,0,9.213348388671875,9.014219284057617,3,3
1383,4,7.5715001063717535,7.5715001063717535,0.9783214322040219,0.9783214322040213,0,0,9.786277770996094,9.014219284057617,4,4
1383,8,6.475141108795309,6.53808362278108,1.0007013560061109,0.999070122472603,2,2,10.07214069366455,9.014219284057617,6,6
1383,16,5.822241393307009,6.303078245538429,1.015684633004194,1.0084154204480702,4,7,11.194518089294434,9.014219284057617,12,9
1383,32,4.825620825967214,6.24452519247557,1.0091384034956405,1.0119344734900912,15,17,11.679204940795898,9.014219284057617,17,15
1383,64,3.674348545688978,6.002755912064099,1.0034374327294444,1.0203786959200616,33,47,12.222439765930176,9.014219284057617,31,17
1383,128,2.4143440064485664,5.911324062082854,1.0031519812122585,1.0265373980195875,64,108,12.994209289550781,9.014219284057617,64,20
1384,1,7.935826346295245,7.935826346295241,0.9623678009719797,0.9623678009719816,0,0,8.016636848449707,8.016636848449707,1,1
1384,2,5.900953558194104,5.900953558194105,0.994564748963269,0.9945647489632704,0,0,8.650445938110352,8.016636848449707,2,2
1384,3,5.858247322218979,5.85824732221898,0.995909095513157,0.9959090955131586,0,0,8.934242248535156,8.016636848449707,3,3
1384,4,5.5030572139462945,5.5030572139462945,1.0029283044548134,1.0029283044548145,0,0,9.310310363769531,8.016636848449707,4,4
1384,8,5.394472554944314,5.394472554944312,1.0073910214448332,1.007391021444835,0,0,9.863340377807617,8.016636848449707,8,8
1384,16,4.885956217070362,4.965427269957134,1.019050411492713,1.0202019467192724,4,5,10.451691627502441,8.016636848449707,12,11
1384,32,4.353055864727945,4.85177243593703,1.0205417041998457,1.023846281088968,14,16,10.833093643188477,8.016636848449707,18,16
1384,64,3.344046470786621,4.680892255794794,1.014376316457837,1.027805300690333,33,47,11.410750389099121,8.016636848449707,31,17
1384,128,1.908458189169935,4.620048986421603,1.0051889121061262,1.0295737819011601,62,107,11.7712984085083,8.016636848449707,66,21
1385,1,7.413392421978523,7.413392421978526,0.9695537247692543,0.9695537247692562,0,0,7.470217704772949,7.470217704772949,1,1
1385,2,5.949946120730256,5.949946120730255,0.990021568972661,0.9900215689726617,0,0,7.58206844329834,7.470217704772949,2,2
1385,3,5.8779627597316875,5.877962759731688,0.9910350282238628,0.9910350282238635,0,0,7.662019729614258,7.470217704772949,3,3
1385,4,5.812465504641832,5.812465504641833,0.9926572441718122,0.9926572441718131,0,0,7.759060859680176,7.470217704772949,4,4
1385,8,4.984842806239842,4.996900948944469,1.0038333263835417,1.0038303976545295,3,3,7.891849517822266,7.470217704772949,5,5
1385,16,4.638606097679297,4.8910942883149,1.0058536620064435,1.0055688623875916,8,7,8.508099555969238,7.470217704772949,8,9
1385,32,3.9820407700071976,4.86464729270865,1.0052147978013881,1.006371691088477,11,22,9.031517028808594,7.470217704772949,21,10
1385,64,2.7132692792592334,4.677402189697948,1.0037549097544871,1.0127660747503322,29,54,9.456398010253906,7.470217704772949,35,10
1385,128,1.1203257487517906,4.578918797277604,1.0001593624445662,1.0168666194026243,60,116,10.16006088256836,7.470217704772949,68,12
1386,1,7.553898585097682,7.553898585097683,0.9540307183608543,0.9540307183608551,0,0,7.680764675140381,7.680764675140381,1,1
1386,2,6.125396970224336,6.125396970224335,0.983832069121172,0.9838320691211715,0,0,7.883462429046631,7.680764675140381,2,2
1386,3,5.635522045447852,5.635522045447851,0.9925088337752932,0.9925088337752932,0,0,7.903528690338135,7.680764675140381,3,3
1386,4,5.307752914212887,5.307752914212887,0.9980828029195115,0.9980828029195106,0,0,8.016743659973145,7.680764675140381,4,4
1386,8,4.5738845118817455,4.573884511881745,1.0086122535422726,1.0086122535422737,0,0,8.763564109802246,7.680764675140381,8,8
1386,16,4.3018192023524735,4.572568214064766,1.0094359333645575,1.0088137518936535,6,6,9.459084510803223,7.680764675140381,10,10
1386,32,3.672826697267987,4.491498246896999,1.0116987735858398,1.012748874871249,10,21,10.201717376708984,7.680764675140381,22,11
1386,64,2.6819350922648133,4.262028013242341,1.0093792409801103,1.0196788117964757,29,51,11.08336353302002,7.680764675140381,35,13
1386,128,1.6245641413274055,4.079845604073229,1.0026623503194545,1.0274173632787003,59,114,12.016000747680664,7.680764675140381,69,14
1387,1,6.117649469875522,6.117649469875494,0.984532561644716,0.9845325616447176,0,0,6.135274410247803,6.135274410247803,1,1
1387,2,5.451409990061629,5.451409990061631,0.9940986211582312,0.9940986211582321,0,0,7.3202290534973145,6.135274410247803,2,2
1387,3,5.169916670645223,5.169916670645223,0.9994978892963153,0.9994978892963154,0,0,7.685771942138672,6.135274410247803,3,3
1387,4,4.870739860088985,4.870739860088984,1.004377734076154,1.0043777340761544,0,0,7.72146463394165,6.135274410247803,4,4
1387,8,4.53628085766536,4.733518945555424,1.006695964398295,1.0068927189937875,1,2,8.591875076293945,6.135274410247803,7,6
1387,16,4.078274540558879,4.447826882957293,1.0137756541835952,1.015104615496651,4,6,9.150257110595703,6.135274410247803,12,10
1387,32,3.2471689135681854,4.318478388675135,1.01171243472871,1.0190416372410602,15,18,9.689043045043945,6.135274410247803,17,14
1387,64,2.378752956148367,4.305988815910621,1.0028418435606996,1.020042507655577,30,46,10.305214881896973,6.135274410247803,34,18
1387,128,1.2434857230549812,4.298274191554885,0.9993853848372977,1.021270087259078,61,108,11.080199241638184,6.135274410247803,67,20
1388,1,9.024384413690681,9.024384413690685,0.9454030530223756,0.945403053022378,0,0,9.169456481933594,9.169456481933594,1,1
1388,2,8.711783801917962,8.711783801917965,0.9578259406359126,0.9578259406359144,0,0,10.891616821289062,9.169456481933594,2,2
1388,3,7.299106845581428,7.299106845581429,0.9947929445659824,0.9947929445659843,0,0,11.316593170166016,9.169456481933594,3,3
1388,4,6.8333085562174825,6.833308556217482,1.0057317430696227,1.0057317430696249,0,0,11.540434837341309,9.169456481933594,4,4
1388,8,6.670962968671819,6.684682121457688,1.0104250933420027,1.0098800293030448,1,2,12.05551815032959,9.169456481933594,7,6
1388,16,6.129455041198818,6.583554973061177,1.0160301848654383,1.0151779151075417,7,9,12.591845512390137,9.169456481933594,9,7
1388,32,5.6678859243566295,6.430629171764168,1.0237614540062,1.0237667240412929,14,24,13.702803611755371,9.169456481933594,18,8
1388,64,4.182581981116116,6.234734565959819,1.010689632022601,1.0300089407535769,27,54,14.361995697021484,9.169456481933594,37,10
1388,128,2.603374329250094,6.213494471022397,1.0000957731239855,1.0321835070670582,62,117,15.274457931518555,9.169456481933594,66,11
1389,1,8.443612850863842,8.443612850863842,0.9561460623392158,0.9561460623392161,0,0,8.543354988098145,8.543354988098145,1,1
1389,2,7.976869843612551,7.976869843612551,0.968754028746813,0.9687540287468128,0,0,9.165160179138184,8.543354988098145,2,2
1389,3,6.534420290095614,6.534420290095612,0.9931715782344206,0.9931715782344207,0,0,9.300883293151855,8.543354988098145,3,3
1389,4,6.421251395464623,6.421251395464623,0.9967260351320073,0.9967260351320069,0,0,9.40781021118164,8.543354988098145,4,4
1389,8,5.703884887483796,5.703884887483795,1.0121237380808028,1.0121237380808028,0,0,9.842604637145996,8.543354988098145,8,8
1389,16,5.1428313834182395,5.351818841806145,1.0223427956769726,1.020918526760298,4,6,10.53022575378418,8.543354988098145,12,10
1389,32,4.054766373463653,5.049203913158772,1.0243687466494866,1.0248406035541882,13,18,11.222454071044922,8.543354988098145,19,14
1389,64,2.826735749470811,4.969249049892902,1.0119563637851563,1.030808065461544,28,47,11.683706283569336,8.543354988098145,36,17
1389,128,1.7709380153841925,4.911229631759391,1.003122355352203,1.0343806549657115,63,106,12.379612922668457,8.543354988098145,65,22
1390,1,8.836191187381347,8.836191187381353,0.9518332450204214,0.9518332450204239,0,0,8.950032234191895,8.950032234191895,1,1
1390,2,7.584518461995292,7.584518461995295,0.9798456440998812,0.9798456440998826,0,0,9.541244506835938,8.950032234191895,2,2
1390,3,7.498549557530031,7.498549557530032,0.9828119870930586,0.9828119870930601,0,0,9.812793731689453,8.950032234191895,3,3
1390,4,6.963358876156977,6.991289497970374,0.9937497209016004,0.9937127736462898,1,1,10.083418846130371,8.950032234191895,3,3
1390,8,6.4619221148545485,6.553562403225328,1.0068107757365858,1.0062962181697812,2,2,10.86185359954834,8.950032234191895,6,6
1390,16,5.9356782831658865,6.453337094184808,1.0138735480976986,1.0109366901941688,7,6,11.404558181762695,8.950032234191895,9,10
1390,32,4.856352309366301,6.262440969981428,1.0105372112942126,1.0195300158910745,13,20,12.086281776428223,8.950032234191895,19,12
1390,64,3.9629563247640496,6.203012865293051,1.0113488445551284,1.0245945184687189,32,50,12.94807243347168,8.950032234191895,32,14
1390,128,2.4329085109740225,6.127238640726862,1.0045197267853507,1.0295551830519096,64,114,13.730145454406738,8.950032234191895,64,14
1391,1,10.426568894358143,10.426568894358148,0.9346174502963095,0.9346174502963113,0,0,10.611665725708008,10.611665725708008,1,1
1391,2,8.455296421581053,8.455296421581055,0.9749967812551007,0.9749967812551013,0,0,11.251463890075684,10.611665725708008,2,2
1391,3,8.376366017991677,8.376366017991677,0.9780626711063471,0.9780626711063474,0,0,11.303183555603027,10.611665725708008,3,3
1391,4,8.225246022447699,8.376366017991677,0.9773862069021564,0.9780626711063474,1,1,12.028786659240723,10.611665725708008,3,3
1391,8,7.8981946035237796,8.294905354005946,0.980896759945287,0.9832472506895434,4,4,13.008191108703613,10.611665725708008,4,4
1391,16,7.123680187220038,8.064121124728173,0.9905473492304467,0.9942488443904668,7,9,13.990002632141113,10.611665725708008,9,7
1391,32,6.066516625075245,7.937436546186885,1.0036870214427696,1.0044316528149304,16,23,14.85360050201416,10.611665725708008,16,9
1391,64,4.583645434975005,7.792130648939879,0.9984623693463432,1.0130566121855842,28,54,15.561583518981934,10.611665725708008,36,10
1391,128,3.1519914967987672,7.7177949159332435,1.0016721656918435,1.0194101312172907,65,117,16.507734298706055,10.611665725708008,63,11
1392,1,1.787569240927457,1.7875692409274582,0.9962892733622385,0.9962892733622394,0,0,1.7912871837615967,1.7912871837615967,1,1
1392,2,1.6654872177119249,1.6654872177119249,0.9979018526825544,0.9979018526825553,0,0,2.4935784339904785,1.7912871837615967,2,2
1392,3,1.5920215791713614,1.5920215791713623,0.9984459564411203,0.9984459564411219,0,0,2.7150166034698486,1.7912871837615967,3,3
1392,4,1.566746841730525,1.5920215791713623,0.9981730969747159,0.9984459564411219,1,1,2.7201218605041504,1.7912871837615967,3,3
1392,8,1.5293105825338473,1.577217998267738,0.9981632871600471,0.9985236884613065,4,4,2.990269422531128,1.7912871837615967,4,4
1392,16,1.2971660813040293,1.3839511130413744,0.9987868808863741,0.9995173002789888,6,10,3.3101117610931396,1.7912871837615967,10,6
1392,32,1.002014282787725,1.3424374656427036,0.999253801006518,1.0003390189144645,17,21,3.7073192596435547,1.7912871837615967,15,11
1392,64,0.2902310973632171,1.3036170251678478,1.0004114643682054,1.0005263210752633,30,53,4.315389633178711,1.7912871837615967,34,11
1392,128,0.01383607458734192,1.2935689195686664,1.0000020922428967,1.0009655234870956,65,115,5.098605155944824,1.7912871837615967,63,13
1393,1,10.868787603823254,10.868787603823261,0.9434251709058111,0.9434251709058132,0,0,11.00123119354248,11.00123119354248,1,1
1393,2,9.532211242974746,9.532211242974746,0.977890855616685,0.9778908556166861,0,0,11.991246223449707,11.00123119354248,2,2
1393,3,9.318169584589297,9.318169584589299,0.9847342299251984,0.9847342299252002,0,0,12.25780963897705,11.00123119354248,3,3
1393,4,9.318169529763432,9.318169584589299,0.9847321003972317,0.9847342299252002,1,1,12.373984336853027,11.00123119354248,3,3
1393,8,8.622181348454907,8.677417425537499,1.0072607800329474,1.0084825652611824,2,2,12.973353385925293,11.00123119354248,6,6
1393,16,7.940369096338986,8.257053878982152,1.0252314275836545,1.024831472610726,3,6,13.527210235595703,11.00123119354248,13,10
1393,32,6.792456846833406,7.964012992078598,1.0283540186056956,1.032249021946671,15,22,13.82020092010498,11.00123119354248,17,10
1393,64,5.59297295733348,7.876903231651376,1.0323048496313492,1.0359919721330795,27,54,14.240748405456543,11.00123119354248,37,10
1393,128,4.097959380856805,7.7414392721890035,1.025163742849533,1.0464007722541484,58,113,14.68728256225586,11.00123119354248,70,15
1394,1,11.014890026457238,11.014890026457243,0.9199355321857429,0.9199355321857442,0,0,11.266899108886719,11.266899108886719,1,1
1394,2,9.568418554741603,9.568418554741605,0.9645452442735962,0.9645452442735968,0,0,12.159074783325195,11.266899108886719,2,2
1394,3,9.412828124131545,9.412828124131545,0.9664822824495041,0.9664822824495045,0,0,12.462268829345703,11.266899108886719,3,3
1394,4,9.159230097760272,9.159230097760274,0.9712409615828936,0.9712409615828947,0,0,12.66268253326416,11.266899108886719,4,4
1394,8,8.08149433969978,8.081958969848348,1.002760261439619,1.0028793446104243,1,1,13.056513786315918,11.266899108886719,7,7
1394,16,7.270057759351284,7.478116114894473,1.0193759435534577,1.0183756546704938,4,7,13.356476783752441,11.266899108886719,12,9
1394,32,6.678281286163806,7.366991787401279,1.0230324748997575,1.0246757182568453,13,19,13.707310676574707,11.266899108886719,19,13
1394,64,5.139718492034954,6.982033047735318,1.0273307840404455,1.038421561545948,32,49,14.16184139251709,11.266899108886719,32,15
1394,128,2.994663784058355,6.808480055281466,1.0101883054864795,1.0447733352325963,61,113,14.79823112487793,11.266899108886719,67,15
1395,1,12.76012603592372,12.760126035923728,0.8883594916144907,0.888359491614493,0,0,13.183782577514648,13.183782577514648,1,1
1395,2,10.37533417621662,10.375334176216628,0.9488770098119933,0.9488770098119966,0,0,13.445710182189941,13.183782577514648,2,2
1395,3,10.17068137199968,10.170681371999684,0.9586477703832705,0.9586477703832736,0,0,14.050985336303711,13.183782577514648,3,3
1395,4,10.000307028420602,10.000307028420604,0.96423959318066,0.964239593180662,0,0,14.095760345458984,13.183782577514648,4,4
1395,8,9.545660384661252,9.605022466182632,0.9802520504374143,0.9801812953230092,3,3,14.304780960083008,13.183782577514648,5,5
1395,16,8.583763947293383,8.744407681104667,1.0114088972761464,1.011350532549963,5,8,14.56119441986084,13.183782577514648,11,8
1395,32,6.82800089120987,8.385013403854215,1.0291640337830343,1.0244995061968285,11,20,15.018403053283691,13.183782577514648,21,12
1395,64,5.766338839591689,8.307070957286337,1.0300311537822233,1.028433513240109,29,51,15.533098220825195,13.183782577514648,35,13
1395,128,3.49164401400394,8.10227832869954,1.0153286265275683,1.039342600507895,59,110,16.020950317382812,13.183782577514648,69,18
1396,1,6.284861691851591,6.284861691851569,0.9790084693233004,0.9790084693233017,0,0,6.316883563995361,6.316883563995361,1,1
1396,2,5.455861371922964,5.455861371922965,0.9915023954792954,0.991502395479296,0,0,6.969801902770996,6.316883563995361,2,2
1396,3,5.0517387067665345,5.0517387067665345,0.9976590810751209,0.997659081075122,0,0,7.066651344299316,6.316883563995361,3,3
1396,4,4.946335745081852,4.946335745081852,0.9996288751903526,0.9996288751903539,0,0,7.131887912750244,6.316883563995361,4,4
1396,8,4.284746660770789,4.287036535730457,1.0080215402026789,1.008006013475335,1,1,7.46040678024292,6.316883563995361,7,7
1396,16,3.70273020940672,3.789501306223003,1.0168052063892523,1.0173281975731312,6,6,7.923713684082031,6.316883563995361,10,10
1396,32,3.163384044432143,3.6478469441892227,1.0174252278205858,1.0194861956990504,15,19,8.20249080657959,6.316883563995361,17,13
1396,64,2.119823645568154,3.602364231344945,1.0082860457077114,1.0208156371002501,31,45,8.76718521118164,6.316883563995361,33,19
1396,128,1.0959462510398146,3.5147316823411696,1.0012386972452045,1.0226847965288393,64,109,9.350260734558105,6.316883563995361,64,19
1397,1,5.1512208151554395,5.151220815155439,0.9857060780557917,0.985706078055791,0,0,5.170267581939697,5.170267581939697,1,1
1397,2,4.757899573554236,4.757899573554236,0.9894153476496739,0.9894153476496739,0,0,5.184479713439941,5.170267581939697,2,2
1397,3,4.5280145526671,4.5280223203915995,0.9925699262204322,0.9925646616749839,1,1,5.225435256958008,5.170267581939697,2,2
1397,4,4.521561383688957,4.521588968112575,0.9926524757054497,0.9926424037178483,1,1,5.34686803817749,5.170267581939697,3,3
1397,8,3.836239771019993,3.8498523487336183,0.9992858254065395,0.99922586339215,3,4,5.734704971313477,5.170267581939697,5,4
1397,16,2.964884573565296,3.3797374577723596,1.0046258128505139,1.0025986125737354,7,11,5.993396759033203,5.170267581939697,9,5
1397,32,2.6222501879949096,3.372268527238773,1.0023220663255055,1.0030740860504508,12,26,6.232964038848877,5.170267581939697,20,6
1397,64,1.3307652835088586,3.2972909249795435,0.9996079304629681,1.0042754867402643,33,57,6.629698276519775,5.170267581939697,31,7
1397,128,0.5182984903198034,3.224544658740374,0.9993686722267068,1.0065182644261441,63,120,7.0098958015441895,5.170267581939697,65,8
1398,1,7.972760920953285,7.972760920953267,0.9649792643550762,0.9649792643550791,0,0,8.03951644897461,8.03951644897461,1,1
1398,2,6.7380799026927685,6.738079902692769,0.9907248141086753,0.9907248141086771,0,0,9.76363754272461,8.03951644897461,2,2
1398,3,6.489955453131681,6.4899554531316825,0.9970789956018351,0.9970789956018369,0,0,9.85030746459961,8.03951644897461,3,3
1398,4,6.099759247436675,6.099759247436675,1.0041764432762634,1.0041764432762652,0,0,9.866633415222168,8.03951644897461,4,4
1398,8,5.5899675905492785,5.6266328562697225,1.0156588574774925,1.015825168594894,1,1,10.001298904418945,8.03951644897461,7,7
1398,16,5.2124467640068755,5.368248840056479,1.0256037801485387,1.0231272640280502,5,6,10.86103630065918,8.03951644897461,11,10
1398,32,4.649823245557823,5.049771834720573,1.0274671194912768,1.0285020281652373,14,18,11.519421577453613,8.03951644897461,18,14
1398,64,3.643702498313951,4.902953013596373,1.017095576187315,1.0340980724692355,30,47,12.074832916259766,8.03951644897461,34,17
1398,128,1.9304345320985092,4.902167076183084,1.002911145053589,1.034448723769616,60,110,12.62491512298584,8.03951644897461,68,18
1399,1,7.75104574731792,7.751045747317922,0.9635060854626653,0.963506085462666,0,0,7.825648307800293,7.825648307800293,1,1
1399,2,6.968507324361367,6.968507324361366,0.9784669725101671,0.9784669725101667,0,0,8.582687377929688,7.825648307800293,2,2
1399,3,6.4356444103648,6.435644410364798,0.9885318356516392,0.9885318356516377,0,0,8.668082237243652,7.825648307800293,3,3
1399,4,6.231597977182033,6.231597977182033,0.9961225015537039,0.9961225015537046,0,0,10.562277793884277,7.825648307800293,4,4
1399,8,5.390153558543739,5.592299034452218,1.0222120719762127,1.019626396463747,2,2,10.986096382141113,7.825648307800293,6,6
1399,16,5.030436988661595,5.5434623286442735,1.0214231812327959,1.0214518268528843,7,9,11.724512100219727,7.825648307800293,9,7
1399,32,3.9754425890743494,5.33987897109397,1.020755887379313,1.0283654937778182,13,22,12.385640144348145,7.825648307800293,19,10
1399,64,3.0133927499694573,5.2824120332286615,1.013474581932985,1.0296503951600355,30,52,13.148197174072266,7.825648307800293,34,12
1399,128,1.8060043564502735,5.23872021320653,1.0021402486078315,1.0323002933822742,62,115,14.073351860046387,7.825648307800293,66,13
1400,1,6.791179409597565,6.7911794095975715,0.9747896462459074,0.9747896462459104,0,0,6.834946155548096,6.834946155548096,1,1
1400,2,4.962087684952248,4.962087684952246,1.004961753933513,1.0049617539335138,0,0,7.681924343109131,6.834946155548096,2,2
1400,3,4.950410469037584,4.950410469037584,1.0050859542881474,1.0050859542881485,0,0,7.770822525024414,6.834946155548096,3,3
1400,4,4.944785994743393,4.950410469037584,1.005037950153212,1.0050859542881485,1,1,7.796397686004639,6.834946155548096,3,3
1400,8,4.840363207464175,4.862680966562754,1.0079980701778002,1.0075068400643101,1,1,8.085973739624023,6.834946155548096,7,7
1400,16,3.883462713798662,4.138049868187634,1.0165690505100489,1.0173675119076058,7,7,8.314774513244629,6.834946155548096,9,9
1400,32,3.2490016475355534,3.9272416648732356,1.0166612826306078,1.0224267938946408,12,21,8.972929954528809,6.834946155548096,20,11
1400,64,2.266859747751559,3.8514636616295475,1.0082386550891371,1.0248528366746519,28,53,9.681964874267578,6.834946155548096,36,11
1400,128,0.9745028624464941,3.845100265815773,1.000227943002419,1.0258141883886807,59,113,10.50636100769043,6.834946155548096,69,15
1401,1,6.162659334529334,6.162659334529335,0.979100813606753,0.9791008136067534,0,0,6.195268154144287,6.195268154144287,1,1
1401,2,5.30051616691486,5.300516166914859,0.9903309144192856,0.9903309144192852,0,0,6.367640495300293,6.195268154144287,2,2
1401,3,4.710144175515727,4.710144175515726,0.9977378131230235,0.9977378131230219,0,0,6.44606876373291,6.195268154144287,3,3
1401,4,4.552008301469366,4.552008301469366,1.0000822102663833,1.0000822102663824,0,0,7.269383907318115,6.195268154144287,4,4
1401,8,3.2866249070662947,3.287200380569761,1.0127755102120735,1.0128351577725558,1,1,7.47796630859375,6.195268154144287,7,7
1401,16,3.0856000994619346,3.1040880560317934,1.0132199110024285,1.0140086712995755,4,6,7.8834452629089355,6.195268154144287,12,10
1401,32,2.5825745826639133,3.039921440414189,1.010098433610011,1.0154933782357332,16,20,8.27867317199707,6.195268154144287,16,12
1401,64,1.8003347319092662,2.936624419550679,1.008800451016148,1.0186593112717797,25,46,8.8182373046875,6.195268154144287,39,18
1401,128,0.8318969897164363,2.9116865155898046,1.0029500135567866,1.0201055762183735,56,106,9.405097007751465,6.195268154144287,72,22
1402,1,10.199395451137,10.199395451137,0.940247167215241,0.9402471672152419,0,0,10.35567855834961,10.35567855834961,1,1
1402,2,7.192062919116753,7.192062919116754,1.005702924792689,1.005702924792688,0,0,11.304580688476562,10.35567855834961,2,2
1402,3,6.987746533376421,6.987746533376422,1.0110392010174125,1.011039201017412,0,0,11.414162635803223,10.35567855834961,3,3
1402,4,6.913193428900519,6.913193428900519,1.012172065118507,1.0121720651185064,0,0,11.47612476348877,10.35567855834961,4,4
1402,8,6.573874631566584,6.573874631566582,1.0216472450512022,1.0216472450512026,0,0,12.258012771606445,10.35567855834961,8,8
1402,16,6.294846871442342,6.4610767303572665,1.0238849211283545,1.0251532249548994,5,6,12.769499778747559,10.35567855834961,11,10
1402,32,5.799329162304188,6.337875623491331,1.0290078031765455,1.02924272860366,9,19,12.98397159576416,10.35567855834961,23,13
1402,64,4.236536036736603,6.046972026130067,1.0243976881088006,1.0368595316920945,34,51,13.459044456481934,10.35567855834961,30,13
1402,128,2.9640064571936158,6.042601173683969,1.0132171512222192,1.0379094445454842,62,112,13.827038764953613,10.35567855834961,66,16
1403,1,8.049317982037515,8.049317982037515,0.9637192731109255,0.9637192731109245,0,0,8.125823974609375,8.125823974609375,1,1
1403,2,7.031602726941681,7.0316027269416805,0.9771231524516776,0.9771231524516762,0,0,8.16542911529541,8.125823974609375,2,2
1403,3,6.245314253741394,6.245314253741393,0.9895121463894079,0.989512146389407,0,0,8.1736478805542,8.125823974609375,3,3
1403,4,6.031395764298654,6.033605806128511,0.9924813594911701,0.992347219908273,1,1,8.2610445022583,8.125823974609375,3,3
1403,8,5.848197640316292,6.000985579889413,0.9945719045089992,0.9925391380333362,3,3,8.414402961730957,8.125823974609375,5,5
1403,16,5.609489218015784,5.967337401859943,0.9964428900446797,0.9933294358126039,7,8,8.618542671203613,8.125823974609375,9,8
1403,32,5.190201460387009,5.957506121711283,0.9949007323482562,0.993905473555623,14,21,8.995467185974121,8.125823974609375,18,11
1403,64,3.671095733270762,5.642757685314355,1.0016487494455555,1.0020950599116119,29,53,9.284372329711914,8.125823974609375,35,11
1403,128,2.454294551199973,5.573957572218861,0.9947478627601345,1.004809174000558,65,117,9.696496963500977,8.125823974609375,63,11
1404,1,8.077187981842927,8.077187981842902,0.9580031473540811,0.958003147354085,0,0,8.175024032592773,8.175024032592773,1,1
1404,2,6.536303411462625,6.536303411462628,0.9852371938292568,0.9852371938292594,0,0,8.423367500305176,8.175024032592773,2,2
1404,3,6.221074023209423,6.221074023209424,0.9909459349602536,0.9909459349602565,0,0,8.502713203430176,8.175024032592773,3,3
1404,4,5.789984542028408,5.789984542028408,0.9974316206998399,0.997431620699843,0,0,8.597586631774902,8.175024032592773,4,4
1404,8,5.057457339177958,5.443970464386892,1.0074437336344682,1.0033592497672548,2,2,8.859970092773438,8.175024032592773,6,6
1404,16,4.338382949262198,5.213431715832606,1.0134460693890313,1.008835560751725,6,8,9.453714370727539,8.175024032592773,10,8
1404,32,4.009211599574797,4.918285374102325,1.0142580386826046,1.019243329404514,12,20,10.51264476776123,8.175024032592773,20,12
1404,64,3.154233354065984,4.9004162733921905,1.0085982995010117,1.0195024517316906,29,51,11.458210945129395,8.175024032592773,35,13
1404,128,1.6865976202286017,4.878100661024485,1.0008887178969053,1.021487986767242,56,113,12.565627098083496,8.175024032592773,72,15
1405,1,7.52112363750931,7.521123637509315,0.9662900508210993,0.9662900508211019,0,0,7.588373184204102,7.588373184204102,1,1
1405,2,6.7885489871622,6.788548987162201,0.9819137745644893,0.981913774564491,0,0,8.889248847961426,7.588373184204102,2,2
1405,3,6.649997915158968,6.649997915158968,0.9858984290712993,0.9858984290713004,0,0,9.322810173034668,7.588373184204102,3,3
1405,4,6.463399546865232,6.463399546865232,0.9899206861566014,0.9899206861566027,0,0,9.592830657958984,7.588373184204102,4,4
1405,8,5.540868205371712,5.551359894599069,1.0087400948270138,1.0087733720099499,3,3,9.789552688598633,7.588373184204102,5,5
1405,16,5.1363674262541785,5.388761428973054,1.016441220800127,1.0149900326000436,3,6,10.320987701416016,7.588373184204102,13,10
1405,32,4.561953056036819,5.142636437621198,1.0197966479296072,1.021442033207943,12,16,11.192110061645508,7.588373184204102,20,16
1405,64,3.05494289458421,5.055938387801196,1.0101179242387757,1.0259416209310683,31,46,11.91396427154541,7.588373184204102,33,18
1405,128,1.80010649025809,4.940688405676066,1.0050659806173274,1.0318073116014008,59,107,12.706995010375977,7.588373184204102,69,21
1406,1,8.567249155806577,8.56724915580658,0.964736346327837,0.9647363463278389,0,0,8.63213062286377,8.63213062286377,1,1
1406,2,6.984524959893449,6.984524959893449,0.9968925092946506,0.9968925092946517,0,0,9.909235000610352,8.63213062286377,2,2
1406,3,6.8569257494530325,6.856925749453031,0.99997256637349,0.9999725663734912,0,0,9.988005638122559,8.63213062286377,3,3
1406,4,6.594906495119346,6.5949064951193455,1.0043755393710403,1.0043755393710407,0,0,10.744397163391113,8.63213062286377,4,4
1406,8,6.311507439835767,6.380484341483346,1.0100647036681933,1.0094124810237393,3,3,11.235466003417969,8.63213062286377,5,5
1406,16,5.937804234386698,6.12640534639187,1.0199285950051173,1.0191458654050285,6,5,11.792479515075684,8.63213062286377,10,11
1406,32,4.9808941518919045,5.79994095721969,1.019249137213158,1.022927103065669,15,21,12.189020156860352,8.63213062286377,17,11
1406,64,3.7262585966223973,5.784768695112452,1.0146556141601486,1.0239664427877722,33,48,12.744342803955078,8.63213062286377,31,16
1406,128,2.108755644926736,5.670422764315536,1.0055160039075821,1.0301311188438969,61,113,13.100274085998535,8.63213062286377,67,15
1407,1,10.494271593164443,10.494271593164438,0.9283360881278069,0.9283360881278087,0,0,10.712983131408691,10.712983131408691,1,1
1407,2,8.799967800774576,8.799967800774576,0.9774204708046842,0.9774204708046847,0,0,10.858842849731445,10.712983131408691,2,2
1407,3,8.223963250851448,8.223963250851448,0.9878087946943679,0.9878087946943674,0,0,10.891777038574219,10.712983131408691,3,3
1407,4,7.780168432605269,7.780168432605268,0.9939026033339513,0.9939026033339524,0,0,11.11785888671875,10.712983131408691,4,4
1407,8,7.218627899029617,7.2186278990296175,1.0105099345149904,1.0105099345149893,0,0,11.266511917114258,10.712983131408691,8,8
1407,16,6.55689629864142,6.757901645837946,1.023040944687836,1.022432001892477,4,5,11.792338371276855,10.712983131408691,12,11
1407,32,6.047008986329249,6.43214329239037,1.0361523622494022,1.0343817683508825,12,16,12.401386260986328,10.712983131408691,20,16
1407,64,4.945700974415755,6.253390157900981,1.0213751847885781,1.0404725850920102,31,45,13.27826976776123,10.712983131408691,33,19
1407,128,3.2448482262785014,6.085031388514322,1.0079989543631631,1.0486016789484665,62,110,13.92863941192627,10.712983131408691,66,18
1408,1,7.444900668734312,7.444900668734315,0.9639330765460782,0.9639330765460793,0,0,7.521695137023926,7.521695137023926,1,1
1408,2,6.928705937014112,6.928705937014113,0.9749304430972724,0.974930443097273,0,0,8.263500213623047,7.521695137023926,2,2
1408,3,6.287310461438583,6.287310461438582,0.9878560520592075,0.9878560520592069,0,0,8.450078010559082,7.521695137023926,3,3
1408,4,5.496228798573921,5.49622879857392,0.9997747555173679,0.9997747555173669,0,0,8.62434196472168,7.521695137023926,4,4
1408,8,5.07510824924226,5.075184221280945,1.0076940602629387,1.0077142084838289,1,1,9.34514331817627,7.521695137023926,7,7
1408,16,4.376384509277083,4.605467129569515,1.016277429035027,1.0164344351456454,5,7,10.116559028625488,7.521695137023926,11,9
1408,32,3.721359670511219,4.403949533741742,1.0175476050671295,1.022416640937434,15,22,10.928980827331543,7.521695137023926,17,10
1408,64,3.068499487738143,4.285641536995008,1.0061645211407682,1.0264540450195518,29,50,11.899487495422363,7.521695137023926,35,14
1408,128,2.181857183503774,4.236474187010824,1.001485319981858,1.0281235967937705,65,113,12.911032676696777,7.521695137023926,63,15
1409,1,6.835583210809706,6.835583210809709,0.9733528213852777,0.9733528213852796,0,0,6.883823394775391,6.883823394775391,1,1
1409,2,6.186496901052282,6.186496901052283,0.9898470561652553,0.989847056165257,0,0,8.611830711364746,6.883823394775391,2,2
1409,3,6.115340746358275,6.115340746358277,0.9908186360358568,0.9908186360358583,0,0,8.733851432800293,6.883823394775391,3,3
1409,4,5.963465528361432,5.963465528361432,0.9990940499720482,0.9990940499720505,0,0,9.009222984313965,6.883823394775391,4,4
1409,8,5.604953035093123,5.604953035093122,1.0058088963459595,1.0058088963459602,0,0,9.304303169250488,6.883823394775391,8,8
1409,16,4.428036772753973,4.5567383917852196,1.0227504514003525,1.0221562907470259,5,7,9.59593391418457,6.883823394775391,11,9
1409,32,3.962893944705485,4.481715243448079,1.01552918273922,1.021215646979913,14,23,9.923664093017578,6.883823394775391,18,9
1409,64,2.893762719761658,4.441017087093943,1.0102392747804245,1.0227245325286987,28,51,10.199036598205566,6.883823394775391,36,13
1409,128,1.7576361508083853,4.356514728674433,1.0006031652064629,1.0242257046068903,63,116,10.552674293518066,6.883823394775391,65,12
1410,1,9.774362147853415,9.774362147853425,0.9292197588933231,0.9292197588933252,0,0,10.008500099182129,10.008500099182129,1,1
1410,2,8.648293204419378,8.64829320441938,0.9581309571412329,0.9581309571412335,0,0,10.72034740447998,10.008500099182129,2,2
1410,3,8.17094994859395,8.170949948593954,0.9728170198632262,0.9728170198632279,0,0,11.373922348022461,10.008500099182129,3,3
1410,4,8.042922326918218,8.04292232691822,0.9775148957127728,0.9775148957127741,0,0,11.383695602416992,10.008500099182129,4,4
1410,8,6.614728968511634,6.633868194245315,1.017370131601574,1.017536802511982,2,2,11.777917861938477,10.008500099182129,6,6
1410,16,5.78497735700491,6.06664693754599,1.0369457768848889,1.0359713011610248,6,6,12.714093208312988,10.008500099182129,10,10
1410,32,4.898349756805623,6.063619613332929,1.0289730198236309,1.0362802003498373,14,20,13.388351440429688,10.008500099182129,18,12
1410,64,4.256378893186743,6.047179063217088,1.0227133599539426,1.0363788559871456,34,51,13.955937385559082,10.008500099182129,30,13
1410,128,2.3263988747902715,6.026901503905111,1.010366915224222,1.0388208144431008,62,113,14.552114486694336,10.008500099182129,66,15
1411,1,9.281134148547098,9.281134148547098,0.9378309226918553,0.9378309226918563,0,0,9.462821960449219,9.462821960449219,1,1
1411,2,8.71482928999989,8.714829289999887,0.9500720862949238,0.9500720862949227,0,0,9.88342571258545,9.462821960449219,2,2
1411,3,8.311045011741978,8.311045011741996,0.962259220364639,0.9622592203646374,0,0,9.955024719238281,9.462821960449219,3,3
1411,4,7.922617185351254,7.922847121169734,0.9705596222546204,0.970519049117583,1,1,10.149413108825684,9.462821960449219,3,3
1411,8,7.5754009579541846,7.65670247962576,0.9795270954859481,0.9776742969692003,2,2,10.539571762084961,9.462821960449219,6,6
1411,16,7.117962070827435,7.478895492723844,0.9863107918102596,0.9817935315597118,6,8,10.762738227844238,9.462821960449219,10,8
1411,32,6.252944418461578,7.079577255359827,0.9970945662654965,0.9941469353963277,16,23,11.324126243591309,9.462821960449219,16,9
1411,64,4.183106039804988,6.5556984235857625,1.0068348050123601,1.0101127764719944,28,51,12.245140075683594,9.462821960449219,36,13
1411,128,2.1610016448358107,6.32302454596123,1.0028950237596517,1.0204479805522602,65,113,12.966652870178223,9.462821960449219,63,15
1412,1,7.107414014811828,7.107414014811828,0.9795154122570762,0.9795154122570764,0,0,7.134212970733643,7.134212970733643,1,1
1412,2,6.035761135634365,6.035761135634366,0.9969165628105887,0.996916562810588,0,0,7.956310749053955,7.134212970733643,2,2
1412,3,5.985233296219522,5.985233296219522,0.9986768112671035,0.9986768112671022,0,0,8.785948753356934,7.134212970733643,3,3
1412,4,5.66516649140308,5.665166491403081,1.0073396095955913,1.0073396095955902,0,0,9.033278465270996,7.134212970733643,4,4
1412,8,5.141524091711857,5.171834459639306,1.014637498184616,1.016296939237697,1,1,9.715638160705566,7.134212970733643,7,7
1412,16,4.578181760215486,4.91229754550114,1.0170963162859696,1.0196387420471789,7,9,10.063830375671387,7.134212970733643,9,7
1412,32,4.099960576476309,4.909030062359413,1.0167739798714146,1.0199889887249247,16,24,10.354866981506348,7.134212970733643,16,8
1412,64,3.3103809507092152,4.879256179451969,1.0071246238039848,1.0215381601329716,29,53,10.728586196899414,7.134212970733643,35,11
1412,128,2.128657776532212,4.821529603177138,1.002441888659728,1.0245694537742551,66,116,11.014153480529785,7.134212970733643,62,12
1413,1,9.406004660360349,9.406004660360324,0.9361495379448391,0.9361495379448417,0,0,9.603594779968262,9.603594779968262,1,1
1413,2,8.444330501523881,8.444330501523888,0.9597707922336893,0.9597707922336908,0,0,9.866348266601562,9.603594779968262,2,2
1413,3,7.985159083122348,7.985159083122351,0.9695334653537757,0.9695334653537777,0,0,10.027552604675293,9.603594779968262,3,3
1413,4,7.779056620535117,7.779056620535121,0.9741435435904727,0.9741435435904755,0,0,10.041413307189941,9.603594779968262,4,4
1413,8,7.182093868213333,7.216725464954938,0.9897941411351239,0.9887697460530649,2,2,10.72399616241455,9.603594779968262,6,6
1413,16,6.25251268242959,6.738094164789676,1.005487794423656,1.0016695733523968,5,6,11.08735466003418,9.603594779968262,11,10
1413,32,5.346127608668814,6.527768153894097,1.0083478513792083,1.0049650433152086,15,19,11.34162425994873,9.603594779968262,17,13
1413,64,3.972960484473307,6.327946999634312,1.0064074267581982,1.013334746262569,30,49,11.83830451965332,9.603594779968262,34,15
1413,128,2.3438809295674954,6.295862154107748,1.0028181935475406,1.0151262899897973,67,113,12.34544849395752,9.603594779968262,61,15
1414,1,10.502187096969351,10.502187096969356,0.9408851226066022,0.9408851226066042,0,0,10.652562141418457,10.652562141418457,1,1
1414,2,9.782086921636138,9.782086921636138,0.9567985174095378,0.9567985174095386,0,0,10.736329078674316,10.652562141418457,2,2
1414,3,8.825135212575246,8.82513521257525,0.9757846594817043,0.9757846594817055,0,0,10.856424331665039,10.652562141418457,3,3
1414,4,8.587102129437826,8.587102129437827,0.982313081001609,0.9823130810016105,0,0,10.891688346862793,10.652562141418457,4,4
1414,8,8.264955075726608,8.274225283113742,0.9882771340677489,0.9881829702210578,1,1,11.116473197937012,10.652562141418457,7,7
1414,16,7.233947204109601,7.600686005203923,1.0072119815603724,1.0040718418395471,5,9,11.471391677856445,10.652562141418457,11,7
1414,32,5.81547640187919,6.607676448786634,1.0196431310736322,1.0214716622356521,17,23,12.054241180419922,10.652562141418457,15,9
1414,64,4.412552331134557,6.392001327943093,1.0161219755169812,1.0263925901280149,29,54,12.594758033752441,10.652562141418457,35,10
1414,128,2.596967970351489,6.115214418994464,1.0058738071523297,1.0355921760960038,66,117,13.014172554016113,10.652562141418457,62,11
1415,1,11.337202212606762,11.337202212606762,0.9037113718938002,0.9037113718938031,0,0,11.688935279846191,11.688935279846191,1,1
1415,2,8.955007801251059,8.955007801251059,0.9771321953655796,0.9771321953655812,0,0,12.652851104736328,11.688935279846191,2,2
1415,3,8.284434116280229,8.284434116280233,0.9935903850436465,0.9935903850436484,0,0,12.661364555358887,11.688935279846191,3,3
1415,4,7.793971200116966,7.793971200116966,1.0014253231921306,1.0014253231921324,0,0,13.177614212036133,11.688935279846191,4,4
1415,8,7.517912937678853,7.5523947958783,1.0090057223951587,1.0100364192258595,1,1,13.342167854309082,11.688935279846191,7,7
1415,16,6.884573050120472,7.116958992552901,1.025132186391351,1.0223455045185545,3,3,13.666558265686035,11.688935279846191,13,13
1415,32,6.41028265790749,6.74840929871902,1.0322953017048984,1.0344870811171212,11,20,14.017095565795898,11.688935279846191,21,12
1415,64,5.363171862177761,6.689266064887058,1.0360468703827959,1.036242654238308,25,48,14.3270263671875,11.688935279846191,39,16
1415,128,3.700599326592139,6.541264739683644,1.0223444323602657,1.0411391443669045,62,108,14.783967018127441,11.688935279846191,66,20
1416,1,5.855102111751071,5.855102111751074,0.9805302178461988,0.9805302178462004,0,0,5.883996486663818,5.883996486663818,1,1
1416,2,4.881317811310872,4.881317811310872,0.9922024647960104,0.9922024647960099,0,0,6.037670135498047,5.883996486663818,2,2
1416,3,3.7816870293756755,3.7816870293756755,1.0007648008913543,1.0007648008913541,0,0,6.0547895431518555,5.883996486663818,3,3
1416,4,3.3288304065009964,3.3288304065009844,1.0065404047085695,1.0065404047085678,0,0,6.524922847747803,5.883996486663818,4,4
1416,8,2.770570554010915,2.881353716340623,1.0109676081495127,1.0110822058299114,1,1,7.030837535858154,5.883996486663818,7,7
1416,16,2.6210645499044136,2.8260811888042148,1.0101589254902525,1.01201159614531,7,7,7.893688678741455,5.883996486663818,9,9
1416,32,2.281355314332014,2.7535876079596444,1.0096053689152775,1.0152907824091162,14,19,8.465083122253418,5.883996486663818,18,13
1416,64,1.7588924487528874,2.6964514347941555,1.006288812540597,1.0178444126438684,31,48,9.405760765075684,5.883996486663818,33,16
1416,128,1.0392514883931057,2.6506872361769673,1.0007588934928457,1.0189055542250056,59,112,10.49957275390625,5.883996486663818,69,16
1417,1,7.493405534711847,7.49340553471185,0.968537852804073,0.9685378528040747,0,0,7.553508758544922,7.553508758544922,1,1
1417,2,6.521467602878883,6.521467602878885,0.9874283931863908,0.9874283931863927,0,0,7.904401779174805,7.553508758544922,2,2
1417,3,6.0344838171387085,6.0344838171387085,0.995278013175172,0.9952780131751742,0,0,7.990541934967041,7.553508758544922,3,3
1417,4,5.894913274858338,5.894913274858338,0.997787885732168,0.9977878857321695,0,0,8.01262378692627,7.553508758544922,4,4
1417,8,5.430685998891638,5.486986495249224,1.0072808119551746,1.006555677937468,2,3,9.020432472229004,7.553508758544922,6,5
1417,16,4.9031366601793955,5.270127208701957,1.0122556280173325,1.0113199504320514,5,7,9.397330284118652,7.553508758544922,11,9
1417,32,3.624354140478804,5.096002883301916,1.0075832952768902,1.0151532235373713,15,24,10.150773048400879,7.553508758544922,17,8
1417,64,2.638786701893812,5.078916249737598,1.0035681231438103,1.0163512752905168,30,53,10.780069351196289,7.553508758544922,34,11
1417,128,1.46914490071476,4.941988898077458,1.0032770620561653,1.0226560516909955,61,116,11.590449333190918,7.553508758544922,67,12
1418,1,7.726630025692166,7.726630025692164,0.9638157064171826,0.9638157064171823,0,0,7.801424980163574,7.801424980163574,1,1
1418,2,6.249533084007959,6.24953308400796,0.9871825342561128,0.9871825342561127,0,0,8.031807899475098,7.801424980163574,2,2
1418,3,5.639530822927073,5.639530822927073,0.9957171799053897,0.9957171799053888,0,0,8.077592849731445,7.801424980163574,3,3
1418,4,5.604143420896531,5.604143420896531,0.9968204261817919,0.9968204261817908,0,0,8.3536376953125,7.801424980163574,4,4
1418,8,4.886853511781959,4.905828494483453,1.0108107830885533,1.0099461738378237,1,2,8.843565940856934,7.801424980163574,7,6
1418,16,4.326273010197134,4.399426390674676,1.0169862698268597,1.0162732045785474,5,6,9.502002716064453,7.801424980163574,11,10
1418,32,3.8232084036196436,4.206993029421982,1.0196877625107463,1.0212782458651946,13,22,10.158023834228516,7.801424980163574,19,10
1418,64,3.0033975093973013,4.155972056544804,1.011295949705529,1.0233757162493053,32,51,10.884115219116211,7.801424980163574,32,13
1418,128,1.563651196502354,4.142378167264409,1.0032596079991605,1.0248869945827712,68,114,11.524169921875,7.801424980163574,60,14
1419,1,9.427007313857748,9.427007313857738,0.9445294124122012,0.9445294124122036,0,0,9.57473373413086,9.57473373413086,1,1
1419,2,6.1993076408476675,6.199307640847665,1.0073827347676136,1.0073827347676148,0,0,9.788561820983887,9.57473373413086,2,2
1419,3,5.976593203060699,5.976593203060697,1.0150434811380824,1.0150434811380844,0,0,11.59172248840332,9.57473373413086,3,3
1419,4,5.852859399434102,5.852859399434102,1.0178967312979663,1.0178967312979674,0,0,11.835437774658203,9.57473373413086,4,4
1419,8,5.241895666264977,5.353519293681996,1.032770445503707,1.0313611893984433,2,2,12.238574981689453,9.57473373413086,6,6
1419,16,4.951308443653732,5.2229119329772775,1.0413905548623492,1.0370274228167782,3,5,12.770621299743652,9.57473373413086,13,11
1419,32,4.383647945027751,5.158768598736714,1.0304909885734632,1.0392454420970951,15,19,13.811182975769043,9.57473373413086,17,13
1419,64,3.2856617569833197,5.138174153975377,1.012153760368398,1.0414445805525503,33,50,14.950356483459473,9.57473373413086,31,14
1419,128,2.179245991581665,5.115933200517183,1.0056224473032755,1.0444985038871712,63,111,15.767741203308105,9.57473373413086,65,17
1420,1,7.706139531107307,7.706139531107307,0.9604951857100598,0.96049518571006,0,0,7.795892238616943,7.795892238616943,1,1
1420,2,7.181080594426119,7.181080594426119,0.9687367471744674,0.9687367471744679,0,0,7.9464216232299805,7.795892238616943,2,2
1420,3,5.154109528786944,5.154109528786944,0.9967092805016419,0.9967092805016424,0,0,8.045930862426758,7.795892238616943,3,3
1420,4,4.873614878843492,4.873614878843491,1.0017521727298346,1.0017521727298346,0,0,8.12198257446289,7.795892238616943,4,4
1420,8,4.499226420780198,4.633872662604862,1.010070808475694,1.0081340415253974,1,2,9.356379508972168,7.795892238616943,7,6
1420,16,3.913609880077233,4.444475031413196,1.0136930782773512,1.012520004005602,6,8,10.072977066040039,7.795892238616943,10,8
1420,32,3.2032368477147206,4.21753179795376,1.0135673089823038,1.021184565564014,14,20,10.548884391784668,7.795892238616943,18,12
1420,64,2.682368154101564,4.139556072943586,1.009247243620452,1.0221030338818362,34,51,11.135276794433594,7.795892238616943,30,13
1420,128,1.3182617669671124,4.1332323942550415,1.0028175381948932,1.0231900127193752,57,112,11.870756149291992,7.795892238616943,71,16
1421,1,9.027679084732165,9.027679084732172,0.9521490694968687,0.9521490694968716,0,0,9.138605117797852,9.138605117797852,1,1
1421,2,7.263217528567721,7.263217528567722,0.9929136119423108,0.9929136119423132,0,0,10.10402774810791,9.138605117797852,2,2
1421,3,7.174856623754942,7.174856623754944,0.9947337802167621,0.9947337802167638,0,0,10.399892807006836,9.138605117797852,3,3
1421,4,6.841499632550793,6.841499632550792,1.0006022747592183,1.0006022747592191,0,0,10.44676399230957,9.138605117797852,4,4
1421,8,6.4448286963751595,6.562483625665842,1.0072500983077473,1.005836356020156,1,2,11.360273361206055,9.138605117797852,7,6
1421,16,5.942421497928339,6.280419818410053,1.009601983694412,1.0154920768418685,7,8,12.185602188110352,9.138605117797852,9,8
1421,32,5.125261764990467,6.1590923449781005,1.0105053257157286,1.0221051077252936,18,21,13.111221313476562,9.138605117797852,14,11
1421,64,3.826443607695512,6.127985371105225,1.006748795938013,1.0261458983220189,30,51,14.026992797851562,9.138605117797852,34,13
1421,128,2.428791674058389,6.065312417160489,1.0018570575462302,1.0291265445485025,66,113,14.689133644104004,9.138605117797852,62,15
1422,1,10.341019652063451,10.341019652063453,0.9259306498068084,0.9259306498068097,0,0,10.576680183410645,10.576680183410645,1,1
1422,2,9.312407569477573,9.312407569477575,0.9535029116825012,0.9535029116825012,0,0,10.953869819641113,10.576680183410645,2,2
1422,3,8.17180800892969,8.171808008929691,0.9818968120443899,0.9818968120443908,0,0,11.204575538635254,10.576680183410645,3,3
1422,4,7.878243293042767,7.878243293042768,0.9899765238181638,0.989976523818165,0,0,11.461505889892578,10.576680183410645,4,4
1422,8,6.976255603019539,6.976255603019538,1.0148039766593766,1.0148039766593777,0,0,12.112249374389648,10.576680183410645,8,8
1422,16,6.523736558494598,6.735603564481678,1.023582774503808,1.0235808994724835,4,5,12.646661758422852,10.576680183410645,12,11
1422,32,5.285695459658451,6.685916659041448,1.0159047170060593,1.025728937407142,14,19,13.05660343170166,10.576680183410645,18,13
1422,64,4.50922047795721,6.672886201129998,1.012569864201157,1.027588808751283,31,49,13.858061790466309,10.576680183410645,33,15
1422,128,2.815743766347737,6.5861192585283845,1.0065300127471886,1.0352037655525712,59,111,14.62789249420166,10.576680183410645,69,17
1423,1,7.4236576431149865,7.423657643114987,0.9628640382259632,0.9628640382259636,0,0,7.506962776184082,7.506962776184082,1,1
1423,2,7.039463040823146,7.039463040823146,0.9723421435774667,0.9723421435774668,0,0,8.22751522064209,7.506962776184082,2,2
1423,3,6.834801644983086,6.834801644983085,0.9781163002316057,0.9781163002316046,0,0,8.91760540008545,7.506962776184082,3,3
1423,4,6.129169113288339,6.148796126136641,0.9885450164860308,0.9888583380854752,1,1,9.008378028869629,7.506962776184082,3,3
1423,8,5.869857660642171,5.964656791406037,0.993694293767025,0.9932592462692434,3,3,9.208941459655762,7.506962776184082,5,5
1423,16,5.040396611557332,5.4567310092972034,1.0044253707974393,1.0037103903307754,5,11,9.510497093200684,7.506962776184082,11,5
1423,32,4.20555899759336,5.18040395957018,1.0098784493198498,1.009650388051007,13,22,10.064062118530273,7.506962776184082,19,10
1423,64,3.315918230100381,4.697962081918199,1.0063735434812038,1.0210877716816684,30,52,10.720758438110352,7.506962776184082,34,12
1423,128,1.860828391081077,4.696802363678156,0.9998358378096079,1.0215506150566047,60,112,11.296162605285645,7.506962776184082,68,16
1424,1,2.9702139858815353,2.9702139858815366,0.9952722263777349,0.9952722263777357,0,0,2.973824977874756,2.973824977874756,1,1
1424,2,2.636108776172997,2.636108776172997,0.9980903933434229,0.9980903933434231,0,0,3.6098601818084717,2.973824977874756,2,2
1424,3,2.6312989644192206,2.6312989644192206,0.9981968091138078,0.9981968091138086,0,0,3.8553459644317627,2.973824977874756,3,3
1424,4,2.4736650501514297,2.479802613661072,0.9986577940340315,0.9987343040702584,1,1,3.8857431411743164,2.973824977874756,3,3
1424,8,1.8882824825644402,1.9398650454682134,1.0031289513232344,1.0032421649895746,2,2,3.993816375732422,2.973824977874756,6,6
1424,16,1.5395713831110245,1.65861399485514,1.006880230849975,1.006099551162917,6,6,4.373970985412598,2.973824977874756,10,10
1424,32,1.2392380931989688,1.546801189415742,1.0061899194118582,1.006628597636022,18,19,4.848973274230957,2.973824977874756,14,13
1424,64,0.7408316712213983,1.5402017681025708,1.0025568983963609,1.0067680876989553,30,50,5.2062530517578125,2.973824977874756,34,14
1424,128,0.12607334012929153,1.5228727815945076,1.0001673686979764,1.0073165616280064,65,113,5.573078632354736,2.973824977874756,63,15
1425,1,12.549305516224582,12.54930551622459,0.8938078037460309,0.8938078037460334,0,0,12.944721221923828,12.944721221923828,1,1
1425,2,10.303981604481345,10.30398160448135,0.9659529463980876,0.9659529463980909,0,0,13.137755393981934,12.944721221923828,2,2
1425,3,8.87249220737748,8.872492207377482,1.0006035279519043,1.0006035279519059,0,0,13.333467483520508,12.944721221923828,3,3
1425,4,8.17478865356911,8.17478865356911,1.0152053650214263,1.015205365021427,0,0,13.571329116821289,12.944721221923828,4,4
1425,8,8.011452999319776,8.096280019295627,1.018847482177738,1.017636936039477,2,3,13.698287963867188,12.944721221923828,6,5
1425,16,7.781345201969313,8.096040664379025,1.022106924969756,1.0177250421331003,7,10,14.1096830368042,12.944721221923828,9,6
1425,32,7.15666998892791,7.727848868486687,1.0388090492857511,1.0342039712102506,15,21,14.491939544677734,12.944721221923828,17,11
1425,64,5.883444830541365,7.651897970341882,1.0390849091416365,1.037016804376313,27,51,14.872428894042969,12.944721221923828,37,13
1425,128,3.5488669102926766,7.583291491303424,1.0184557299739314,1.04073511322387,65,114,15.291570663452148,12.944721221923828,63,14
1426,1,8.412054928339378,8.41205492833938,0.9559331894950674,0.9559331894950676,0,0,8.515214920043945,8.515214920043945,1,1
1426,2,7.49327508489111,7.493275084891113,0.9718552346383835,0.9718552346383851,0,0,8.517705917358398,8.515214920043945,2,2
1426,3,6.242309090628145,6.2423090906281455,0.9897321985277031,0.9897321985277039,0,0,8.524519920349121,8.515214920043945,3,3
1426,4,5.677651400925874,5.677651400925875,0.9988642290450622,0.9988642290450622,0,0,8.601984977722168,8.515214920043945,4,4
1426,8,4.985585764028185,5.026104539491532,1.0095833728565815,1.0084126178584056,1,1,9.025764465332031,8.515214920043945,7,7
1426,16,4.775529518892701,4.84573619877381,1.0141925632563216,1.0137075885698532,6,7,9.48932933807373,8.515214920043945,10,9
1426,32,3.8965289540326866,4.558155533976734,1.0208003954060547,1.0227170882122625,12,20,10.049912452697754,8.515214920043945,20,12
1426,64,2.6428293226915134,4.487048745037622,1.0109366055088715,1.0245998789283446,25,50,10.61885929107666,8.515214920043945,39,14
1426,128,1.5637098612835814,4.43383825024454,1.0042721961193481,1.0269127908319184,63,114,11.441266059875488,8.515214920043945,65,14
1427,1,10.198191255784927,10.198191255784936,0.9364754019814354,0.9364754019814383,0,0,10.374651908874512,10.374651908874512,1,1
1427,2,8.700676624895637,8.70067662489564,0.9730164474950522,0.9730164474950544,0,0,10.69837760925293,10.374651908874512,2,2
1427,3,8.23750942521639,8.23750942521639,0.987234180458572,0.9872341804585727,0,0,11.358674049377441,10.374651908874512,3,3
1427,4,7.994563272841102,7.994563272841103,0.9910685980108227,0.9910685980108238,0,0,11.392904281616211,10.374651908874512,4,4
1427,8,7.66712012832273,7.667120128322729,1.004470772907732,1.0044707729077358,0,0,12.53332805633545,10.374651908874512,8,8
1427,16,6.731985993339053,6.973124201644259,1.031343288459517,1.0263161048566827,6,5,12.921886444091797,10.374651908874512,10,11
1427,32,5.780435674741434,6.7256894806462695,1.0344799580518935,1.035973133493243,14,19,13.503301620483398,10.374651908874512,18,13
1427,64,4.599691097843138,6.673299899040625,1.02486304305867,1.0393360326732464,30,45,14.526640892028809,10.374651908874512,34,19
1427,128,3.3068779134196093,6.618764201120589,1.0119133028010971,1.0438934777635778,69,107,15.325980186462402,10.374651908874512,59,21
1428,1,6.310150050702713,6.310150050702718,0.9802562087074282,0.9802562087074307,0,0,6.338332176208496,6.338332176208496,1,1
1428,2,5.535827660254565,5.535827660254567,0.9931096258086018,0.9931096258086036,0,0,7.793472766876221,6.338332176208496,2,2
1428,3,5.533453110355103,5.533453110355103,0.993426628608117,0.9934266286081186,0,0,8.189659118652344,6.338332176208496,3,3
1428,4,5.288221075722777,5.288474315412682,0.9994284950385601,0.9995039423472887,1,1,8.373625755310059,6.338332176208496,3,3
1428,8,4.813176727485573,4.883801460527259,1.0071646571587611,1.0081633815844993,2,2,9.044386863708496,6.338332176208496,6,6
1428,16,4.220433846154141,4.561221420433855,1.0139645254470426,1.015253976243568,6,9,9.728907585144043,6.338332176208496,10,7
1428,32,3.6029917887745064,4.5066802181454415,1.0161662673704481,1.0197658617779806,12,18,10.309782028198242,6.338332176208496,20,14
1428,64,2.6263094892539947,4.469687825769349,1.0073623415645077,1.0211447932963293,29,47,10.827953338623047,6.338332176208496,35,17
1428,128,1.1020766592963385,4.422930685731175,1.0016547682385375,1.025025481312371,56,110,11.502867698669434,6.338332176208496,72,18
1429,1,6.668423590014608,6.6684235900146085,0.9747434346252939,0.9747434346252942,0,0,6.711368560791016,6.711368560791016,1,1
1429,2,6.270493254401173,6.270493254401173,0.9825444111965116,0.9825444111965116,0,0,7.502183437347412,6.711368560791016,2,2
1429,3,6.050531898297401,6.050531898297401,0.9871365441200394,0.9871365441200394,0,0,7.8077712059021,6.711368560791016,3,3
1429,4,5.766729867437066,5.766729867437066,0.9925339267355745,0.9925339267355753,0,0,8.357396125793457,6.711368560791016,4,4
1429,8,5.202614342304647,5.37068666497265,0.9978444087370051,1.0010927865294634,1,4,8.821051597595215,6.711368560791016,7,4
1429,16,4.243489377393722,4.959408296223318,1.0048584172074357,1.0086029131885523,6,10,9.032401084899902,6.711368560791016,10,6
1429,32,3.64012746014512,4.733267852715294,1.008548469604266,1.0141476164566177,12,22,9.57158088684082,6.711368560791016,20,10
1429,64,2.638460104584934,4.643832762111106,1.004496375033069,1.017769748342708,30,50,10.28238582611084,6.711368560791016,34,14
1429,128,1.3323619750273668,4.574612189563621,1.0002213512313194,1.0211697262315038,61,112,11.135479927062988,6.711368560791016,67,16
1430,1,2.8797581486984076,2.879758148698409,0.9928257545492213,0.9928257545492224,0,0,2.8883819580078125,2.8883819580078125,1,1
1430,2,2.473176549263443,2.4731765492634437,0.9961281914903402,0.9961281914903408,0,0,3.0699148178100586,2.8883819580078125,2,2
1430,3,2.240849131407259,2.2408491314072605,0.997279494997679,0.9972794949976802,0,0,3.228240966796875,2.8883819580078125,3,3
1430,4,2.220678364425711,2.220678364425711,0.9973249229457911,0.9973249229457919,0,0,3.253269672393799,2.8883819580078125,4,4
1430,8,2.1578216980425613,2.169709134577659,0.9978919402295198,0.9982031752991047,2,2,3.536358118057251,2.8883819580078125,6,6
1430,16,1.6131365553148265,1.8604472801861975,0.9997841182339879,1.0003766429311478,6,7,3.823094367980957,2.8883819580078125,10,9
1430,32,1.0339516209082396,1.7141540828997535,1.0009403411058706,1.0021580013963995,12,24,4.334131717681885,2.8883819580078125,20,8
1430,64,0.46698178860896006,1.630754258532163,1.0011353763412298,1.004140813362644,31,51,4.582549095153809,2.8883819580078125,33,13
1430,128,0.02737992761724089,1.5365711216030198,1.0000064125491588,1.0052830426070167,67,115,5.0030598640441895,2.8883819580078125,61,13
1431,1,6.994570665901094,6.994570665901096,0.9656570848777698,0.9656570848777715,0,0,7.0710129737854,7.0710129737854,1,1
1431,2,5.682985573675341,5.682985573675343,0.991557179113723,0.991557179113725,0,0,8.195524215698242,7.0710129737854,2,2
1431,3,5.659582871140742,5.659582871140744,0.9927598023640883,0.9927598023640909,0,0,8.99556827545166,7.0710129737854,3,3
1431,4,5.324935277340419,5.397670465341518,1.0012826730378004,1.0002286936561222,1,1,9.306188583374023,7.0710129737854,3,3
1431,8,4.964327300363258,5.0455364671367136,1.008707432239702,1.008190285534906,3,2,9.83023452758789,7.0710129737854,5,6
1431,16,4.600526648024491,4.778767393610989,1.01319168788856,1.0143795109897211,6,8,11.134058952331543,7.0710129737854,10,8
1431,32,3.5992027684689023,4.680041647806384,1.008255047807262,1.020122162346594,14,23,12.193556785583496,7.0710129737854,18,9
1431,64,2.6644694408592207,4.629869241446922,1.0034688781429415,1.0240276508744552,32,53,13.237467765808105,7.0710129737854,32,11
1431,128,1.626287309516524,4.610260617260914,1.001330579681643,1.0255929126760401,64,116,14.122054100036621,7.0710129737854,64,12
1432,1,8.509907607128447,8.509907607128444,0.9567571786538677,0.9567571786538694,0,0,8.606678009033203,8.606678009033203,1,1
1432,2,6.989799701646817,6.989799701646818,0.9841575370362263,0.9841575370362283,0,0,9.3001127243042,8.606678009033203,2,2
1432,3,6.461960563304749,6.461960563304751,0.9936123049643877,0.9936123049643895,0,0,9.394160270690918,8.606678009033203,3,3
1432,4,5.9780384310514165,5.978038431051417,1.0037901397577123,1.003790139757714,0,0,9.521772384643555,8.606678009033203,4,4
1432,8,5.73567445864274,5.751150779383027,1.0095958623341597,1.0099908966195448,2,2,10.204206466674805,8.606678009033203,6,6
1432,16,5.149339628345695,5.454026155347503,1.0220004814531778,1.019796602797527,4,5,10.693758010864258,8.606678009033203,12,11
1432,32,4.590990861378635,5.217198206307266,1.0274292332038335,1.0286746544736993,14,14,11.353572845458984,8.606678009033203,18,18
1432,64,3.4974002048618655,5.216942586255822,1.0140977499194062,1.0288002541689112,32,44,12.279940605163574,8.606678009033203,32,20
1432,128,2.1757163077881696,5.087026700806826,1.0011053840100241,1.033927701960152,61,108,13.603254318237305,8.606678009033203,67,20
1433,1,10.062947763614929,10.062947763614932,0.9453042352098064,0.9453042352098081,0,0,10.197450637817383,10.197450637817383,1,1
1433,2,9.282881179761905,9.282881179761906,0.9642468607672595,0.9642468607672603,0,0,10.263340950012207,10.197450637817383,2,2
1433,3,8.059346034090229,8.059346034090229,0.9837321588474341,0.9837321588474346,0,0,10.700185775756836,10.197450637817383,3,3
1433,4,7.8476371720578,7.847637172057802,0.9864527294155361,0.9864527294155383,0,0,10.711999893188477,10.197450637817383,4,4
1433,8,6.87620927899477,6.876209278994769,1.0097928285847064,1.0097928285847089,0,0,11.113935470581055,10.197450637817383,8,8
1433,16,6.492660986263821,6.667188913118601,1.0174515527891186,1.0168729027566585,6,6,11.581369400024414,10.197450637817383,10,10
1433,32,5.905757982397715,6.329058576224246,1.02490095686286,1.0258591823229426,8,18,12.006650924682617,10.197450637817383,24,14
1433,64,4.1838411957540265,6.278663176909345,1.014488762462348,1.0286410733277762,29,49,12.397801399230957,10.197450637817383,35,15
1433,128,1.9917473491386655,6.216652494678207,1.0038369711006228,1.0318958398426519,62,113,12.783341407775879,10.197450637817383,66,15
1434,1,3.4069204773432,3.406920477343201,0.9939885275555461,0.9939885275555476,0,0,3.411980152130127,3.411980152130127,1,1
1434,2,2.9150566546265306,2.915056654626531,0.9971257513209695,0.9971257513209704,0,0,3.421354293823242,3.411980152130127,2,2
1434,3,2.8610306083347212,2.8610306083347217,0.9974531822498691,0.9974531822498702,0,0,3.7387099266052246,3.411980152130127,3,3
1434,4,2.281506122086745,2.3064348315160683,1.0010609134034247,1.0008741483075965,2,2,3.9642231464385986,3.411980152130127,2,2
1434,8,1.9765622599658537,2.174298961827709,1.0018580794538414,1.0014731143385571,3,4,4.289472579956055,3.411980152130127,5,4
1434,16,1.7864891206078375,2.1030761764901365,1.0037871693502896,1.002891591349711,6,8,4.627050876617432,3.411980152130127,10,8
1434,32,1.3415673376186128,1.7877281673354715,1.004628372414707,1.006415825127457,15,23,5.1067657470703125,3.411980152130127,17,9
1434,64,0.7021636662604749,1.7804459978755292,1.0010481348602798,1.0068386848663475,33,52,5.45069694519043,3.411980152130127,31,12
1434,128,0.05734223473197891,1.7804459978755292,0.9999650729944416,1.0068386848663475,59,116,5.89818000793457,3.411980152130127,69,12
1435,1,5.580563636656311,5.5805636366563105,0.978640530787015,0.9786405307870145,0,0,5.6179704666137695,5.6179704666137695,1,1
1435,2,4.96147784118352,4.961477841183519,0.988637481766307,0.9886374817663055,0,0,6.229108810424805,5.6179704666137695,2,2
1435,3,4.674682060117633,4.674682060117635,0.9918435344068619,0.991843534406861,0,0,6.359311580657959,5.6179704666137695,3,3
1435,4,4.571397552632693,4.571397552632691,0.9945487093067125,0.9945487093067109,0,0,6.923142433166504,5.6179704666137695,4,4
1435,8,3.83114132208866,4.080200535159492,1.0011266575035556,1.0032225782732123,3,3,7.983023643493652,5.6179704666137695,5,5
1435,16,3.49271904256787,4.063126247601652,1.0041571574554737,1.0046400926575545,6,9,8.982645034790039,5.6179704666137695,10,7
1435,32,2.9868446462240836,3.9636537395565634,1.005631042047773,1.0092840174569133,15,24,9.836297035217285,5.6179704666137695,17,8
1435,64,2.2973457937917208,3.9414056550272902,1.0011895935119068,1.0111489316586477,33,54,10.410816192626953,5.6179704666137695,31,10
1435,128,1.291693626448928,3.910525649932806,1.0004899912321612,1.0133493214028486,57,116,11.287757873535156,5.6179704666137695,71,12
1436,1,7.581522316327841,7.581522316327843,0.9690839077450222,0.9690839077450234,0,0,7.639933109283447,7.639933109283447,1,1
1436,2,6.843523818899219,6.843523818899221,0.982985498404909,0.9829854984049093,0,0,7.656484603881836,7.639933109283447,2,2
1436,3,6.194572996203455,6.194572996203455,0.9965714972979549,0.9965714972979545,0,0,8.334874153137207,7.639933109283447,3,3
1436,4,5.396836196516183,5.400309711785597,1.0071569556181845,1.0072931803211818,1,1,8.4576416015625,7.639933109283447,3,3
1436,8,5.0286654485099005,5.080145441225371,1.0165258131901944,1.0162570947316611,1,1,9.262335777282715,7.639933109283447,7,7
1436,16,4.49760604115047,4.7282302904468025,1.0238557731369244,1.0231477040367098,4,6,9.812292098999023,7.639933109283447,12,10
1436,32,3.698557727943931,4.435579612463925,1.0229151505963725,1.0305049568852165,11,20,10.606772422790527,7.639933109283447,21,12
1436,64,2.607134506707647,4.345742411347565,1.011885843395291,1.0345862413029636,29,47,11.490731239318848,7.639933109283447,35,17
1436,128,1.473461454991953,4.329916274611227,1.0016894398692209,1.0354623624840014,62,109,12.307793617248535,7.639933109283447,66,19
1437,1,6.494605266469699,6.494605266469699,0.9780555068917478,0.9780555068917477,0,0,6.528735637664795,6.528735637664795,1,1
1437,2,5.933092197717326,5.933092197717326,0.9874771797480864,0.9874771797480859,0,0,7.804310321807861,6.528735637664795,2,2
1437,3,5.5838744582796345,5.583874458279634,0.9922118534714679,0.9922118534714675,0,0,7.889777660369873,6.528735637664795,3,3
1437,4,4.976079848754743,4.976079848754743,1.0034791734235726,1.003479173423572,0,0,8.210563659667969,6.528735637664795,4,4
1437,8,4.814451609074401,4.831390204756562,1.006046327072813,1.006178892582512,2,2,9.033751487731934,6.528735637664795,6,6
1437,16,4.22385913293706,4.450699435170369,1.0157286245587434,1.0172891870693108,6,7,9.717365264892578,6.528735637664795,10,9
1437,32,3.704036383918235,4.407785511165475,1.0131141454305146,1.0198213437137889,14,21,10.244653701782227,6.528735637664795,18,11
1437,64,2.776144999764831,4.380794864074526,1.0059717789085014,1.0209178543472914,29,52,10.873899459838867,6.528735637664795,35,12
1437,128,1.4464363658908777,4.380215381393992,1.0031609047239667,1.0211767130621912,61,115,11.53266716003418,6.528735637664795,67,13
1438,1,8.039697512293689,8.039697512293673,0.9457480654398432,0.9457480654398468,0,0,8.198692321777344,8.198692321777344,1,1
1438,2,7.8694727126186645,7.869472712618672,0.9505164586722137,0.9505164586722163,0,0,9.812400817871094,8.198692321777344,2,2
1438,3,7.362860062266527,7.362860062266529,0.9643536116128865,0.9643536116128888,0,0,9.903664588928223,8.198692321777344,3,3
1438,4,6.756861923264328,6.761544347137368,0.9746467867822193,0.9746263981517984,1,1,10.001847267150879,8.198692321777344,3,3
1438,8,6.039475550130813,6.384157062769539,0.985283320066703,0.9853845484447261,3,3,10.510440826416016,8.198692321777344,5,5
1438,16,5.836919584746831,6.354472815707722,0.9873605969364339,0.9868925760414196,6,9,10.805861473083496,8.198692321777344,10,7
1438,32,5.369013164793019,6.303172235485582,0.9984244526373363,0.9891252836948526,11,23,11.455084800720215,8.198692321777344,21,9
1438,64,4.095396409002837,6.003374011965875,0.9994294549676599,1.0007037915953192,30,52,12.116924285888672,8.198692321777344,34,12
1438,128,3.052329226063362,5.9214528486224545,1.0054904951767432,1.00331499105187,67,115,12.613873481750488,8.198692321777344,61,13
1439,1,3.9175722350656943,3.9175722350656956,0.9883983730926729,0.9883983730926738,0,0,3.9336626529693604,3.9336626529693604,1,1
1439,2,2.667750276710384,2.667750276710384,1.0010002460772551,1.0010002460772558,0,0,5.125418186187744,3.9336626529693604,2,2
1439,3,2.5738918197598033,2.5738918197598033,1.0031559143098054,1.003155914309805,0,0,6.390172481536865,3.9336626529693604,3,3
1439,4,2.4716974351782164,2.4716974351782155,1.0049521641017514,1.0049521641017516,0,0,6.755216121673584,3.9336626529693604,4,4
1439,8,2.3998772370819643,2.402565054651534,1.0060845731836963,1.0062194198367687,2,2,7.294793128967285,3.9336626529693604,6,6
1439,16,2.1869396711229507,2.3596371655111157,1.006784314075384,1.00800246519695,5,7,7.913786888122559,3.9336626529693604,11,9
1439,32,1.7628514020118737,2.2910135600788712,1.0035049906969333,1.0095948464402458,15,23,8.368914604187012,3.9336626529693604,17,9
1439,64,1.1957556546148098,2.264729457123304,1.002672171845564,1.010076625439503,35,52,8.941951751708984,3.9336626529693604,29,12
1439,128,0.6216839796598775,2.242682342825306,1.001026458860851,1.0113392574699618,62,118,9.679605484008789,3.9336626529693604,66,10
1440,1,9.162093651003836,9.162093651003838,0.9499012843027647,0.9499012843027662,0,0,9.286393165588379,9.286393165588379,1,1
1440,2,7.580007446339993,7.5800074463399945,0.9872291145507943,0.9872291145507964,0,0,9.926407814025879,9.286393165588379,2,2
1440,3,6.622047248271009,6.6220472482710075,1.0054135731442573,1.0054135731442593,0,0,9.970307350158691,9.286393165588379,3,3
1440,4,6.615581276038692,6.615581276038692,1.006017380873444,1.0060173808734458,0,0,10.08640193939209,9.286393165588379,4,4
1440,8,6.0563835433911875,6.0574137047299725,1.0165636558375288,1.0167586490222176,1,1,10.541704177856445,9.286393165588379,7,7
1440,16,5.213598327870856,5.60301792227578,1.0263137595569636,1.0263625274605925,4,5,11.000602722167969,9.286393165588379,12,11
1440,32,4.738010257675602,5.328580905378622,1.0310866376840035,1.0331478718143416,12,18,11.209506034851074,9.286393165588379,20,14
1440,64,3.9216442149645023,5.206125582628771,1.027468727956894,1.0361447081201518,28,45,11.515236854553223,9.286393165588379,36,19
1440,128,2.9017649407041377,4.988764758347736,1.018983438227642,1.0386072328704397,63,109,11.981518745422363,9.286393165588379,65,19
1441,1,8.779490538480434,8.779490538480436,0.9518070595166106,0.9518070595166134,0,0,8.895724296569824,8.895724296569824,1,1
1441,2,8.252880997968573,8.252880997968555,0.9723605988659523,0.9723605988659545,0,0,11.072263717651367,8.895724296569824,2,2
1441,3,8.220292160877099,8.220292160877099,0.9757648121406771,0.975764812140679,0,0,11.370390892028809,8.895724296569824,3,3
1441,4,8.211394186589784,8.220292160877099,0.9750615431042778,0.975764812140679,1,1,11.481136322021484,8.895724296569824,3,3
1441,8,7.160100214672407,7.316610235505215,1.0001937802724394,1.0011781001021172,3,3,11.851592063903809,8.895724296569824,5,5
1441,16,6.456857074645843,6.9803266775951505,1.0061761955100224,1.0132262925716504,6,10,12.789453506469727,8.895724296569824,10,6
1441,32,5.778289325578315,6.818100826816279,1.0187563626286535,1.0238946678252572,13,20,13.163263320922852,8.895724296569824,19,12
1441,64,4.328116356742218,6.430293854023168,1.0121897901051695,1.030981021505418,24,50,13.720819473266602,8.895724296569824,40,14
1441,128,2.898613155820002,6.262915292495626,1.0113922400109168,1.0384454148211248,57,112,14.188733100891113,8.895724296569824,71,16
1442,1,7.6171380512534945,7.617138051253486,0.9665086635851596,0.9665086635851631,0,0,7.682525157928467,7.682525157928467,1,1
1442,2,6.325158608040817,6.325158608040818,0.9857693972295716,0.9857693972295725,0,0,7.753077983856201,7.682525157928467,2,2
1442,3,5.298348694805682,5.298348694805681,0.9992533188706172,0.9992533188706184,0,0,8.122057914733887,7.682525157928467,3,3
1442,4,4.976667719956658,4.976667719956658,1.0035094865385101,1.0035094865385117,0,0,8.278932571411133,7.682525157928467,4,4
1442,8,4.407024849218787,4.4183895679333665,1.009657476367531,1.0101241863422157,1,1,8.922683715820312,7.682525157928467,7,7
1442,16,4.222002288099972,4.316168859660665,1.014066518982239,1.0142276034074689,2,3,9.27088737487793,7.682525157928467,14,13
1442,32,3.761622369156901,4.067896885643195,1.0142713026834553,1.0203864477232873,13,18,9.938210487365723,7.682525157928467,19,14
1442,64,2.6819671647697207,3.998061818252757,1.0118912640153357,1.0237458187989612,30,46,10.496541023254395,7.682525157928467,34,18
1442,128,1.6726253538747633,3.998061818252757,1.0052614096990122,1.0237458187989612,66,110,11.082829475402832,7.682525157928467,62,18
1443,1,7.697030579279744,7.697030579279747,0.9666899225867238,0.9666899225867253,0,0,7.7593488693237305,7.7593488693237305,1,1
1443,2,6.2253482954804555,6.225348295480455,0.9915695249985408,0.9915695249985413,0,0,8.367940902709961,7.7593488693237305,2,2
1443,3,5.557693316793273,5.557693316793274,1.0010327903065637,1.0010327903065634,0,0,8.49245548248291,7.7593488693237305,3,3
1443,4,5.4421534323549485,5.442153432354948,1.0027290342528505,1.00272903425285,0,0,8.61437702178955,7.7593488693237305,4,4
1443,8,4.474440164700616,4.477532533772374,1.0177411889235206,1.0177560896251603,1,1,8.877510070800781,7.7593488693237305,7,7
1443,16,4.1905295562711276,4.265943447277931,1.0226204386079316,1.0225087821108876,3,5,9.468823432922363,7.7593488693237305,13,11
1443,32,3.8873567695049824,4.237924507502297,1.0227404757210796,1.0242004177691857,12,16,10.138955116271973,7.7593488693237305,20,16
1443,64,2.7665213142321257,4.201662123044564,1.007292622794361,1.0263032860269572,29,45,10.959423065185547,7.7593488693237305,35,19
1443,128,1.499709757067299,4.188504106388988,1.0024447058112758,1.0281469588346421,64,107,11.704073905944824,7.7593488693237305,64,21
1444,1,12.14853666977332,12.14853666977332,0.9245755071786087,0.92457550717861,0,0,12.351900100708008,12.351900100708008,1,1
1444,2,10.316283565714418,10.316283565714418,0.9868269084142125,0.9868269084142123,0,0,14.53709888458252,12.351900100708008,2,2
1444,3,9.394882787552326,9.394882787552326,1.0142121124392105,1.0142121124392103,0,0,14.592325210571289,12.351900100708008,3,3
1444,4,9.344701189209962,9.344701189209964,1.016641340241513,1.0166413402415135,0,0,14.720405578613281,12.351900100708008,4,4
1444,8,9.03209894021667,9.2193741232868,1.0170131646346576,1.020876218633666,2,3,15.771395683288574,12.351900100708008,6,5
1444,16,8.63893128271694,9.156282319412878,1.0218676824199455,1.0275981672311674,5,9,16.404659271240234,12.351900100708008,11,7
1444,32,7.250914299095338,8.655695382046336,1.036744368040015,1.0472790554009257,14,23,17.018558502197266,12.351900100708008,18,9
1444,64,4.987725191612256,8.541933236628365,1.0177257900782561,1.055564847294527,30,53,17.6629695892334,12.351900100708008,34,11
1444,128,3.385491024098242,8.498376246041289,1.0183947068964034,1.059910858365999,57,111,18.277198791503906,12.351900100708008,71,17
1445,1,6.949625826032968,6.94962582603297,0.9665107323016597,0.9665107323016608,0,0,7.0199971199035645,7.0199971199035645,1,1
1445,2,5.909617707872985,5.909617707872984,0.9837037968868432,0.9837037968868427,0,0,7.203489303588867,7.0199971199035645,2,2
1445,3,5.706875826984254,5.706875826984254,0.9849963871066661,0.9849963871066658,0,0,7.246454238891602,7.0199971199035645,3,3
1445,4,5.456862769793812,5.456862769793811,0.9898783799505981,0.9898783799505981,0,0,7.80838680267334,7.0199971199035645,4,4
1445,8,5.056111599661853,5.227733722764379,0.9939875127424533,0.9945620453608259,2,3,8.659064292907715,7.0199971199035645,6,5
1445,16,4.959814502960206,5.164466769375611,0.9976106089144574,0.998005555192644,5,10,9.389182090759277,7.0199971199035645,11,6
1445,32,4.34725075045686,5.064338666930834,1.0046916983041099,1.0034112383167955,14,22,9.88868236541748,7.0199971199035645,18,10
1445,64,3.3093800397172366,4.903755811829825,1.0039887233828269,1.01133710985762,28,50,10.654364585876465,7.0199971199035645,36,14
1445,128,1.8043509692848165,4.7470748802656715,1.002741886992128,1.0175462545151115,66,114,11.513631820678711,7.0199971199035645,62,14
1446,1,9.309697426105446,9.309697426105455,0.9505232240346171,0.9505232240346201,0,0,9.426046371459961,9.426046371459961,1,1
1446,2,6.928524988714926,6.928524988714927,0.9936227732170375,0.9936227732170384,0,0,9.53382682800293,9.426046371459961,2,2
1446,3,6.739532977864879,6.739532977864879,0.9976572253024039,0.9976572253024044,0,0,9.895930290222168,9.426046371459961,3,3
1446,4,6.698732959099069,6.739532977864879,0.9979585383502423,0.9976572253024044,1,1,10.185205459594727,9.426046371459961,3,3
1446,8,6.028200994563402,6.083066351632204,1.013499644191668,1.0132131269624263,2,2,10.69852352142334,9.426046371459961,6,6
1446,16,5.301790038928402,5.818851150655144,1.0241117011334526,1.0210094598536203,6,7,11.131509780883789,9.426046371459961,10,9
1446,32,4.763658147251484,5.501995153672312,1.0273042701751596,1.0295467670686467,15,20,11.922788619995117,9.426046371459961,17,12
1446,64,3.496971947077489,5.315764458333653,1.0109238736606914,1.0373751592420406,31,51,12.766555786132812,9.426046371459961,33,13
1446,128,2.4251864509399605,5.275092488845143,1.005955835307737,1.0423083417764025,58,110,13.685396194458008,9.426046371459961,70,18
1447,1,9.121065095990039,9.121065095990042,0.9451853638120024,0.9451853638120035,0,0,9.268766403198242,9.268766403198242,1,1
1447,2,8.09598051964402,8.095980519644025,0.9659237753168024,0.9659237753168042,0,0,9.456714630126953,9.268766403198242,2,2
1447,3,7.482296314152456,7.482296314152441,0.9786734189115441,0.9786734189115447,0,0,9.824459075927734,9.268766403198242,3,3
1447,4,6.876624867043813,6.876624867043801,0.9923978426241992,0.9923978426242002,0,0,9.888014793395996,9.268766403198242,4,4
1447,8,5.872386816586242,5.875060823991307,1.0125001415495365,1.0124644629430022,1,1,10.409083366394043,9.268766403198242,7,7
1447,16,5.489914080434346,5.759566838890421,1.0216265506378974,1.0166933844052877,2,5,10.902294158935547,9.268766403198242,14,11
1447,32,4.791830767403843,5.734634665643053,1.0121658099426925,1.018976949395475,15,20,11.602127075195312,9.268766403198242,17,12
1447,64,3.758513445695814,5.710835626907787,1.0080693327693684,1.0209771654390258,30,49,12.0155611038208,9.268766403198242,34,15
1447,128,2.513914926388143,5.681082520814255,1.0030293703421862,1.022877230564879,63,111,12.546258926391602,9.268766403198242,65,17
1448,1,2.3357022728930663,2.3357022728930663,0.9970296260693834,0.9970296260693835,0,0,2.3375015258789062,2.3375015258789062,1,1
1448,2,2.083651824278545,2.0836518242785447,0.9988149195829299,0.9988149195829301,0,0,2.581393003463745,2.3375015258789062,2,2
1448,3,1.7920350243870262,1.7920350243870262,1.0005309580031336,1.0005309580031334,0,0,2.5897746086120605,2.3375015258789062,3,3
1448,4,1.65749385637765,1.6574938563776502,1.0009853346162718,1.0009853346162716,0,0,2.6274287700653076,2.3375015258789062,4,4
1448,8,1.2990947372655708,1.3053057529857315,1.0021598006446797,1.0020605569693175,2,3,2.7899787425994873,2.3375015258789062,6,5
1448,16,1.0998456180447544,1.171521685863962,1.0019514010520716,1.0024595082057455,8,7,3.1287171840667725,2.3375015258789062,8,9
1448,32,0.6999592818776615,1.1354289305091594,1.0012251006437178,1.0027152549027045,16,20,3.4209864139556885,2.3375015258789062,16,12
1448,64,0.37358098026083003,1.050623445975108,1.0003654915097813,1.003579626317542,29,46,3.890040636062622,2.3375015258789062,35,18
1448,128,0.027845638860015245,1.0342706051035573,1.0000203186706027,1.003996058524137,61,110,4.381543159484863,2.3375015258789062,67,18
1449,1,6.037150203812769,6.037150203812768,0.9826571761745121,0.9826571761745114,0,0,6.059636116027832,6.059636116027832,1,1
1449,2,5.575567442295673,5.5755674422956725,0.9901186632344715,0.9901186632344708,0,0,7.04502010345459,6.059636116027832,2,2
1449,3,5.356654149009293,5.356654149009293,0.9946165586438867,0.9946165586438857,0,0,7.363658428192139,6.059636116027832,3,3
1449,4,4.9238917792383985,4.923891779238398,0.9973262760159379,0.9973262760159367,0,0,7.405468940734863,6.059636116027832,4,4
1449,8,4.517314843780741,4.606224464380231,1.0053223741119006,1.0039501746512385,2,2,7.883406162261963,6.059636116027832,6,6
1449,16,3.5610792115386567,3.8469936208539135,1.0169058363792298,1.015966089970599,3,7,8.455625534057617,6.059636116027832,13,9
1449,32,3.1802676918293056,3.4788128065532327,1.0174447820376846,1.0224780793253534,13,19,9.312660217285156,6.059636116027832,19,13
1449,64,2.0694496796451185,3.4435943425447015,1.0072363626591438,1.0243706692920378,25,52,10.104597091674805,6.059636116027832,39,12
1449,128,0.8778781014533295,3.4424091704170485,1.0004470769837073,1.0245652647455707,63,114,10.984274864196777,6.059636116027832,65,14
1450,1,9.488611217166175,9.488611217166179,0.9455498150343415,0.9455498150343454,0,0,9.624249458312988,9.624249458312988,1,1
1450,2,7.705259603862168,7.705259603862169,0.9865330500459157,0.9865330500459172,0,0,10.387980461120605,9.624249458312988,2,2
1450,3,7.0189061375060895,7.01890613750609,1.001344152537615,1.0013441525376159,0,0,10.525518417358398,9.624249458312988,3,3
1450,4,6.920952292323148,6.920952292323147,1.0034444812657246,1.0034444812657257,0,0,10.96289348602295,9.624249458312988,4,4
1450,8,6.337320469183048,6.337320469183046,1.022809375316448,1.0228093753164516,0,0,11.839211463928223,9.624249458312988,8,8
1450,16,5.904690374757819,6.154962435737524,1.0248133910179196,1.0300704304421222,5,5,12.792783737182617,9.624249458312988,11,11
1450,32,5.197104193943571,5.854683452112289,1.0221563092844972,1.0406035161380554,16,19,13.53056812286377,9.624249458312988,16,13
1450,64,3.876391994202217,5.837455941130709,1.0134498770855933,1.0416632722568724,27,48,14.519194602966309,9.624249458312988,37,16
1450,128,2.3242493335960623,5.792066375137188,1.0078327644672487,1.0464418770289603,66,112,15.509345054626465,9.624249458312988,62,16
1451,1,8.998387607476449,8.998387607476452,0.9578957886402927,0.9578957886402935,0,0,9.086944580078125,9.086944580078125,1,1
1451,2,7.237848162924834,7.237848162924833,0.9916673277450115,0.9916673277450101,0,0,9.366531372070312,9.086944580078125,2,2
1451,3,5.834595945701342,5.834595945701342,1.0151175010829505,1.0151175010829512,0,0,9.428608894348145,9.086944580078125,3,3
1451,4,5.789855178452958,5.7898551784529575,1.0162465780926835,1.016246578092684,0,0,9.498407363891602,9.086944580078125,4,4
1451,8,5.41885915785222,5.419064129577159,1.0229134677942893,1.0229804882165316,1,1,10.058916091918945,9.086944580078125,7,7
1451,16,5.217639860576025,5.242159951270821,1.027934228369637,1.028083059079579,5,5,10.717439651489258,9.086944580078125,11,11
1451,32,4.632490350423556,4.997788201847145,1.037808032770318,1.0376220839684809,11,17,11.521427154541016,9.086944580078125,21,15
1451,64,3.552600710732847,4.928356137215529,1.026765285318843,1.0412063173392747,29,43,12.326658248901367,9.086944580078125,35,21
1451,128,2.112017273848034,4.923743781782616,1.0069811003625575,1.0421098203700296,65,105,13.12819766998291,9.086944580078125,63,23
1452,1,5.83661168304704,5.83661168304704,0.9765172918126581,0.9765172918126592,0,0,5.879655838012695,5.879655838012695,1,1
1452,2,5.480028422929289,5.48002842292929,0.9831353431229708,0.9831353431229716,0,0,6.35852575302124,5.879655838012695,2,2
1452,3,5.082153628583446,5.0821536285834465,0.9876130288783296,0.9876130288783298,0,0,6.476883411407471,5.879655838012695,3,3
1452,4,4.554352937798367,4.554352937798367,0.9963282275433545,0.9963282275433545,0,0,6.607165813446045,5.879655838012695,4,4
1452,8,3.443618008716996,3.4976148610632496,1.0081262072692954,1.00844876609781,3,3,7.077340126037598,5.879655838012695,5,5
1452,16,3.284464017715077,3.493810269271215,1.0077108434921946,1.008714771339899,8,9,7.471721649169922,5.879655838012695,8,7
1452,32,2.9448575773054766,3.3779735622731275,1.0130204042113211,1.012468745502776,13,20,7.914641857147217,5.879655838012695,19,12
1452,64,2.2921046276095844,3.3481984741424577,1.0059660407569657,1.0152639217201904,32,44,8.701066017150879,5.879655838012695,32,20
1452,128,0.9929851540289445,3.3011027595383178,1.0010971653850465,1.0174737571885983,59,107,9.519827842712402,5.879655838012695,69,21
1453,1,6.744836307575052,6.744836307575052,0.9675401048784972,0.9675401048784968,0,0,6.817411422729492,6.817411422729492,1,1
1453,2,6.3843972321233275,6.384397232123325,0.9763294455815223,0.9763294455815211,0,0,7.073739528656006,6.817411422729492,2,2
1453,3,5.481434166442985,5.481434166442985,0.9941933733569173,0.9941933733569165,0,0,7.376615524291992,6.817411422729492,3,3
1453,4,5.273786377070941,5.300679776251786,1.0008098411301591,0.9985885537583269,1,1,7.975401878356934,6.817411422729492,3,3
1453,8,4.050493935149392,4.26235796109808,1.0118142395395164,1.015909906125502,1,1,8.618844985961914,6.817411422729492,7,7
1453,16,3.853041619003601,4.150034021017326,1.0130473027850722,1.0177889533710527,4,8,9.533921241760254,6.817411422729492,12,8
1453,32,3.270682979236848,4.0967002230649525,1.0133439649560545,1.019418382502017,11,21,10.018546104431152,6.817411422729492,21,11
1453,64,2.471445989090172,4.017238099221107,1.010218015536168,1.0221003095298198,33,53,10.629217147827148,6.817411422729492,31,11
1453,128,1.102479876339615,4.011007292420449,1.0022770938190315,1.022604236490138,60,114,11.233596801757812,6.817411422729492,68,14
1454,1,9.030141409494119,9.030141409494119,0.9589277600898872,0.9589277600898877,0,0,9.110601425170898,9.110601425170898,1,1
1454,2,8.229650543722249,8.22965054372225,0.9776602804087045,0.9776602804087047,0,0,9.767568588256836,9.110601425170898,2,2
1454,3,7.25983043044878,7.25983043044878,0.9938423420112077,0.9938423420112075,0,0,10.084417343139648,9.110601425170898,3,3
1454,4,7.0003811544668215,7.000381154466821,0.9998420759206699,0.9998420759206691,0,0,10.115379333496094,9.110601425170898,4,4
1454,8,6.094941669346439,6.145962865508359,1.018090715698665,1.016366750465289,1,1,10.798694610595703,9.110601425170898,7,7
1454,16,5.430937717206729,5.964328571958696,1.0202034701192138,1.0208211085734935,4,8,11.502151489257812,9.110601425170898,12,8
1454,32,4.303410491541547,5.714604009795088,1.0240553839007542,1.028919255244729,16,21,12.149712562561035,9.110601425170898,16,11
1454,64,3.587921678793129,5.466669153085583,1.0255194176124687,1.0384534247766608,29,50,12.948214530944824,9.110601425170898,35,14
1454,128,1.9812447059736789,5.4236032887999395,1.0083191410931247,1.0398600584520006,60,110,13.751672744750977,9.110601425170898,68,18
1455,1,4.44728220938689,4.44728220938689,0.9889302164596405,0.9889302164596403,0,0,4.459771633148193,4.459771633148193,1,1
1455,2,4.228802345085374,4.228802345085374,0.9936026589321615,0.9936026589321607,0,0,5.81215238571167,4.459771633148193,2,2
1455,3,4.004475044345878,4.004475044345878,0.9956101963255085,0.9956101963255086,0,0,6.0193352699279785,4.459771633148193,3,3
1455,4,3.946421865388987,3.9471582788746438,0.9973067782817651,0.997332955911143,1,1,6.490915775299072,4.459771633148193,3,3
1455,8,3.6634425611688055,3.6762004124546155,1.001148222417493,1.0012709883749995,3,3,7.088380336761475,4.459771633148193,5,5
1455,16,3.0893034645140327,3.2784200776121377,1.0069069188463204,1.0079241343734813,5,8,7.607834815979004,4.459771633148193,11,8
1455,32,2.468439567745373,3.1716163932084704,1.0043706276238016,1.0101945469339335,13,19,8.247143745422363,4.459771633148193,19,13
1455,64,1.8492765619557436,2.9958144494508203,1.0032950496570179,1.0142081403041314,33,52,8.868315696716309,4.459771633148193,31,12
1455,128,0.836265898296365,2.984277723375662,1.0005595268958676,1.0151967264391193,60,111,9.592923164367676,4.459771633148193,68,17
1456,1,7.907894844569341,7.907894844569341,0.9606280452669136,0.9606280452669153,0,0,7.995358943939209,7.995358943939209,1,1
1456,2,7.2345203264566695,7.234520326456671,0.9721121963986213,0.9721121963986221,0,0,8.221478462219238,7.995358943939209,2,2
1456,3,6.944081771428729,6.9440817714287295,0.9787721670157846,0.9787721670157852,0,0,8.782618522644043,7.995358943939209,3,3
1456,4,6.598561415844672,6.598561415844672,0.9877960401524118,0.9877960401524111,0,0,9.536938667297363,7.995358943939209,4,4
1456,8,6.361106299307142,6.499490305825659,0.9931290475214947,0.9933160468345457,4,3,9.95889663696289,7.995358943939209,4,5
1456,16,5.302570354008488,5.803835829984341,1.010039451816328,1.0095558315845694,7,8,10.52099609375,7.995358943939209,9,8
1456,32,4.4601073928949155,5.429134995557745,1.0184300604009566,1.0192743808891203,15,20,11.214011192321777,7.995358943939209,17,12
1456,64,2.905994592141169,5.347869770684805,1.0089087199694977,1.0230375468879038,33,50,12.22623062133789,7.995358943939209,31,14
1456,128,1.7330575901547258,5.247154378777175,1.0042305207622761,1.0282103514427094,62,113,12.992591857910156,7.995358943939209,66,15
1457,1,8.850473204258689,8.850473204258687,0.9603933465009389,0.9603933465009405,0,0,8.926756858825684,8.926756858825684,1,1
1457,2,7.6886320687521685,7.68863206875217,0.9843682027622976,0.9843682027622986,0,0,9.565929412841797,8.926756858825684,2,2
1457,3,7.2534462316767865,7.2534462316767865,0.9939839490852844,0.9939839490852851,0,0,9.660533905029297,8.926756858825684,3,3
1457,4,7.055599099500572,7.055599099500572,0.998198132603928,0.9981981326039295,0,0,9.864253997802734,8.926756858825684,4,4
1457,8,6.251138066038017,6.280176144030292,1.0137262322262943,1.0138402739110315,3,3,10.009111404418945,8.926756858825684,5,5
1457,16,5.276767026928125,5.584440332281459,1.0338596739289037,1.029301547016647,5,8,10.513809204101562,8.926756858825684,11,8
1457,32,4.835667375032156,5.477412321018947,1.0335851012330282,1.0332089291875524,14,21,11.571236610412598,8.926756858825684,18,11
1457,64,3.859038626385043,5.476733253189043,1.0226903807623828,1.0333802095995501,28,52,12.486403465270996,8.926756858825684,36,12
1457,128,2.5751704196889706,5.412571460738592,1.0108307820968432,1.0402656536411916,62,112,13.42330265045166,8.926756858825684,66,16
1458,1,8.519784296542397,8.519784296542392,0.9588430407602487,0.9588430407602501,0,0,8.607126235961914,8.607126235961914,1,1
1458,2,8.154884581885964,8.154884581885966,0.969522847418157,0.9695228474181574,0,0,10.742704391479492,8.607126235961914,2,2
1458,3,7.766386782815246,7.766386782815246,0.9832001737812954,0.983200173781295,0,0,11.696470260620117,8.607126235961914,3,3
1458,4,7.595601736883085,7.595601736883085,0.9877743173019543,0.9877743173019546,0,0,11.864728927612305,8.607126235961914,4,4
1458,8,6.632941365491153,6.730498470555671,1.016714124069716,1.0159599086515243,1,2,13.368122100830078,8.607126235961914,7,6
1458,16,6.022436999792559,6.727876707553345,1.0115839538188305,1.0163103679189847,5,9,14.001998901367188,8.607126235961914,11,7
1458,32,5.376015239598737,6.681029272142638,1.0172985275287347,1.0207356838188808,17,22,14.67018985748291,8.607126235961914,15,10
1458,64,4.184511357231918,6.223462641767065,1.0115354693909748,1.037908027724326,26,50,15.667352676391602,8.607126235961914,38,14
1458,128,2.569934279127335,6.113741740398352,1.0060069690508735,1.0436292695785951,62,113,16.371788024902344,8.607126235961914,66,15
1459,1,11.447297402350507,11.447297402350518,0.917918417790593,0.9179184177905966,0,0,11.712215423583984,11.712215423583984,1,1
1459,2,9.735469228869214,9.735469228869215,0.9663039927970203,0.966303992797023,0,0,12.175822257995605,11.712215423583984,2,2
1459,3,8.805794250985015,8.805794250985016,0.9915201101638683,0.9915201101638718,0,0,12.565038681030273,11.712215423583984,3,3
1459,4,8.05023404758856,8.05023404758856,1.0109903037228676,1.0109903037228696,0,0,13.084782600402832,11.712215423583984,4,4
1459,8,7.732285759011771,7.732285759011768,1.0207102632487024,1.020710263248706,1,1,13.975112915039062,11.712215423583984,7,7
1459,16,7.266318895157595,7.691963321165503,1.0214812541467038,1.0225091469666843,6,6,14.4382905960083,11.712215423583984,10,10
1459,32,6.512379840162229,7.470580094187446,1.0183143314217502,1.0325381689803488,14,20,15.086711883544922,11.712215423583984,18,12
1459,64,5.186886127511483,7.433615989771986,1.01723232995127,1.0368096826478042,32,50,15.749354362487793,11.712215423583984,32,14
1459,128,3.218315372622397,7.370472783181517,1.0054902529313836,1.0397967787023137,59,113,16.38100814819336,11.712215423583984,69,15
1460,1,8.906161319765422,8.90616131976543,0.9507639267934347,0.9507639267934378,0,0,9.026055335998535,9.026055335998535,1,1
1460,2,7.496546805208007,7.496546805207957,0.985526018360195,0.9855260183601967,0,0,9.36507511138916,9.026055335998535,2,2
1460,3,7.18703062752674,7.187030627526739,0.9870441431803318,0.9870441431803314,0,0,9.454255104064941,9.026055335998535,3,3
1460,4,6.954941268606589,6.95494126860659,0.9913832352529042,0.9913832352529047,0,0,9.574012756347656,9.026055335998535,4,4
1460,8,6.373360242760062,6.4396941039023075,1.0051692147421867,1.0029802481867975,2,2,10.75443172454834,9.026055335998535,6,6
1460,16,5.534964045581751,5.91807251718506,1.0187875717009205,1.0203753878882647,6,5,11.639328956604004,9.026055335998535,10,11
1460,32,4.973053549178379,5.702736598398606,1.0225737215177935,1.027057981989906,14,20,12.208722114562988,9.026055335998535,18,12
1460,64,3.7778934741988484,5.697979554671507,1.011033149586299,1.0275095866030388,28,50,12.77216911315918,9.026055335998535,36,14
1460,128,2.337115852557163,5.546869773225982,1.0099081532477934,1.0321242714693195,58,115,13.590570449829102,9.026055335998535,70,13
1461,1,9.680427385556397,9.680427385556401,0.9427405689404148,0.9427405689404178,0,0,9.830977439880371,9.830977439880371,1,1
1461,2,7.704910355918571,7.704910355918572,0.9880635980192929,0.9880635980192943,0,0,10.46059513092041,9.830977439880371,2,2
1461,3,7.655043606434829,7.655043606434827,0.9896320422143929,0.9896320422143943,0,0,10.80352783203125,9.830977439880371,3,3
1461,4,7.115493176396959,7.115493176396959,1.0003436316292218,1.0003436316292231,0,0,11.049216270446777,9.830977439880371,4,4
1461,8,6.794310258592711,6.812841606344057,1.008258205712206,1.0083298224965165,2,2,11.834890365600586,9.830977439880371,6,6
1461,16,6.30071205450917,6.391224131291862,1.018426970525757,1.0192813336452042,6,9,12.235493659973145,9.830977439880371,10,7
1461,32,5.421133447906363,6.108006811276083,1.0248471612276457,1.0305600883709962,14,22,12.74185562133789,9.830977439880371,18,10
1461,64,4.015969300506915,6.044691458707154,1.0221972475371954,1.033346533415879,22,53,13.271683692932129,9.830977439880371,42,11
1461,128,2.430613177027354,6.011045409743817,1.0122525233978483,1.0364902830475247,68,116,13.896310806274414,9.830977439880371,60,12
1462,1,9.517414218085214,9.517414218085218,0.9385398618280274,0.9385398618280302,0,0,9.68932056427002,9.68932056427002,1,1
1462,2,8.645804835205958,8.645804835205952,0.9649633445851717,0.9649633445851737,0,0,10.420967102050781,9.68932056427002,2,2
1462,3,7.247636167368233,7.247636167368234,0.9983000790252059,0.9983000790252077,0,0,10.730003356933594,9.68932056427002,3,3
1462,4,6.798482008442943,6.798482008442943,1.0098121592959826,1.0098121592959841,0,0,11.6394624710083,9.68932056427002,4,4
1462,8,6.636669884106577,6.636669884106577,1.01790549224173,1.0179054922417323,0,0,12.472816467285156,9.68932056427002,8,8
1462,16,6.5230259616455815,6.52813424744433,1.0246969498768166,1.0245630244717145,5,6,12.855952262878418,9.68932056427002,11,10
1462,32,5.744460767607941,6.365275113459753,1.0293640293052366,1.0327347078074436,12,16,13.628744125366211,9.68932056427002,20,16
1462,64,4.2734462839112055,5.917970290192938,1.027116197570035,1.0478716974294449,31,49,14.236409187316895,9.68932056427002,33,15
1462,128,2.8984105381973633,5.833462258299845,1.0158157446881035,1.0525049241419042,69,111,14.923293113708496,9.68932056427002,59,17
1463,1,11.802368123353526,11.80236812335351,0.9183405367448707,0.9183405367448738,0,0,12.049500465393066,12.049500465393066,1,1
1463,2,11.441365379099228,11.441365379099196,0.9331880554913909,0.9331880554913932,0,0,13.303658485412598,12.049500465393066,2,2
1463,3,11.13614222143661,11.136142221436616,0.9454286570228536,0.945428657022855,0,0,13.448453903198242,12.049500465393066,3,3
1463,4,10.787033427516677,10.78703342751668,0.9595627883181057,0.9595627883181082,0,0,13.492993354797363,12.049500465393066,4,4
1463,8,8.903452562663668,8.955826313572148,1.0138765133897751,1.015291809784409,2,2,14.396632194519043,12.049500465393066,6,6
1463,16,8.705830466453449,8.866069402822589,1.0194788777439832,1.0218754316889624,5,6,14.981836318969727,12.049500465393066,11,10
1463,32,7.449087552102917,8.504242705508686,1.0321381684963993,1.0419071946215892,12,20,15.545598983764648,12.049500465393066,20,12
1463,64,5.8771999554648,8.478002784125817,1.0237167434342758,1.0456185439496715,34,50,16.094335556030273,12.049500465393066,30,14
1463,128,4.0248704296270175,8.104035410985054,1.0147717103998715,1.0647538014132183,61,112,16.738664627075195,12.049500465393066,67,16
1464,1,10.757902005732912,10.757902005732914,0.9336702418544324,0.9336702418544333,0,0,10.934642791748047,10.934642791748047,1,1
1464,2,9.849670770181714,9.849670770181714,0.9554128532831311,0.9554128532831307,0,0,11.065086364746094,10.934642791748047,2,2
1464,3,9.157676491526914,9.157676491526916,0.973877304147498,0.9738773041474984,0,0,11.611960411071777,10.934642791748047,3,3
1464,4,8.484984149487886,8.484984149487888,0.9920334011223346,0.9920334011223342,0,0,11.762101173400879,10.934642791748047,4,4
1464,8,7.712482051828067,7.7124826092923,1.0157286098125622,1.0157238176046848,1,1,12.103097915649414,10.934642791748047,7,7
1464,16,7.011651021340896,7.2950366941816736,1.0215293708259694,1.0234433790416002,4,7,12.934582710266113,10.934642791748047,12,9
1464,32,5.974363177397831,7.017677371828879,1.030815128613412,1.0337774492324603,11,19,13.579817771911621,10.934642791748047,21,13
1464,64,4.737245322595403,6.96104618141922,1.0264335991536957,1.0377257068433843,31,46,14.055243492126465,10.934642791748047,33,18
1464,128,2.8618640022741397,6.769249778065381,1.0083082047751115,1.0473355923201442,63,107,14.56054973602295,10.934642791748047,65,21
1465,1,8.845719612610706,8.84571961261071,0.9404587250495967,0.9404587250495984,0,0,9.030644416809082,9.030644416809082,1,1
1465,2,7.851079208115061,7.851079208115061,0.951577453553583,0.9515774535535847,0,0,9.046528816223145,9.030644416809082,2,2
1465,3,7.808983841000249,7.808983841000249,0.9516923914577391,0.9516923914577388,0,0,9.108349800109863,9.030644416809082,3,3
1465,4,7.793783298274897,7.793783298274896,0.9522049449186363,0.9522049449186365,0,0,9.126128196716309,9.030644416809082,4,4
1465,8,7.737054958652196,7.746504190309143,0.9538487372211975,0.9539029967134447,3,4,9.31143856048584,9.030644416809082,5,4
1465,16,7.479480065696119,7.73689134616381,0.9537298908579342,0.954435571722383,7,10,9.446589469909668,9.030644416809082,9,6
1465,32,6.903691192913807,7.662796706495775,0.9633646899181905,0.9564820697121749,16,27,9.578963279724121,9.030644416809082,16,5
1465,64,5.283462903666176,6.653425896117744,0.9890869434427563,0.982876144806915,30,58,9.752243995666504,9.030644416809082,34,6
1465,128,4.463421008487817,6.623270079593403,0.9889232411126763,0.9841794756269563,64,119,10.053888320922852,9.030644416809082,64,9
1466,1,11.964785596784838,11.964785596784845,0.9000344893239185,0.9000344893239204,0,0,12.324115753173828,12.324115753173828,1,1
1466,2,10.91837688240606,10.91837688240606,0.9362466609270138,0.9362466609270134,0,0,12.678521156311035,12.324115753173828,2,2
1466,3,9.75798413263537,9.75798413263537,0.9689727655023005,0.9689727655023004,0,0,12.808075904846191,12.324115753173828,3,3
1466,4,9.733578713477895,9.733578713477895,0.9699231417941364,0.9699231417941361,0,0,13.20235538482666,12.324115753173828,4,4
1466,8,8.542677364688426,8.561817429718221,1.0059022564398157,1.0058842002751733,2,2,13.732549667358398,12.324115753173828,6,6
1466,16,7.733366332117739,8.076616287820038,1.0255013367834058,1.021010596744166,5,7,14.397976875305176,12.324115753173828,11,9
1466,32,6.475481004825427,7.706917593061666,1.0362819593250923,1.0330807975835363,11,21,14.916801452636719,12.324115753173828,21,11
1466,64,4.679126993042651,7.6614228475620045,1.0248990142977128,1.0369477626162151,27,50,15.628036499023438,12.324115753173828,37,14
1466,128,3.0946597885869496,7.434756661431016,1.0122294867803154,1.0489905810966742,62,112,16.25605583190918,12.324115753173828,66,16
1467,1,11.771485332710593,11.771485332710593,0.9243203411282699,0.9243203411282702,0,0,11.97895622253418,11.97895622253418,1,1
1467,2,10.400845690516142,10.40084569051614,0.9601793491738067,0.9601793491738067,0,0,12.132892608642578,11.97895622253418,2,2
1467,3,9.91963106069435,9.91963106069435,0.9736410831361091,0.9736410831361096,0,0,12.203166961669922,11.97895622253418,3,3
1467,4,8.812168891951805,8.812168891951805,0.9951573009928083,0.9951573009928082,0,0,12.332262992858887,11.97895622253418,4,4
1467,8,8.085124522959445,8.085124522959443,1.01906413331637,1.0190641333163712,0,0,13.574522018432617,11.97895622253418,8,8
1467,16,7.431795947244916,7.639692837954708,1.0363214387657131,1.033564567416309,3,4,14.150956153869629,11.97895622253418,13,12
1467,32,6.309981082650964,7.2854679603179155,1.0448112386233115,1.0435420400231212,12,19,14.747289657592773,11.97895622253418,20,13
1467,64,5.06615603388241,7.056062192770694,1.0402436743105659,1.0536698289545048,29,49,15.371726036071777,11.97895622253418,35,15
1467,128,3.242932078213956,7.054724336897974,1.0208944823593666,1.0540366444336362,60,112,15.8815279006958,11.97895622253418,68,16
1468,1,11.085009896979008,11.085009896979008,0.9328834827674986,0.9328834827674991,0,0,11.26123332977295,11.26123332977295,1,1
1468,2,9.542193480817573,9.542193480817573,0.9701884093938339,0.9701884093938336,0,0,11.568256378173828,11.26123332977295,2,2
1468,3,8.84653851474833,8.846538514748328,0.9888371877052535,0.9888371877052524,0,0,11.957813262939453,11.26123332977295,3,3
1468,4,8.063062239539754,8.063062239539754,1.0075873670436082,1.0075873670436073,0,0,12.286859512329102,11.26123332977295,4,4
1468,8,7.411697133525214,7.411697133525216,1.0256630786303225,1.0256630786303211,0,0,12.541228294372559,11.26123332977295,8,8
1468,16,6.5144207087018255,7.049264426058811,1.037822674376537,1.0371935008787132,5,6,13.593539237976074,11.26123332977295,11,10
1468,32,5.7706477452865,6.803981723488328,1.0349618216047387,1.047501541805273,11,21,14.337543487548828,11.26123332977295,21,11
1468,64,4.597184763605868,6.800448000459873,1.017624120303864,1.0488799489526621,29,51,15.34617805480957,11.26123332977295,35,13
1468,128,2.682643384743268,6.758526710683171,1.0126150331450292,1.054519669478906,60,113,16.203914642333984,11.26123332977295,68,15
1469,1,9.218305959911046,9.218305959911048,0.9505680811083566,0.950568081108357,0,0,9.338968276977539,9.338968276977539,1,1
1469,2,8.381754090724321,8.381754090724321,0.9666045541216777,0.9666045541216775,0,0,9.959701538085938,9.338968276977539,2,2
1469,3,8.087233387072587,8.087233387072587,0.9733592320689728,0.9733592320689723,0,0,10.35411548614502,9.338968276977539,3,3
1469,4,7.749998246149045,7.749998246149045,0.9814419790883762,0.9814419790883759,0,0,10.51503849029541,9.338968276977539,4,4
1469,8,6.8584318636437915,6.893515596671049,1.003806739375704,1.0015435192626558,1,2,11.27292251586914,9.338968276977539,7,6
1469,16,6.209556088841513,6.436886175977867,1.0127505775585193,1.0150707682318454,6,7,11.671575546264648,9.338968276977539,10,9
1469,32,5.228588378340113,6.289162927490819,1.020289226009649,1.0221296243607225,13,18,12.059831619262695,9.338968276977539,19,14
1469,64,3.880466036382171,6.198011257157925,1.0152341674774241,1.0264826944009218,29,47,12.530134201049805,9.338968276977539,35,17
1469,128,2.34531967360235,6.089394282170446,1.0042100226803798,1.0333611201709654,60,107,13.056991577148438,9.338968276977539,68,21
1470,1,10.780226498090185,10.780226498090148,0.9283888270229262,0.9283888270229282,0,0,10.984223365783691,10.984223365783691,1,1
1470,2,9.852628535568083,9.852628535568085,0.955951384130679,0.9559513841306804,0,0,12.091452598571777,10.984223365783691,2,2
1470,3,8.222360920799847,8.222360920799845,0.9972511888418352,0.9972511888418354,0,0,12.367072105407715,10.984223365783691,3,3
1470,4,7.769990908811277,7.769990908811277,1.0082561247181607,1.0082561247181603,0,0,12.438691139221191,10.984223365783691,4,4
1470,8,7.243544781071062,7.420693236650184,1.0204603529016145,1.0199659007449657,2,2,12.916471481323242,10.984223365783691,6,6
1470,16,6.666658096566603,6.806418662888921,1.0296398929912858,1.0325026383770188,7,6,13.548198699951172,10.984223365783691,9,10
1470,32,5.731049546314431,6.6504344113166445,1.0298195984852732,1.039882216912327,14,20,14.074328422546387,10.984223365783691,18,12
1470,64,4.806648619641294,6.490837479826876,1.0211215905804738,1.0406548419694808,33,48,14.404414176940918,10.984223365783691,31,16
1470,128,2.972489709410527,6.312101558858508,1.008346482295765,1.0497030225576813,64,112,14.939399719238281,10.984223365783691,64,16
1471,1,8.6829960098205,8.682996009820476,0.952555429173962,0.9525554291739629,0,0,8.799361228942871,8.799361228942871,1,1
1471,2,7.275116446435877,7.275116446435882,0.9779107069085283,0.9779107069085273,0,0,9.18443489074707,8.799361228942871,2,2
1471,3,6.84963772314826,6.849637723148259,0.987182555252752,0.9871825552527511,0,0,9.40178108215332,8.799361228942871,3,3
1471,4,6.548840252073096,6.548840252073096,0.9935875351718675,0.9935875351718666,0,0,9.424607276916504,8.799361228942871,4,4
1471,8,6.007473017276018,6.008355666881153,1.0051509909352916,1.005134997912946,2,2,9.645604133605957,8.799361228942871,6,6
1471,16,4.863895462030759,5.067864475401824,1.025967351492753,1.0223610045925011,6,6,10.183698654174805,8.799361228942871,10,10
1471,32,4.3918479198631255,4.8881991719264155,1.0301650102402653,1.028964343150435,14,20,10.547712326049805,8.799361228942871,18,12
1471,64,3.70970508647056,4.8221784056066035,1.0233078301513978,1.0310493746707003,29,45,11.140179634094238,8.799361228942871,35,19
1471,128,2.2524523173401114,4.774504887797692,1.0103633358675839,1.0344736119127516,59,109,11.869455337524414,8.799361228942871,69,19
1472,1,7.737768278660551,7.7377682786605515,0.9645117563882256,0.9645117563882258,0,0,7.810896873474121,7.810896873474121,1,1
1472,2,6.0976482586481815,6.0976482586481815,0.994082571115482,0.9940825711154833,0,0,8.466256141662598,7.810896873474121,2,2
1472,3,6.01878614653569,6.018786146535689,0.9958755843007505,0.9958755843007516,0,0,8.804701805114746,7.810896873474121,3,3
1472,4,5.673979857327498,5.673979857327498,1.0024025266595373,1.0024025266595378,0,0,8.93188190460205,7.810896873474121,4,4
1472,8,5.40903807013586,5.420671599584395,1.011277523442105,1.010907658443894,2,3,9.488093376159668,7.810896873474121,6,5
1472,16,4.939378154454644,5.232610448596256,1.0147094895048907,1.013998572709094,7,6,9.990486145019531,7.810896873474121,9,10
1472,32,4.27520797350241,5.150509243630862,1.0166212724639876,1.019002024033857,14,18,10.533163070678711,7.810896873474121,18,14
1472,64,3.1242528862947045,5.03801028400499,1.0076412438645357,1.024052676234776,32,43,10.9192476272583,7.810896873474121,32,21
1472,128,1.6893437577748234,4.944594225621975,1.0061087287476247,1.0276866359571852,67,107,11.680135726928711,7.810896873474121,61,21
1473,1,7.344768585295145,7.344768585295142,0.9700590349377581,0.9700590349377618,0,0,7.400444030761719,7.400444030761719,1,1
1473,2,6.252895059747389,6.252895059747382,0.9902287882991772,0.99022878829918,0,0,8.200599670410156,7.400444030761719,2,2
1473,3,6.086500645388476,6.086500645388477,0.9934012672693302,0.9934012672693328,0,0,8.341976165771484,7.400444030761719,3,3
1473,4,5.922234498812627,5.922234498812628,0.99609309216011,0.9960930921601121,0,0,8.400226593017578,7.400444030761719,4,4
1473,8,5.220772487468787,5.248613782495511,1.010069427317837,1.0087808956926434,2,3,9.286882400512695,7.400444030761719,6,5
1473,16,4.701893168905792,4.918989058242422,1.0197627900625772,1.0168389918680967,5,5,10.313238143920898,7.400444030761719,11,11
1473,32,3.6054629227131416,4.595717752706744,1.0163217319307887,1.025548398405667,14,22,11.509340286254883,7.400444030761719,18,10
1473,64,2.489052187410498,4.567542283813713,1.006768118375442,1.0279106741091975,32,52,12.401834487915039,7.400444030761719,32,12
1473,128,1.5335070638906265,4.479025036602014,1.0028984586776817,1.033525087390623,65,114,13.23136043548584,7.400444030761719,63,14
1474,1,8.27938814308101,8.279388143081011,0.9629418394322985,0.9629418394322989,0,0,8.35321044921875,8.35321044921875,1,1
1474,2,6.40822408186339,6.40822408186339,0.9912885569934436,0.9912885569934441,0,0,8.523381233215332,8.35321044921875,2,2
1474,3,6.350304538924528,6.350304538924529,0.9925796450056499,0.9925796450056503,0,0,8.603930473327637,8.35321044921875,3,3
1474,4,5.775374423779465,5.775374423779464,1.0037631680506123,1.0037631680506136,0,0,8.786040306091309,8.35321044921875,4,4
1474,8,5.403435266422606,5.408962946254756,1.0091598872743184,1.0091703720678336,2,2,9.196921348571777,8.35321044921875,6,6
1474,16,5.217918445870358,5.296527729802076,1.0122141477557316,1.0121816072253287,6,6,9.774991989135742,8.35321044921875,10,10
1474,32,4.0335768416205395,5.187964468462585,1.010923416198871,1.0173804116699143,14,19,10.59001350402832,8.35321044921875,18,13
1474,64,2.824429773699759,4.839437693580983,1.0079654455852718,1.0269756043990839,30,51,11.49265193939209,8.35321044921875,34,13
1474,128,1.3106262321920163,4.835183227432435,1.0018564191220543,1.027291493350746,55,113,12.269365310668945,8.35321044921875,73,15
1475,1,6.03311786095579,6.033117860955791,0.9826311529292082,0.982631152929209,0,0,6.056121349334717,6.056121349334717,1,1
1475,2,4.52280322055464,4.522803220554639,1.001929653892129,1.001929653892129,0,0,7.279224395751953,6.056121349334717,2,2
1475,3,4.355055509120729,4.35505550912073,1.0053354700199353,1.0053354700199344,0,0,7.756308555603027,6.056121349334717,3,3
1475,4,4.352665314202651,4.3526653142026515,1.0055875164233012,1.0055875164233008,0,0,8.11811637878418,6.056121349334717,4,4
1475,8,3.95289651931183,4.236261500723381,1.0081105523832645,1.0078579040746065,2,3,8.566995620727539,6.056121349334717,6,5
1475,16,3.534312844044135,4.20070577115661,1.0061723061088068,1.0098276026391297,7,10,9.125871658325195,6.056121349334717,9,6
1475,32,2.9168796829375867,3.808285709050303,1.008725102961936,1.019727403056887,15,23,9.591483116149902,6.056121349334717,17,9
1475,64,2.0950876851749753,3.7926828840020343,1.0070855053932182,1.0199547954500354,28,54,10.434237480163574,6.056121349334717,36,10
1475,128,1.2204469372247937,3.76546738780992,1.0007812163656875,1.0216621111211919,65,116,11.278761863708496,6.056121349334717,63,12
1476,1,10.58244081048082,10.582440810480822,0.9307126207799671,0.9307126207799697,0,0,10.784269332885742,10.784269332885742,1,1
1476,2,8.50730707370089,8.507307073700888,0.9757416845800125,0.9757416845800124,0,0,10.937999725341797,10.784269332885742,2,2
1476,3,8.052615575836544,8.052615575836542,0.9864302646681034,0.9864302646681026,0,0,11.175760269165039,10.784269332885742,3,3
1476,4,7.596500498557568,7.596500498557569,0.9987223279334119,0.9987223279334099,0,0,11.279036521911621,10.784269332885742,4,4
1476,8,6.126502407434395,6.156035085102481,1.0295557132093203,1.0296510984771758,1,1,11.634891510009766,10.784269332885742,7,7
1476,16,5.481742021225021,5.679013801388377,1.0426727365904265,1.0394337981316975,4,4,12.127071380615234,10.784269332885742,12,12
1476,32,5.1191822460247565,5.593037702501571,1.04661836521188,1.0439169696526962,11,15,12.509367942810059,10.784269332885742,21,17
1476,64,4.020538294279796,5.473210433727111,1.040551882421239,1.0478345774641427,26,46,13.207173347473145,10.784269332885742,38,18
1476,128,2.580379787096955,5.437419374448823,1.016217496289995,1.0507738246182123,58,110,13.756021499633789,10.784269332885742,70,18
1477,1,9.84905554015428,9.84905554015428,0.9443334933478038,0.9443334933478035,0,0,9.99486255645752,9.99486255645752,1,1
1477,2,8.746831224571768,8.746831224571766,0.97033366782602,0.9703336678260186,0,0,10.246091842651367,9.99486255645752,2,2
1477,3,8.565181383285394,8.565181383285392,0.9758677035260886,0.975867703526087,0,0,10.373513221740723,9.99486255645752,3,3
1477,4,7.993928205665057,7.993928205665056,0.9917621488999958,0.9917621488999944,0,0,10.769837379455566,9.99486255645752,4,4
1477,8,7.897274567652719,7.897274567652719,0.9950624418936278,0.9950624418936258,0,0,10.96223258972168,9.99486255645752,8,8
1477,16,6.476787172667589,7.428843243424225,1.018465500099556,1.0083328183063873,5,7,11.199945449829102,9.99486255645752,11,9
1477,32,5.691000364413392,7.340003062113602,1.0174625377916962,1.0122479138131204,14,20,11.552202224731445,9.99486255645752,18,12
1477,64,4.49051626568304,7.009657591254211,1.011999558303865,1.0232437854150114,30,52,12.062270164489746,9.99486255645752,34,12
1477,128,2.3834566196346807,6.902893232537116,1.0058252849640075,1.0259215390387566,68,115,12.496722221374512,9.99486255645752,60,13
1478,1,5.872710801395815,5.872710801395816,0.9787638996055454,0.9787638996055458,0,0,5.908524513244629,5.908524513244629,1,1
1478,2,4.713710933180114,4.713710933180114,0.9934636989951331,0.9934636989951324,0,0,6.161933898925781,5.908524513244629,2,2
1478,3,3.987546874522725,3.9875468745227254,1.00269144771134,1.0026914477113393,0,0,6.18702507019043,5.908524513244629,3,3
1478,4,3.1858975640671896,3.1858975640671914,1.0120501638915869,1.0120501638915864,0,0,6.2700605392456055,5.908524513244629,4,4
1478,8,2.9614504431709823,2.9709222384993565,1.013376610006473,1.013128905489637,1,1,6.697422504425049,5.908524513244629,7,7
1478,16,2.4824030700050086,2.751835112415928,1.0145890236060575,1.015615093052892,6,7,7.085930347442627,5.908524513244629,10,9
1478,32,2.025232375017477,2.7071070679110445,1.0110395330969382,1.0168717346881635,15,18,7.659225940704346,5.908524513244629,17,14
1478,64,1.2024221872181722,2.706381049166923,1.002924782541032,1.0169988209313758,28,48,8.352787017822266,5.908524513244629,36,16
1478,128,0.6147113259051836,2.70360722028871,1.000999639908788,1.0173621300418931,64,110,9.284146308898926,5.908524513244629,64,18
1479,1,7.729862272695592,7.729862272695594,0.9566660246129746,0.9566660246129765,0,0,7.839268684387207,7.839268684387207,1,1
1479,2,7.1358818853841255,7.135881885384126,0.9731649998899491,0.9731649998899499,0,0,8.653058052062988,7.839268684387207,2,2
1479,3,6.49894728475303,6.49894728475303,0.9851785744130717,0.9851785744130723,0,0,8.908509254455566,7.839268684387207,3,3
1479,4,5.557205457480846,5.557205457480847,0.9975051292983751,0.9975051292983754,0,0,8.995315551757812,7.839268684387207,4,4
1479,8,5.297949567640098,5.299762923895508,1.0033162214765898,1.003615625076702,2,2,9.568015098571777,7.839268684387207,6,6
1479,16,4.875595854908178,5.055085045211232,1.0114084445772675,1.0130036854739304,5,7,10.368446350097656,7.839268684387207,11,9
1479,32,4.395926238861907,4.977722029477548,1.0173979681477678,1.019991959785786,13,18,10.860164642333984,7.839268684387207,19,14
1479,64,3.3078484293722314,4.83125344679339,1.0128977890692596,1.025952796791559,27,46,11.426226615905762,7.839268684387207,37,18
1479,128,1.904125205314423,4.5728222788400394,1.0035594415072078,1.0369137004300917,59,109,12.133090019226074,7.839268684387207,69,19
1480,1,8.080604787337391,8.080604787337386,0.9613835254121046,0.9613835254121066,0,0,8.164077758789062,8.164077758789062,1,1
1480,2,6.9228111922525555,6.9228111922525555,0.9876170939471967,0.9876170939471984,0,0,8.912801742553711,8.164077758789062,2,2
1480,3,5.747168343090046,5.7471683430900455,1.008376426976215,1.008376426976215,0,0,9.261761665344238,8.164077758789062,3,3
1480,4,5.739638729858062,5.739638729858061,1.0089973221494992,1.0089973221494999,0,0,9.264654159545898,8.164077758789062,4,4
1480,8,5.35163062642966,5.358931993895432,1.0182129755397216,1.0182594241957543,1,1,9.922654151916504,8.164077758789062,7,7
1480,16,4.686557472398108,4.732008429696941,1.030458975641107,1.0312011704786546,3,5,10.767770767211914,8.164077758789062,13,11
1480,32,3.8418517192621975,4.6371916525635575,1.0218806038418706,1.034084541185236,14,20,11.715241432189941,8.164077758789062,18,12
1480,64,3.0319108019713648,4.565738293983999,1.0143773011619976,1.0376222774159234,33,50,12.394185066223145,8.164077758789062,31,14
1480,128,1.941561809946366,4.511114070513475,1.003281873568512,1.040851577133084,65,112,13.175058364868164,8.164077758789062,63,16
1481,1,7.262704703338349,7.262704703338352,0.968762910363138,0.9687629103631397,0,0,7.322854042053223,7.322854042053223,1,1
1481,2,5.842357633167837,5.842357633167837,0.9898977861541209,0.989897786154122,0,0,7.6324143409729,7.322854042053223,2,2
1481,3,5.372213782981873,5.372213782981873,0.9962996230317307,0.9962996230317323,0,0,8.142779350280762,7.322854042053223,3,3
1481,4,5.178559505852526,5.178559505852526,1.0008644632382997,1.0008644632383004,0,0,8.342580795288086,7.322854042053223,4,4
1481,8,4.688604568539194,4.74857043024825,1.0082717620314463,1.007987517990208,2,2,8.799013137817383,7.322854042053223,6,6
1481,16,4.312607939773098,4.471522688692763,1.0160516782409807,1.0148393537101734,5,4,9.304465293884277,7.322854042053223,11,12
1481,32,3.7321661994800364,4.269809225536012,1.0160826651600803,1.020505848995291,14,19,10.101746559143066,7.322854042053223,18,13
1481,64,2.1974850107335167,4.00763024889417,1.0057842006364148,1.0277584901287358,30,48,10.855141639709473,7.322854042053223,34,16
1481,128,1.181446543960272,3.9860267470635224,1.0023397524803825,1.028691091120457,57,111,11.571819305419922,7.322854042053223,71,17
1482,1,8.680206608694846,8.680206608694851,0.9600135139043124,0.9600135139043149,0,0,8.762443542480469,8.762443542480469,1,1
1482,2,7.747297799278385,7.747297799278358,0.9797588658858634,0.9797588658858651,0,0,9.434968948364258,8.762443542480469,2,2
1482,3,7.175578269515434,7.175578269515435,0.9900602833911795,0.9900602833911809,0,0,9.547163009643555,8.762443542480469,3,3
1482,4,7.1149597116667715,7.114959711666773,0.9922730308709888,0.9922730308709906,0,0,9.767860412597656,8.762443542480469,4,4
1482,8,5.791343157912877,5.8426745105700535,1.0138278586985037,1.0141532064083898,2,2,9.945720672607422,8.762443542480469,6,6
1482,16,5.399553342040405,5.651909252375801,1.019004121944422,1.0173130438190217,6,8,10.667309761047363,8.762443542480469,10,8
1482,32,4.65814957033031,5.235229806761756,1.0253808695796272,1.0283290649721408,12,21,11.113616943359375,8.762443542480469,20,11
1482,64,3.152621648680392,5.055952800322869,1.0184210209483864,1.0346738001572446,26,45,11.838561058044434,8.762443542480469,38,19
1482,128,1.7206274505337091,4.825077271327894,1.0060055060617055,1.0428494036511373,58,106,12.736760139465332,8.762443542480469,70,22
1483,1,2.205495653212005,2.205495653212006,0.9980095591142045,0.9980095591142059,0,0,2.2063586711883545,2.2063586711883545,1,1
1483,2,1.7705105146199562,1.7705105146199565,0.999586046779093,0.9995860467790936,0,0,2.3084168434143066,2.2063586711883545,2,2
1483,3,1.7703180984097857,1.7705105146199565,0.9995598270957771,0.9995860467790936,1,1,2.749864101409912,2.2063586711883545,2,2
1483,4,1.7427792907049546,1.7433610662788412,1.0002042030125693,1.0002436638986176,1,1,3.4738895893096924,2.2063586711883545,3,3
1483,8,1.7093899738962126,1.7187803931832772,1.000867045824149,1.0008788369330273,3,2,3.771026611328125,2.2063586711883545,5,6
1483,16,1.5620442185656556,1.7113801053934397,1.0009361170110451,1.0011836811958652,6,9,4.0390777587890625,2.2063586711883545,10,7
1483,32,1.0464103412712302,1.600892684448057,1.0010749952606888,1.002701922258401,16,24,4.543931007385254,2.2063586711883545,16,8
1483,64,0.4634119372458976,1.60032550420289,1.0001859107162112,1.0028365784198072,33,53,5.024758815765381,2.2063586711883545,31,11
1483,128,0.040169995116732964,1.4991657188898724,1.0000012257774515,1.0039759031146638,60,117,5.816469192504883,2.2063586711883545,68,11
1484,1,2.4357533953834998,2.4357533953834998,0.998069716550979,0.998069716550981,0,0,2.436504364013672,2.436504364013672,1,1
1484,2,1.6718777443352186,1.6718777443352177,1.0018043416588132,1.0018043416588147,0,0,2.512625217437744,2.436504364013672,2,2
1484,3,1.6416617881956816,1.6416617881956812,1.001840567231601,1.0018405672316026,0,0,2.6479318141937256,2.436504364013672,3,3
1484,4,1.6241043315828558,1.6241043315828592,1.0019718759134038,1.0019718759134046,0,0,2.8181300163269043,2.436504364013672,4,4
1484,8,1.553571267395994,1.5565950076351691,1.002109493497799,1.0021060919761244,3,3,3.046837329864502,2.436504364013672,5,5
1484,16,1.3538475971189188,1.4706667991004858,1.0018027029046275,1.0027921949582534,9,9,3.6297104358673096,2.436504364013672,7,7
1484,32,0.9650317180095869,1.4063033726755159,1.0012189698009906,1.0035681130694558,16,23,3.913492202758789,2.436504364013672,16,9
1484,64,0.38338095027992913,1.3456440079767156,1.000411866966968,1.0042061485362852,30,52,4.446977615356445,2.436504364013672,34,12
1484,128,0.01959642590201912,1.3444244036017776,1.0000091045240707,1.0042887581350546,66,116,5.089085102081299,2.436504364013672,62,12
1485,1,10.35353934433214,10.35353934433214,0.9217900758732832,0.9217900758732852,0,0,10.616376876831055,10.616376876831055,1,1
1485,2,8.789544419716352,8.789544419716352,0.9675572834652055,0.9675572834652069,0,0,11.571955680847168,10.616376876831055,2,2
1485,3,8.331924643711737,8.331924643711737,0.9801779194710923,0.9801779194710933,0,0,11.652482032775879,10.616376876831055,3,3
1485,4,8.298552512618489,8.29855251261849,0.9810865361228049,0.9810865361228056,0,0,11.758907318115234,10.616376876831055,4,4
1485,8,6.834189348192691,6.836409501266911,1.0212371985544295,1.0211433582477085,1,1,12.500395774841309,10.616376876831055,7,7
1485,16,6.353320032243734,6.460078754379512,1.031589042811023,1.0337334451124747,3,5,13.036705017089844,10.616376876831055,13,11
1485,32,5.09865389668064,6.068244947472868,1.0355669583361102,1.0438078278960325,12,18,13.77134895324707,10.616376876831055,20,14
1485,64,3.6244275911354165,6.0652039005964475,1.0190567817694256,1.0445268087857615,28,49,14.54758071899414,10.616376876831055,36,15
1485,128,2.5352985186928993,5.8387193166766025,1.012517263203774,1.0533654699774722,59,114,15.165671348571777,10.616376876831055,69,14
1486,1,6.780881241176727,6.780881241176729,0.9719790022127649,0.9719790022127658,0,0,6.832864284515381,6.832864284515381,1,1
1486,2,6.051666341402147,6.051666341402147,0.9827866334894058,0.9827866334894059,0,0,6.951733589172363,6.832864284515381,2,2
1486,3,5.172483807663018,5.172483807663017,0.9942612686579823,0.9942612686579811,0,0,7.0583367347717285,6.832864284515381,3,3
1486,4,4.811942972501499,4.863277679104649,1.0000892768573832,0.9991619840136317,1,1,7.819659233093262,6.832864284515381,3,3
1486,8,4.73189585349109,4.820364166839034,1.0010177291823654,1.000750257857865,2,2,8.295452117919922,6.832864284515381,6,6
1486,16,4.567036312270198,4.80597572696441,1.00005568777534,1.0014996192990742,6,9,8.965635299682617,6.832864284515381,10,7
1486,32,3.2194854483915267,4.528466669921717,1.001622815167866,1.0074767224449173,16,24,9.401300430297852,6.832864284515381,16,8
1486,64,1.8894422055841562,4.475960535421102,1.0023278235257143,1.011798664836454,28,50,10.1513090133667,6.832864284515381,36,14
1486,128,1.0341194322489626,4.143749991191978,1.0014205307991917,1.0196732410583254,62,116,10.718734741210938,6.832864284515381,66,12
1487,1,8.803268227296787,8.80326822729678,0.9581833277879644,0.958183327787969,0,0,8.889259338378906,8.889259338378906,1,1
1487,2,8.00190296740231,8.001902967402309,0.9805121384467961,0.9805121384467992,0,0,9.424223899841309,8.889259338378906,2,2
1487,3,7.098590040979418,7.0985900409794205,0.9983875896215848,0.9983875896215882,0,0,9.742902755737305,8.889259338378906,3,3
1487,4,6.864817199964989,6.864817199964987,1.0035114037866697,1.0035114037866728,0,0,9.826498985290527,8.889259338378906,4,4
1487,8,6.3546593559645945,6.475632836722549,1.0140935344070352,1.0128152001206625,1,2,10.213483810424805,8.889259338378906,7,6
1487,16,5.487716103486762,5.995106067929837,1.0304336859747485,1.0250433537852335,7,7,10.812922477722168,8.889259338378906,9,9
1487,32,4.334938045949215,5.592139958959629,1.0292872578942307,1.0346709295626257,14,18,11.44793701171875,8.889259338378906,18,14
1487,64,3.324931422090927,5.322863792553774,1.0191266707986533,1.0434422431979207,32,46,12.014287948608398,8.889259338378906,32,18
1487,128,2.1410434402341174,5.237227057645861,1.005124140426008,1.0459225904760845,63,109,12.885847091674805,8.889259338378906,65,19
1488,1,10.185097551790593,10.185097551790601,0.9540431048118116,0.9540431048118149,0,0,10.275761604309082,10.275761604309082,1,1
1488,2,8.821347324820419,8.82134732482042,0.9857363842354068,0.9857363842354085,0,0,11.03707218170166,10.275761604309082,2,2
1488,3,7.932635579942363,7.932635579942363,1.0092474754709166,1.0092474754709175,0,0,11.962356567382812,10.275761604309082,3,3
1488,4,7.9033849725634155,7.9033849725634155,1.0104841180148443,1.010484118014845,0,0,12.02308464050293,10.275761604309082,4,4
1488,8,7.340815339577919,7.356334937618134,1.0255160529732197,1.0253984883956748,1,1,12.360190391540527,10.275761604309082,7,7
1488,16,6.919240127306647,7.161208256496949,1.0313024354507627,1.030370028235427,5,5,13.141100883483887,10.275761604309082,11,11
1488,32,5.497295048371942,7.042317401398241,1.0451371660212885,1.0354172847551735,13,19,13.959592819213867,10.275761604309082,19,13
1488,64,4.426083329110123,7.012199741265068,1.0392693923634793,1.0392865712177324,28,46,14.614628791809082,10.275761604309082,36,18
1488,128,2.8416219985255387,6.745137694534457,1.0155943113914618,1.0554963520254197,61,110,15.538202285766602,10.275761604309082,67,18
1489,1,9.696955364896976,9.696955364896983,0.9350281417019097,0.9350281417019128,0,0,9.885068893432617,9.885068893432617,1,1
1489,2,7.946078393176552,7.946078393176553,0.9719998238622789,0.9719998238622796,0,0,10.181225776672363,9.885068893432617,2,2
1489,3,7.208137815651896,7.208137815651896,0.9858456041016341,0.9858456041016355,0,0,10.274286270141602,9.885068893432617,3,3
1489,4,6.8010793842598565,6.8010793842598565,0.9988814100958087,0.9988814100958094,0,0,10.626629829406738,9.885068893432617,4,4
1489,8,6.63302492731434,6.667032104156859,1.0039415945412364,1.0032449584995133,1,2,11.512306213378906,9.885068893432617,7,6
1489,16,5.533456403525025,5.919691443229314,1.0265853825907982,1.022254981496058,6,7,11.824020385742188,9.885068893432617,10,9
1489,32,4.912969302571172,5.683914100041068,1.0328060788926707,1.0318933058008404,16,18,12.318991661071777,9.885068893432617,16,14
1489,64,3.797053524559576,5.201089592457899,1.03346723707795,1.048728597295429,32,48,12.851829528808594,9.885068893432617,32,16
1489,128,2.5886194129205027,4.996778899290174,1.019575998737288,1.056984915837007,64,111,13.584782600402832,9.885068893432617,64,17
1490,1,9.387099513883506,9.387099513883507,0.9445350119914315,0.9445350119914336,0,0,9.532486915588379,9.532486915588379,1,1
1490,2,7.211148551651276,7.211148551651277,0.9959497718699645,0.9959497718699659,0,0,10.166915893554688,9.532486915588379,2,2
1490,3,7.138444932899383,7.138444932899384,0.9975124400727451,0.997512440072747,0,0,10.279648780822754,9.532486915588379,3,3
1490,4,6.8883039525211585,6.8883039525211585,1.0054494632886963,1.0054494632886966,0,0,10.349502563476562,9.532486915588379,4,4
1490,8,6.0862621776044055,6.24434630022924,1.0192590897406077,1.0162100779752463,2,2,10.597318649291992,9.532486915588379,6,6
1490,16,5.316799575684707,5.663238932712533,1.032483893021254,1.0274689796057694,6,7,11.113515853881836,9.532486915588379,10,9
1490,32,4.848892267201886,5.655262562614514,1.027350822496462,1.0282133016321098,16,23,11.727513313293457,9.532486915588379,16,9
1490,64,3.6947187391805563,5.353688311094462,1.0218428577376613,1.0375525852495,31,49,12.296270370483398,9.532486915588379,33,15
1490,128,2.2397769043520976,5.284081902114826,1.0077500026415311,1.0392392031415632,63,117,12.919153213500977,9.532486915588379,65,11
1491,1,8.123105136225053,8.123105136225057,0.9720006345648543,0.9720006345648572,0,0,8.166813850402832,8.166813850402832,1,1
1491,2,5.8933248276697565,5.8933248276697565,1.0061244630527626,1.006124463052763,0,0,8.186817169189453,8.166813850402832,2,2
1491,3,5.564162216776355,5.564162216776355,1.0093290333862828,1.0093290333862828,0,0,8.212735176086426,8.166813850402832,3,3
1491,4,5.277209477058052,5.277209477058051,1.0149903812760621,1.0149903812760621,0,0,8.595539093017578,8.166813850402832,4,4
1491,8,4.55108367782136,4.554516428787501,1.026177261877398,1.0259422727149174,1,1,9.134054183959961,8.166813850402832,7,7
1491,16,4.301235982659684,4.428993833772572,1.027400494677611,1.029661818122142,4,6,10.42572021484375,8.166813850402832,12,10
1491,32,3.6337603457875645,4.339093922346453,1.0218761784395523,1.0337191716441079,12,20,11.18507194519043,8.166813850402832,20,12
1491,64,2.825277243418177,4.251900590551655,1.0169606825585158,1.0401178910771098,25,47,11.892165184020996,8.166813850402832,39,17
1491,128,1.528277860933832,4.250556983879822,1.004483747186229,1.040523646457111,57,110,12.873812675476074,8.166813850402832,71,18
1492,1,9.713488009672615,9.71348800967256,0.9464456449116453,0.9464456449116481,0,0,9.846177101135254,9.846177101135254,1,1
1492,2,9.629596688879923,9.629596688879928,0.950074214242383,0.9500742142423853,0,0,10.249886512756348,9.846177101135254,2,2
1492,3,6.700199788179078,6.700199788179077,1.0098143677002969,1.0098143677002989,0,0,10.394742965698242,9.846177101135254,3,3
1492,4,6.699733189675664,6.699733189675662,1.0098755762171614,1.0098755762171634,0,0,10.438366889953613,9.846177101135254,4,4
1492,8,6.0840890765064435,6.266734790615202,1.0173278036287212,1.0166509592316024,4,3,10.977482795715332,9.846177101135254,4,5
1492,16,5.783213598426125,6.216300981630517,1.016720766590188,1.017475693695885,6,9,11.633804321289062,9.846177101135254,10,7
1492,32,5.343831972589625,6.113577186785986,1.017706103590458,1.0214824639670403,14,24,12.013362884521484,9.846177101135254,18,8
1492,64,3.8642202343683802,5.964300064870199,1.013936613843028,1.0306699999655695,29,51,12.903351783752441,9.846177101135254,35,13
1492,128,1.9530655446676388,5.923210575293137,1.0030527695005076,1.0323786964214834,64,114,13.61697769165039,9.846177101135254,64,14
1493,1,9.632630953208286,9.632630953208286,0.9415589272808199,0.9415589272808202,0,0,9.789445877075195,9.789445877075195,1,1
1493,2,8.565794050370293,8.565794050370293,0.961237773969136,0.9612377739691356,0,0,9.937445640563965,9.789445877075195,2,2
1493,3,7.077578425513054,7.077578425513054,0.9884126650748375,0.9884126650748372,0,0,9.961627960205078,9.789445877075195,3,3
1493,4,6.9894835816346585,6.989850662473948,0.9919356603088487,0.9919347629478329,1,1,10.346548080444336,9.789445877075195,3,3
1493,8,6.698538830860426,6.698538830860426,1.0003901699021123,1.0003901699021116,0,0,10.932394981384277,9.789445877075195,8,8
1493,16,5.736063182606748,5.849631500089924,1.0201539159461257,1.0201204174573393,4,6,11.460200309753418,9.789445877075195,12,10
1493,32,5.039953290036078,5.7643607189911945,1.021627401624009,1.0231441965781207,15,20,12.18377685546875,9.789445877075195,17,12
1493,64,3.591380339202201,5.6807360057730945,1.0110963138051736,1.0263684638339163,30,51,12.921765327453613,9.789445877075195,34,13
1493,128,2.016306354146291,5.667542289360829,1.0029520254508884,1.0273414966942238,65,114,13.68140983581543,9.789445877075195,63,14
1494,1,10.17931417442535,10.179314174425354,0.930453655704894,0.930453655704896,0,0,10.395614624023438,10.395614624023438,1,1
1494,2,9.49213837760033,9.492138377600334,0.9504198944684237,0.9504198944684248,0,0,10.968306541442871,10.395614624023438,2,2
1494,3,9.119435079419016,9.119435079419015,0.9591851947752768,0.9591851947752785,0,0,11.097936630249023,10.395614624023438,3,3
1494,4,8.805062782956789,8.805062782956789,0.9674776156499024,0.9674776156499025,0,0,11.185554504394531,10.395614624023438,4,4
1494,8,8.16611393555681,8.168406337727214,0.9825805130787029,0.9824626028721724,2,2,11.480305671691895,10.395614624023438,6,6
1494,16,7.221513246311733,7.375734567379997,1.0046187126552657,1.0037709758164992,3,8,11.830856323242188,10.395614624023438,13,8
1494,32,6.163639872384618,6.9368461369263725,1.0164155959158911,1.017818101248497,14,22,12.117588996887207,10.395614624023438,18,10
1494,64,4.9723989526511305,6.844965402374749,1.018845252097862,1.0225950215466055,26,52,12.570762634277344,10.395614624023438,38,12
1494,128,3.34641669746847,6.667111175086611,1.0109110485019952,1.0334222948803382,72,109,13.005836486816406,10.395614624023438,56,19
1495,1,7.130055257852503,7.130055257852509,0.979467274071451,0.9794672740714537,0,0,7.157369136810303,7.157369136810303,1,1
1495,2,6.225045783062666,6.225045783062666,0.9971901998644422,0.9971901998644446,0,0,8.39659595489502,7.157369136810303,2,2
1495,3,6.12933122354213,6.12933122354213,1.001139353728713,1.0011393537287154,0,0,9.474763870239258,7.157369136810303,3,3
1495,4,6.060686309142761,6.060686309142759,1.0033966400714003,1.0033966400714023,0,0,9.48532772064209,7.157369136810303,4,4
1495,8,5.006892667436773,5.006892667436769,1.020403660915618,1.0204036609156206,0,0,10.07291030883789,7.157369136810303,8,8
1495,16,4.573691092906378,4.9202443815387005,1.0195572308335843,1.0244766675566246,6,8,10.21796989440918,7.157369136810303,10,8
1495,32,4.005060877675496,4.818361499661878,1.0241333474235517,1.0288739172312154,15,19,10.823470115661621,7.157369136810303,17,13
1495,64,2.824521766996573,4.737311629954825,1.0138284148047811,1.0310533506111628,28,51,11.438258171081543,7.157369136810303,36,13
1495,128,1.7383248478663023,4.6322235522940245,1.0033571092877025,1.0349805616974774,70,115,12.196700096130371,7.157369136810303,58,13
1496,1,7.198574826844992,7.1985748268449905,0.9700026690943794,0.9700026690943805,0,0,7.256918907165527,7.256918907165527,1,1
1496,2,5.931761793040748,5.931761793040716,0.9931296134690488,0.9931296134690492,0,0,8.56908130645752,7.256918907165527,2,2
1496,3,5.476250931284489,5.476250931284488,1.0034279112548528,1.0034279112548534,0,0,8.697232246398926,7.256918907165527,3,3
1496,4,5.050558898712873,5.056160403469334,1.0087580120902384,1.0086552364564993,1,1,8.86862564086914,7.256918907165527,3,3
1496,8,5.009619528029657,5.052429379541604,1.0084368038659783,1.009012811950474,4,4,9.28198528289795,7.256918907165527,4,4
1496,16,4.257153349819713,4.502992786259601,1.017710837605363,1.0208311029103718,8,10,9.663280487060547,7.256918907165527,8,6
1496,32,3.798784327791193,4.501256955381157,1.0133439441250551,1.0210319358942552,15,24,10.04241943359375,7.256918907165527,17,8
1496,64,2.442605348526454,4.424313783122855,1.0076727836285326,1.023893163864236,27,53,10.550375938415527,7.256918907165527,37,11
1496,128,1.1737890819656391,4.35339538198803,1.0018741126887059,1.028461174778594,61,114,11.296088218688965,7.256918907165527,67,14
1497,1,6.042500866533062,6.042500866533063,0.9791963931365416,0.9791963931365425,0,0,6.075124263763428,6.075124263763428,1,1
1497,2,4.665789768634409,4.665789768634409,0.9989924336633482,0.9989924336633493,0,0,6.683663368225098,6.075124263763428,2,2
1497,3,4.640789094606725,4.640789094606725,1.0006414139214368,1.0006414139214383,0,0,8.021012306213379,6.075124263763428,3,3
1497,4,4.630441710158486,4.630441710158487,1.0010991025182423,1.0010991025182436,0,0,8.100630760192871,6.075124263763428,4,4
1497,8,4.406496741148165,4.427765989041235,1.0065007959135017,1.006405806887532,3,3,8.764293670654297,6.075124263763428,5,5
1497,16,3.906840472868419,4.326086400285092,1.0082475113764986,1.0096966625459192,7,10,9.545960426330566,6.075124263763428,9,6
1497,32,3.328628447440121,4.0864013490137205,1.006238721254853,1.0155945293741329,12,22,10.09720230102539,6.075124263763428,20,10
1497,64,2.3580358485546125,3.888948256902754,1.0041243000057338,1.0227439415390163,31,51,10.956938743591309,6.075124263763428,33,13
1497,128,1.3868762421848488,3.877157398426437,1.0009283468423136,1.0233133034189645,58,114,11.656624794006348,6.075124263763428,70,14
1498,1,6.554526275998538,6.554526275998539,0.9806048537174864,0.9806048537174884,0,0,6.5801544189453125,6.5801544189453125,1,1
1498,2,5.80853677212745,5.808536772127452,0.9928914861688702,0.9928914861688711,0,0,8.22650146484375,6.5801544189453125,2,2
1498,3,5.178852830817027,5.178852830817027,1.0062627154838042,1.0062627154838053,0,0,8.30711555480957,6.5801544189453125,3,3
1498,4,5.01338287309201,5.013382873092009,1.0086567522931824,1.0086567522931833,0,0,8.383009910583496,6.5801544189453125,4,4
1498,8,4.800691231509773,4.824051561680448,1.0125784783492617,1.0128928532477088,2,3,9.07143783569336,6.5801544189453125,6,5
1498,16,4.670735129494117,4.7923406862443745,1.014400596899715,1.014013153045218,6,8,9.91556453704834,6.5801544189453125,10,8
1498,32,4.233972485754306,4.735692582026323,1.0123038975719487,1.0168578575362348,14,20,10.383735656738281,6.5801544189453125,18,12
1498,64,3.480084433304806,4.5322479693763,1.0153046561239822,1.0238346022563811,31,51,10.887431144714355,6.5801544189453125,33,13
1498,128,2.0998586682911755,4.52165192217581,1.0042873748076302,1.025102936817254,60,114,11.700481414794922,6.5801544189453125,68,14
1499,1,10.89189222984328,10.89189222984328,0.9212553020386768,0.9212553020386791,0,0,11.134187698364258,11.134187698364258,1,1
1499,2,8.665527482081766,8.66552748208177,0.9743770137478953,0.9743770137478978,0,0,11.181746482849121,11.134187698364258,2,2
1499,3,7.943513569146142,7.943513569146143,0.99468432920173,0.994684329201732,0,0,12.020045280456543,11.134187698364258,3,3
1499,4,7.933070291995221,7.943513569146142,0.994494819199684,0.994684329201732,1,1,12.265527725219727,11.134187698364258,3,3
1499,8,7.382681427158344,7.48382574330765,1.0122671115279527,1.0104090297043844,2,2,13.647802352905273,11.134187698364258,6,6
1499,16,6.767813090281978,6.935535819292531,1.033159277923134,1.0323573726109354,3,7,14.088652610778809,11.134187698364258,13,9
1499,32,5.81544636869282,6.90278460758227,1.033281201562616,1.034849059891463,14,20,14.736710548400879,11.134187698364258,18,12
1499,64,4.992351853697136,6.704790847975667,1.0183170566119808,1.039593498777338,30,51,15.452238082885742,11.134187698364258,34,13
1499,128,2.717135476872453,6.701820866619893,1.007123536178694,1.0403813545232121,66,114,16.231826782226562,11.134187698364258,62,14
1500,1,6.465541320239907,6.465541320239906,0.9689372598121926,0.9689372598121939,0,0,6.536694049835205,6.536694049835205,1,1
1500,2,6.260107158004373,6.260107158004375,0.9714073618058809,0.9714073618058818,0,0,6.658417224884033,6.536694049835205,2,2
1500,3,6.2107728811958545,6.2107728811958545,0.9720740956338616,0.9720740956338616,0,0,6.688112258911133,6.536694049835205,3,3
1500,4,6.2008762342079295,6.2107728811958545,0.9720776595285197,0.9720740956338616,1,1,6.715795993804932,6.536694049835205,3,3
1500,8,6.033486933873803,6.066448684145253,0.9736704220412173,0.9736486527581525,3,3,6.833197116851807,6.536694049835205,5,5
1500,16,5.526224644002767,5.77213405012072,0.9790156191302467,0.9780512347859317,7,9,6.9666829109191895,6.536694049835205,9,7
1500,32,5.1032658592591105,5.608154213862897,0.9847818152462073,0.9819072168565894,16,22,7.189370155334473,6.536694049835205,16,10
1500,64,4.159521334557561,5.523285077049091,0.9848842796453079,0.9846081835425351,26,53,7.430820941925049,6.536694049835205,38,11
1500,128,2.671740416566776,5.521441712146378,0.9907536014250127,0.9848927253305902,69,117,7.668644905090332,6.536694049835205,59,11
1501,1,7.069203232702539,7.069203232702541,0.9733760900372268,0.9733760900372277,0,0,7.113557815551758,7.113557815551758,1,1
1501,2,6.464700108153139,6.464700108153139,0.9858660967259387,0.9858660967259391,0,0,8.56229305267334,7.113557815551758,2,2
1501,3,5.820528948358637,5.820528948358637,0.9994805876899867,0.9994805876899864,0,0,8.837910652160645,7.113557815551758,3,3
1501,4,5.764445212880667,5.764445212880666,1.0009319515426038,1.000931951542603,0,0,9.086764335632324,7.113557815551758,4,4
1501,8,5.358302456498461,5.362691823161004,1.0099154529614787,1.0098874313045803,1,3,10.040884017944336,7.113557815551758,7,5
1501,16,4.946081556120179,5.205779672027685,1.0117812198054206,1.014829548516473,5,8,10.553324699401855,7.113557815551758,11,8
1501,32,3.5177110080579994,4.825030963769052,1.0100443977539217,1.0269556199642094,13,21,11.28097915649414,7.113557815551758,19,11
1501,64,2.6846849788812066,4.645418305501432,1.0061001993074004,1.0326979617955268,34,51,12.185943603515625,7.113557815551758,30,13
1501,128,1.811711143482043,4.62313187994528,1.0014518156922239,1.0336398909500875,60,115,13.078985214233398,7.113557815551758,68,13
1502,1,9.27034277996399,9.27034277996399,0.9565381524356699,0.9565381524356711,0,0,9.360118865966797,9.360118865966797,1,1
1502,2,7.563351969770922,7.563351969770914,0.991277677011822,0.9912776770118236,0,0,9.666221618652344,9.360118865966797,2,2
1502,3,6.649871639491439,6.649871639491439,1.0081636735628337,1.0081636735628343,0,0,10.201266288757324,9.360118865966797,3,3
1502,4,5.923332218226958,5.923332218226958,1.0199100517863862,1.0199100517863853,0,0,10.32421588897705,9.360118865966797,4,4
1502,8,5.8494869575165955,5.849486957516599,1.0212788906229426,1.021278890622941,0,0,10.55721378326416,9.360118865966797,8,8
1502,16,5.2540149341150615,5.66104009305218,1.025935838246789,1.0235732597819869,5,6,11.094270706176758,9.360118865966797,11,10
1502,32,4.692399848188886,5.498127481046328,1.0286166965104073,1.0288613236577553,12,16,11.579645156860352,9.360118865966797,20,16
1502,64,3.527378314456448,5.3540196125789965,1.0172614257909212,1.0304198044843411,33,48,12.214302062988281,9.360118865966797,31,16
1502,128,1.912098563445556,5.296983521204897,1.0072626313680682,1.0326891705644132,60,110,12.840749740600586,9.360118865966797,68,18
1503,1,7.617479735028942,7.617479735028943,0.97533845383987,0.975338453839872,0,0,7.652989864349365,7.652989864349365,1,1
1503,2,6.6798878055209165,6.679887805520917,0.9874258620014917,0.9874258620014928,0,0,7.75657320022583,7.652989864349365,2,2
1503,3,6.21800328663946,6.218003286639459,0.9953747350163757,0.9953747350163764,0,0,7.859227657318115,7.652989864349365,3,3
1503,4,5.717683078970685,5.717683078970684,1.0021356588253416,1.0021356588253425,0,0,7.920060157775879,7.652989864349365,4,4
1503,8,4.393383901797314,4.393383901797316,1.0184915564744226,1.018491556474422,0,0,8.231045722961426,7.652989864349365,8,8
1503,16,4.257845727287933,4.266580740626003,1.0222411598674372,1.0220700335473438,4,5,8.829383850097656,7.652989864349365,12,11
1503,32,3.5199955204518028,4.159682597391258,1.0151985859802066,1.0255282912113892,12,18,9.661417007446289,7.652989864349365,20,14
1503,64,2.9428963412504565,4.021899033157891,1.0117738299740802,1.0288529778827018,32,50,10.353397369384766,7.652989864349365,32,14
1503,128,1.8458977258457732,3.9950317370139237,1.0010263533000907,1.0308403886780824,65,108,11.004154205322266,7.652989864349365,63,20
1504,1,7.54786218104047,7.547862181040471,0.9655051305135316,0.9655051305135333,0,0,7.6172356605529785,7.6172356605529785,1,1
1504,2,6.5736539058445125,6.5736539058445125,0.9828365514987725,0.9828365514987729,0,0,7.969624042510986,7.6172356605529785,2,2
1504,3,5.912845218051865,5.9128452180518645,0.9943879690987367,0.9943879690987361,0,0,8.153502464294434,7.6172356605529785,3,3
1504,4,5.669279548569581,5.669279548569581,0.9980875907483729,0.9980875907483728,0,0,8.31519603729248,7.6172356605529785,4,4
1504,8,5.380056090090604,5.428384090204636,1.0031774946668586,1.0034595804932667,1,1,9.07674789428711,7.6172356605529785,7,7
1504,16,4.83681776036787,5.147257560477664,1.0125166660927583,1.0100313172755855,5,5,9.306455612182617,7.6172356605529785,11,11
1504,32,4.07315144298509,5.014454285755523,1.0160397309144944,1.014203952132451,12,20,10.126826286315918,7.6172356605529785,20,12
1504,64,2.8067816286078493,4.962606446786998,1.0068390654113804,1.0171252471965422,24,47,10.660614967346191,7.6172356605529785,40,17
1504,128,1.6853308689399247,4.863789166350387,1.0036966064007644,1.0240543802153397,61,109,11.373577117919922,7.6172356605529785,67,19
1505,1,4.592781097567628,4.592781097567628,0.9863064613824949,0.9863064613824949,0,0,4.6120076179504395,4.6120076179504395,1,1
1505,2,4.0224762823449876,4.0224762823449876,0.9921203174910844,0.9921203174910836,0,0,4.730968475341797,4.6120076179504395,2,2
1505,3,3.8454668524975837,3.845466852497605,0.9945374619706018,0.9945374619706004,0,0,4.808552265167236,4.6120076179504395,3,3
1505,4,3.7976924307450965,3.797692430745095,0.9948884388096045,0.9948884388096033,0,0,5.181914329528809,4.6120076179504395,4,4
1505,8,3.5290249456614617,3.529024945661461,0.9984183274800156,0.9984183274800138,0,0,5.663827896118164,4.6120076179504395,8,8
1505,16,2.6382634935496077,2.8142604511292713,1.0085646236030024,1.009061698619842,5,9,6.48739767074585,4.6120076179504395,11,7
1505,32,2.1340544976816904,2.6386609207516085,1.005355358825347,1.0112625368535355,13,21,7.378553867340088,4.6120076179504395,19,11
1505,64,1.5003468224725967,2.6256890537156687,1.0036494077892988,1.0121222817429787,30,51,8.040533065795898,4.6120076179504395,34,13
1505,128,0.558724791809013,2.6139793570812446,1.0006907666935487,1.0136350628787525,68,112,9.006978988647461,4.6120076179504395,60,16
1506,1,9.829807369380003,9.829807369380003,0.9445211560553058,0.9445211560553068,0,0,9.967254638671875,9.967254638671875,1,1
1506,2,8.456110487096874,8.456110487096876,0.9727657388370947,0.9727657388370954,0,0,10.062483787536621,9.967254638671875,2,2
1506,3,8.084963224042543,8.084963224042543,0.980983508663007,0.9809835086630072,0,0,10.100836753845215,9.967254638671875,3,3
1506,4,7.028642461974859,7.028642461974859,1.000202929419308,1.0002029294193087,0,0,10.22193717956543,9.967254638671875,4,4
1506,8,6.796067624998055,6.9034380292931115,1.003971482314506,1.003492146799044,1,1,10.852018356323242,9.967254638671875,7,7
1506,16,6.02085033236908,6.2102013093881405,1.0298930787425533,1.029409098126524,4,7,11.951138496398926,9.967254638671875,12,9
1506,32,5.003799299732728,5.86730866073021,1.027408723121297,1.0381147057839957,11,17,12.625195503234863,9.967254638671875,21,15
1506,64,3.757135660109158,5.86730866073021,1.0082539628320044,1.0381147057839957,30,49,13.357889175415039,9.967254638671875,34,15
1506,128,2.569526758083505,5.864182340517479,1.0009181812001051,1.0390521864039104,62,111,14.213080406188965,9.967254638671875,66,17
1507,1,4.486040013001349,4.486040013001352,0.9852702440576395,0.9852702440576412,0,0,4.508769512176514,4.508769512176514,1,1
1507,2,3.405862443923367,3.405862443923348,0.994100664222211,0.9941006642222128,0,0,4.851551532745361,4.508769512176514,2,2
1507,3,3.012130958680479,3.0121309586804794,0.9988055386036221,0.9988055386036239,0,0,5.216085910797119,4.508769512176514,3,3
1507,4,2.9131494894845886,2.913149489484588,0.9998365684667669,0.9998365684667684,0,0,5.279379844665527,4.508769512176514,4,4
1507,8,2.3635119428298443,2.378767620788249,1.0050515075377353,1.0051300594970947,2,3,5.671395301818848,4.508769512176514,6,5
1507,16,1.8353315410093654,2.222198462761278,1.0064126288462616,1.0080122346791118,7,6,6.1167097091674805,4.508769512176514,9,10
1507,32,1.475221464318382,1.9991745379746215,1.0050522466113385,1.0114168025891352,15,21,6.811225414276123,4.508769512176514,17,11
1507,64,1.1201605768326148,1.977426001367979,1.0018276830537258,1.0123073145979564,32,50,7.401607990264893,4.508769512176514,32,14
1507,128,0.42190177165458087,1.9771280242826423,1.0001432419435319,1.0124349248004316,57,111,8.314194679260254,4.508769512176514,71,17
1508,1,8.820524835134163,8.820524835134167,0.9568139782269569,0.9568139782269586,0,0,8.916242599487305,8.916242599487305,1,1
1508,2,8.108593088116343,8.108593088116345,0.9715797944350951,0.9715797944350962,0,0,9.451869010925293,8.916242599487305,2,2
1508,3,7.436837335081579,7.43683733508158,0.9870277494544242,0.9870277494544235,0,0,9.788212776184082,8.916242599487305,3,3
1508,4,7.203889000521261,7.2038890005212615,0.991304089342294,0.9913040893422949,0,0,9.834654808044434,8.916242599487305,4,4
1508,8,7.058833768427341,7.05883376842734,0.9962906141979588,0.9962906141979601,0,0,10.20753288269043,8.916242599487305,8,8
1508,16,6.326851197204017,6.737640978505652,1.0080032034891568,1.0067053758322608,5,5,10.639444351196289,8.916242599487305,11,11
1508,32,4.96845631065395,6.177736920769142,1.0228765437240566,1.0198080778317182,14,21,10.932988166809082,8.916242599487305,18,11
1508,64,3.8991424586154557,5.935331922151447,1.020955076522168,1.02773492256515,28,50,11.305678367614746,8.916242599487305,36,14
1508,128,1.9895283252704814,5.913207408354867,1.0029611447753144,1.028017488857153,67,113,11.873530387878418,8.916242599487305,61,15
1509,1,10.82065661478328,10.820656614783285,0.9312304320463222,0.9312304320463238,0,0,11.014974594116211,11.014974594116211,1,1
1509,2,8.871871811102537,8.871871811102539,0.9803698502961395,0.9803698502961415,0,0,11.404210090637207,11.014974594116211,2,2
1509,3,8.598378915443199,8.598378915443199,0.9852332572469124,0.985233257246912,0,0,11.499722480773926,11.014974594116211,3,3
1509,4,8.328233496902131,8.32823349690213,0.9931895718583331,0.9931895718583333,0,0,12.40757942199707,11.014974594116211,4,4
1509,8,7.603677718033216,7.668270917934559,1.0148924460367874,1.0118492208447045,1,1,12.785614967346191,11.014974594116211,7,7
1509,16,6.981176208136929,7.57122598857547,1.021828993063222,1.0154974200420686,6,8,13.483681678771973,11.014974594116211,10,8
1509,32,5.984620514547825,7.476984847594213,1.020065785256301,1.020740114899977,13,21,14.227952003479004,11.014974594116211,19,11
1509,64,4.8090243051208175,7.367705381370632,1.0165745753183222,1.0267179257944832,28,52,14.62663459777832,11.014974594116211,36,12
1509,128,2.927478400333509,7.171287325855527,1.0060234357406843,1.033417040203911,65,117,15.401165962219238,11.014974594116211,63,11
1510,1,9.001320690242368,9.001320690242373,0.9525280196474385,0.952528019647441,0,0,9.113183975219727,9.113183975219727,1,1
1510,2,6.848118978714358,6.84811897871436,0.9930519794421625,0.9930519794421653,0,0,9.393969535827637,9.113183975219727,2,2
1510,3,6.498621773318,6.498621773318,1.0010386224124574,1.001038622412461,0,0,9.619485855102539,9.113183975219727,3,3
1510,4,5.800011795423296,5.80001179542331,1.0128844644031245,1.0128844644031272,0,0,9.942209243774414,9.113183975219727,4,4
1510,8,5.539654478162187,5.58285926046323,1.0174983204673236,1.0170857332311327,2,2,10.532440185546875,9.113183975219727,6,6
1510,16,4.791169347998077,5.286342457152108,1.0301602302547745,1.0271040458753435,4,6,10.97477912902832,9.113183975219727,12,10
1510,32,4.074015521493839,5.2211646598969885,1.0270237606663957,1.0298349017497077,13,20,11.684442520141602,9.113183975219727,19,12
1510,64,2.8415066859778033,5.115865898729876,1.012481543827791,1.0350457299035407,28,51,12.550251007080078,9.113183975219727,36,13
1510,128,1.8225513281070853,5.006609071436561,1.0018453155050664,1.0417107740472744,65,107,13.123891830444336,9.113183975219727,63,21
1511,1,9.657003152500096,9.657003152500097,0.9388455350099452,0.9388455350099453,0,0,9.830453872680664,9.830453872680664,1,1
1511,2,8.03365350808128,8.033653508081281,0.9749911529818093,0.9749911529818092,0,0,10.43510913848877,9.830453872680664,2,2
1511,3,7.966943232803599,7.9669432328036,0.9769057290439629,0.9769057290439631,0,0,10.529947280883789,9.830453872680664,3,3
1511,4,7.624205947836227,7.624205947836226,0.9841196831103414,0.984119683110338,0,0,10.76377010345459,9.830453872680664,4,4
1511,8,7.131241735872189,7.1483179951657005,1.0025006992144863,1.0018890684657094,2,2,11.83808708190918,9.830453872680664,6,6
1511,16,6.86621569680944,7.073452030324438,1.0035133189826997,1.0047686233879896,6,7,12.688639640808105,9.830453872680664,10,9
1511,32,5.782723722841348,6.67413985393535,1.0102371741826985,1.0182008609454534,15,21,13.316960334777832,9.830453872680664,17,11
1511,64,3.891576421687,6.506714347468731,1.0139063060747064,1.0260259573315413,32,51,14.041234970092773,9.830453872680664,32,13
1511,128,2.378403284667675,6.501851814782676,1.0076865569440854,1.0273075982032291,68,115,14.913442611694336,9.830453872680664,60,13
1512,1,7.001144757514816,7.001144757514817,0.9681797515489616,0.9681797515489624,0,0,7.067562580108643,7.067562580108643,1,1
1512,2,6.512313850714592,6.512313850714593,0.979209633494512,0.9792096334945115,0,0,7.804841041564941,7.067562580108643,2,2
1512,3,5.930086316447351,5.930086316447352,0.9867534795098298,0.9867534795098301,0,0,7.88353157043457,7.067562580108643,3,3
1512,4,5.483843600584866,5.483843600584866,0.9946956280849097,0.9946956280849092,0,0,8.345084190368652,7.067562580108643,4,4
1512,8,4.5949361537973505,4.648128362452542,1.0127443072780755,1.0124441626373901,3,4,8.7755708694458,7.067562580108643,5,4
1512,16,3.8719102115094164,4.347022105364181,1.0163881651221232,1.016959117300516,4,8,9.116759300231934,7.067562580108643,12,8
1512,32,3.5427826119471097,4.299132955209105,1.0151980463319799,1.0184650353722176,13,22,9.861663818359375,7.067562580108643,19,10
1512,64,2.412597884394268,4.286295788073011,1.003124045967453,1.0196972894036058,30,52,10.59146785736084,7.067562580108643,34,12
1512,128,1.3518466383749537,4.232387776092849,1.0005132843868103,1.0227621991076061,61,114,11.377714157104492,7.067562580108643,67,14
1513,1,7.219678086290669,7.219678086290667,0.9634799259978778,0.9634799259978803,0,0,7.302767753601074,7.302767753601074,1,1
1513,2,6.242487088606919,6.242487088606921,0.9849922118570265,0.984992211857028,0,0,8.187783241271973,7.302767753601074,2,2
1513,3,5.285690217978253,5.285690217978253,1.001612253517902,1.0016122535179028,0,0,8.319221496582031,7.302767753601074,3,3
1513,4,5.227120785646924,5.227120785646923,1.002343080712599,1.0023430807126006,0,0,8.532990455627441,7.302767753601074,4,4
1513,8,4.854796743559531,4.878235368740072,1.0115816225420808,1.010730947924956,2,2,8.696468353271484,7.302767753601074,6,6
1513,16,4.477336476137723,4.578641570481964,1.0194275134106878,1.0188422050342862,4,6,9.180621147155762,7.302767753601074,12,10
1513,32,3.909020677483112,4.185051195068184,1.0235027811261497,1.0240734412924322,12,18,9.793659210205078,7.302767753601074,20,14
1513,64,2.654078677925802,4.129177603941547,1.0128553352436438,1.027905380980613,29,45,10.64875316619873,7.302767753601074,35,19
1513,128,1.6395570967402662,4.070210805901246,1.0049730041740186,1.029517280305679,64,109,11.489828109741211,7.302767753601074,64,19
1514,1,9.375691548778985,9.375691548778983,0.9537707939932704,0.95377079399327,0,0,9.476613998413086,9.476613998413086,1,1
1514,2,7.605048893552843,7.605048893552843,0.9875674673618895,0.9875674673618899,0,0,9.785340309143066,9.476613998413086,2,2
1514,3,7.075156463964465,7.075156463964466,0.9986820860102099,0.9986820860102096,0,0,9.818047523498535,9.476613998413086,3,3
1514,4,6.122147757632238,6.122147757632238,1.0170758227623313,1.0170758227623309,0,0,10.01590347290039,9.476613998413086,4,4
1514,8,5.674131240551273,5.67413124055127,1.0231991211623161,1.023199121162318,0,0,10.793527603149414,9.476613998413086,8,8
1514,16,5.3342975627952365,5.672637521503896,1.0217562469708072,1.0235630510599443,6,6,11.209946632385254,9.476613998413086,10,10
1514,32,4.537925423414902,5.589029106310384,1.0230369242346855,1.0290608031352262,15,20,12.031926155090332,9.476613998413086,17,12
1514,64,3.6134550409672643,5.482003434762549,1.0137625164822932,1.0368181569297383,31,49,12.825459480285645,9.476613998413086,33,15
1514,128,2.5559055619330726,5.341981671741279,1.0042204553259095,1.045134496108715,65,110,13.478324890136719,9.476613998413086,63,18
1515,1,3.190225484911154,3.1902254849111427,0.9924389786709116,0.992438978670913,0,0,3.198777437210083,3.198777437210083,1,1
1515,2,2.432030819468522,2.4320308194685225,0.9968035606502328,0.9968035606502337,0,0,3.3119852542877197,3.198777437210083,2,2
1515,3,2.271166757733891,2.2711667577338917,0.9980610517776967,0.9980610517776978,0,0,3.7100636959075928,3.198777437210083,3,3
1515,4,2.2682173120804525,2.2682173120804525,0.9980599656986128,0.9980599656986135,0,0,3.73126220703125,3.198777437210083,4,4
1515,8,1.9034545594286147,1.957193311895032,1.0013089225261522,1.0010419725917337,2,3,4.202277183532715,3.198777437210083,6,5
1515,16,1.772897887087782,1.9230337323400306,1.001499843520914,1.0020095334130086,6,8,4.56749963760376,3.198777437210083,10,8
1515,32,1.3667431476475531,1.8763711302932315,1.0020327890093006,1.003873701295045,13,21,5.061313629150391,3.198777437210083,19,11
1515,64,0.7746489831114496,1.7992954169269735,1.0002840255708283,1.005207199830216,27,50,5.562877178192139,3.198777437210083,37,14
1515,128,0.10711363218308341,1.7572115433878768,1.0002674062548957,1.0059645042780203,65,114,6.1881279945373535,3.198777437210083,63,14
1516,1,7.060449647170018,7.060449647170022,0.9738383869521169,0.9738383869521188,0,0,7.10417366027832,7.10417366027832,1,1
1516,2,6.101452570086301,6.101452570086303,0.9886982377225496,0.9886982377225507,0,0,7.566280364990234,7.10417366027832,2,2
1516,3,5.4729270740422225,5.4729270740422225,0.9986725953092714,0.9986725953092723,0,0,8.011560440063477,7.10417366027832,3,3
1516,4,5.454587938742076,5.454587938742076,0.9999580639453929,0.9999580639453939,0,0,8.468097686767578,7.10417366027832,4,4
1516,8,5.329393116663489,5.330762888547246,1.0028215358171835,1.0028887759498946,1,1,8.71717643737793,7.10417366027832,7,7
1516,16,4.8427407591755625,4.872220024474184,1.012032419313838,1.012030870864876,4,5,9.047564506530762,7.10417366027832,12,11
1516,32,4.055218493975679,4.526544077661458,1.017963644056536,1.0204305181005107,15,19,9.550858497619629,7.10417366027832,17,13
1516,64,2.8822186199674844,4.431979420928925,1.0099939052909828,1.0234914285588732,32,49,10.010438919067383,7.10417366027832,32,15
1516,128,1.5366011050279238,4.376718626236606,1.0014578921752668,1.0261461390832594,60,107,10.642621994018555,7.10417366027832,68,21
1517,1,6.053211780343435,6.0532117803434256,0.978995944597497,0.9789959445975,0,0,6.085067272186279,6.085067272186279,1,1
1517,2,4.9051409713669765,4.905140971366977,0.994222511129291,0.9942225111292926,0,0,6.618321895599365,6.085067272186279,2,2
1517,3,4.487449896714259,4.48744989671426,1.0006060010591376,1.0006060010591389,0,0,6.791879653930664,6.085067272186279,3,3
1517,4,4.398257247526555,4.398257247526555,1.0024938733030182,1.0024938733030193,0,0,7.031991004943848,6.085067272186279,4,4
1517,8,3.3394428838296775,3.344041485551136,1.0128752722445,1.0131546002252576,2,2,7.406326770782471,6.085067272186279,6,6
1517,16,3.061502545369994,3.1351938884474118,1.0162520208730996,1.0167270460292634,5,6,8.08594799041748,6.085067272186279,11,10
1517,32,2.441791578833434,3.1349907985531935,1.0099958903100494,1.0168400091507417,13,20,8.71380615234375,6.085067272186279,19,12
1517,64,1.9339636101565414,2.968038908541633,1.0072895833555626,1.0244850790760427,32,45,9.68934440612793,6.085067272186279,32,19
1517,128,1.147526135118637,2.9680389085416348,1.0003804347420293,1.024485079076042,60,109,10.680757522583008,6.085067272186279,68,19
1518,1,9.003090424438922,9.003090424438925,0.9558388266434449,0.9558388266434471,0,0,9.098315238952637,9.098315238952637,1,1
1518,2,8.287631692732067,8.287631692732054,0.9716593667605435,0.9716593667605447,0,0,9.620908737182617,9.098315238952637,2,2
1518,3,7.541427188415025,7.541427188415021,0.984190065958457,0.9841900659584593,0,0,9.831194877624512,9.098315238952637,3,3
1518,4,7.454483092573388,7.454483092573388,0.9873519166690817,0.9873519166690832,0,0,10.061854362487793,9.098315238952637,4,4
1518,8,5.8003602512312185,5.950841737688635,1.0181699885749422,1.0170966791454117,1,1,11.024867057800293,9.098315238952637,7,7
1518,16,5.223068863459166,5.950841737688635,1.011999200295905,1.0170966791454117,7,9,11.949764251708984,9.098315238952637,9,7
1518,32,4.561589501930934,5.90003106454823,1.01746931732833,1.0229129098975953,16,19,12.688088417053223,9.098315238952637,16,13
1518,64,3.6865599214051006,5.871346252587245,1.0088395015011946,1.0263066845566773,30,50,13.620370864868164,9.098315238952637,34,14
1518,128,2.508924638592439,5.853794149101664,1.0047584311549569,1.0287062013446815,62,114,14.436795234680176,9.098315238952637,66,14
1519,1,7.241000508800412,7.241000508800412,0.9691289496163654,0.9691289496163652,0,0,7.3000006675720215,7.3000006675720215,1,1
1519,2,6.17417028495415,6.174170284954151,0.9888033421475776,0.9888033421475775,0,0,7.716668128967285,7.3000006675720215,2,2
1519,3,5.789843897225302,5.789843897225302,0.9965105551625641,0.996510555162564,0,0,8.515359878540039,7.3000006675720215,3,3
1519,4,5.440647333549722,5.440647333549723,1.0018152371501392,1.0018152371501392,0,0,8.540987968444824,7.3000006675720215,4,4
1519,8,4.610044671353261,4.62098682659869,1.0153165343877046,1.015442686418367,1,1,9.113845825195312,7.3000006675720215,7,7
1519,16,4.293589612003187,4.366173764540032,1.0232411106538635,1.0223478540419404,4,5,9.861730575561523,7.3000006675720215,12,11
1519,32,3.6602233707275844,4.2097124193432105,1.0241395733195693,1.0257055014780687,14,21,10.329216003417969,7.3000006675720215,18,11
1519,64,2.8728401927228853,4.178526282871085,1.01829983710802,1.0269740744345646,30,50,10.880568504333496,7.3000006675720215,34,14
1519,128,1.6818417819578193,4.108741342310994,1.004285912384416,1.029618948963945,61,110,11.723630905151367,7.3000006675720215,67,18
1520,1,10.22839045970337,10.228390459703373,0.9427538934225926,0.942753893422594,0,0,10.372481346130371,10.372481346130371,1,1
1520,2,8.24327266877206,8.24327266877206,0.9804310317708029,0.9804310317708029,0,0,10.389458656311035,10.372481346130371,2,2
1520,3,7.821042052817735,7.8210420528177345,0.991766163067846,0.991766163067846,0,0,10.554458618164062,10.372481346130371,3,3
1520,4,7.681646855950045,7.681646855950045,0.9937633668082223,0.9937633668082233,0,0,10.598894119262695,10.372481346130371,4,4
1520,8,6.267849234859135,6.505105295200022,1.0226715009144285,1.019547987096948,1,1,11.094507217407227,10.372481346130371,7,7
1520,16,5.689498653208944,6.26174186465743,1.027988132280369,1.0263258246863725,7,8,11.76314926147461,10.372481346130371,9,8
1520,32,4.626815811962474,5.8478355999598985,1.0238375235975572,1.0413095874928247,12,21,12.691398620605469,10.372481346130371,20,11
1520,64,3.2392868508036576,5.794815297352538,1.013469959321061,1.0446585921189822,31,52,13.876887321472168,10.372481346130371,33,12
1520,128,2.3730379512568662,5.7817298683033345,1.0081411394277624,1.0461488361797522,58,115,14.916351318359375,10.372481346130371,70,13
1521,1,9.093696878180117,9.09369687818012,0.9478975797413421,0.9478975797413429,0,0,9.226791381835938,9.226791381835938,1,1
1521,2,7.492902557427978,7.4929025574279775,0.9814672816709542,0.9814672816709542,0,0,9.282137870788574,9.226791381835938,2,2
1521,3,6.502192535187002,6.502192535187003,1.0016159459455258,1.0016159459455247,0,0,9.425056457519531,9.226791381835938,3,3
1521,4,5.560734419632815,5.560734419632817,1.0172473788309648,1.0172473788309633,0,0,9.459900856018066,9.226791381835938,4,4
1521,8,5.160995445121778,5.178418545665102,1.0216822255873461,1.021460076693098,1,1,9.710958480834961,9.226791381835938,7,7
1521,16,4.617922312997991,4.834690137022943,1.0286576066789994,1.0272563558279142,4,5,10.344406127929688,9.226791381835938,12,11
1521,32,4.23569219281008,4.741755438913326,1.0306453534417646,1.0313537266077373,14,17,11.138869285583496,9.226791381835938,18,15
1521,64,2.9501865275434915,4.735285119730212,1.0118701487429567,1.0322677346617255,28,48,11.757033348083496,9.226791381835938,36,16
1521,128,1.7725497027069204,4.726168191369786,1.0078424658713887,1.0337809354679064,61,108,12.27737808227539,9.226791381835938,67,20
1522,1,7.377491378931385,7.377491378931388,0.9663866864300639,0.966386686430065,0,0,7.448782444000244,7.448782444000244,1,1
1522,2,6.048622441715432,6.048622441715434,0.9832262355674243,0.9832262355674257,0,0,7.506101131439209,7.448782444000244,2,2
1522,3,5.6345175553304685,5.634517555330469,0.9901721779559174,0.9901721779559185,0,0,7.5792717933654785,7.448782444000244,3,3
1522,4,5.620011658602512,5.634517555330469,0.9896869772092078,0.9901721779559185,1,1,7.63247537612915,7.448782444000244,3,3
1522,8,4.678905689489047,4.777286964296367,1.005311304470205,1.0056169971478746,1,1,7.991552829742432,7.448782444000244,7,7
1522,16,3.9062344967832505,4.339086503507159,1.013140745115103,1.0136784724568597,4,8,8.431486129760742,7.448782444000244,12,8
1522,32,3.354841857207185,4.327055940516657,1.0107446527539334,1.0143467305545608,14,20,9.103738784790039,7.448782444000244,18,12
1522,64,2.135358035950933,4.24798210610608,1.0011546958586837,1.0173410166547316,31,49,9.620244979858398,7.448782444000244,33,15
1522,128,1.0740923924652392,4.209341269379517,1.0012381242874415,1.0184779207773218,66,113,10.254424095153809,7.448782444000244,62,15
1523,1,11.021784569404463,11.021784569404472,0.9374540884024193,0.9374540884024221,0,0,11.176675796508789,11.176675796508789,1,1
1523,2,9.556132858656515,9.55613285865651,0.9754765652204587,0.9754765652204608,0,0,11.62746524810791,11.176675796508789,2,2
1523,3,8.022021523406165,8.022021523406165,1.0046003600362647,1.0046003600362652,0,0,11.664399147033691,11.176675796508789,3,3
1523,4,7.957393391682878,7.957393391682878,1.0072530615381685,1.0072530615381685,0,0,11.743804931640625,11.176675796508789,4,4
1523,8,6.950887162575516,6.95091799141017,1.032213333522544,1.032229992710883,1,1,12.27881908416748,11.176675796508789,7,7
1523,16,6.517177805676868,6.565978793262539,1.0384663726047116,1.0395702493155041,5,6,12.698891639709473,11.176675796508789,11,10
1523,32,5.81332828289817,6.253274486664073,1.0426344839793802,1.0485296707041434,14,18,13.233087539672852,11.176675796508789,18,14
1523,64,4.589716847713819,6.130174729688958,1.0355047580534644,1.0510662922079264,30,48,13.702731132507324,11.176675796508789,34,16
1523,128,2.716063909473556,6.113239479205121,1.0101897044152381,1.052758472084177,57,109,14.199095726013184,11.176675796508789,71,19
1524,1,9.418344171611178,9.418344171611185,0.9467246744678233,0.9467246744678255,0,0,9.551920890808105,9.551920890808105,1,1
1524,2,8.02449299184906,8.02449299184906,0.9829587404422133,0.9829587404422133,0,0,9.730639457702637,9.551920890808105,2,2
1524,3,7.869886909164283,7.869886909164281,0.9891226679136206,0.9891226679136205,0,0,10.815621376037598,9.551920890808105,3,3
1524,4,7.633856842387951,7.633856842387952,0.9959306075551223,0.9959306075551227,0,0,11.031489372253418,9.551920890808105,4,4
1524,8,7.585829422861454,7.633499528662226,0.9963427359217507,0.9960353920509014,2,2,11.298493385314941,9.551920890808105,6,6
1524,16,6.836789309655084,7.499202079130978,1.0099528741629622,1.0017055532552632,6,9,11.687275886535645,9.551920890808105,10,7
1524,32,5.4127840425289895,6.946609708500182,1.015335582576892,1.012629659702444,12,26,12.09592056274414,9.551920890808105,20,6
1524,64,4.025667009560793,6.758308226333872,1.0130316167802471,1.0225974322171336,29,52,12.672903060913086,9.551920890808105,35,12
1524,128,2.638718967427814,6.5245357006337334,1.007553816357846,1.0322507966668084,62,112,13.219972610473633,9.551920890808105,66,16
1525,1,10.581898341689177,10.581898341689183,0.9438026075224139,0.9438026075224165,0,0,10.70580005645752,10.70580005645752,1,1
1525,2,8.830685026215665,8.830685026215665,0.985063546599273,0.9850635465992732,0,0,11.075502395629883,10.70580005645752,2,2
1525,3,7.8378378656261205,7.837837865626122,1.006085897146708,1.006085897146707,0,0,11.40884017944336,10.70580005645752,3,3
1525,4,7.834849625320768,7.837837865626122,1.0060649650732407,1.006085897146707,1,1,12.451669692993164,10.70580005645752,3,3
1525,8,7.155076109973947,7.388438301072134,1.0203336301353039,1.0177262358118495,2,2,12.985175132751465,10.70580005645752,6,6
1525,16,6.173865625526127,6.748611856730462,1.0423674485562346,1.0408309491032415,5,4,13.742588996887207,10.70580005645752,11,12
1525,32,5.455473608367708,6.499263555335557,1.0420156570752284,1.0484521608091881,15,17,14.619205474853516,10.70580005645752,17,15
1525,64,4.044413347716508,6.436424069152311,1.029040566186704,1.051457425950042,30,46,15.227226257324219,10.70580005645752,34,18
1525,128,2.6665530379577587,6.4144495312466505,1.0136347061822137,1.0531407540558502,60,112,15.880844116210938,10.70580005645752,68,16
1526,1,12.185005393577711,12.18500539357772,0.8882615287509824,0.8882615287509857,0,0,12.616288185119629,12.616288185119629,1,1
1526,2,11.18184864381053,11.181848643810536,0.9205529966742201,0.9205529966742219,0,0,12.874515533447266,12.616288185119629,2,2
1526,3,11.044020374759398,11.044020374759402,0.9248725126409734,0.924872512640975,0,0,12.972404479980469,12.616288185119629,3,3
1526,4,10.878911823400646,10.878911823400648,0.9318806155510152,0.9318806155510161,0,0,13.148104667663574,12.616288185119629,4,4
1526,8,10.583094927222907,10.585346875604383,0.9444304414732653,0.9443739211857863,1,1,13.687257766723633,12.616288185119629,7,7
1526,16,9.660165121040086,9.83821706798282,0.9715621580689318,0.9735495800770597,6,7,14.075840950012207,12.616288185119629,10,9
1526,32,8.58240672372677,9.503552882725014,0.9759167502230865,0.988654473861736,15,20,14.960541725158691,12.616288185119629,17,12
1526,64,6.74889406955759,9.27701070605103,0.9907782986037618,1.0002316719422795,33,52,15.773155212402344,12.616288185119629,31,12
1526,128,4.23650846908218,9.052916788202998,0.9892047488205793,1.0149045930235747,65,117,16.6787109375,12.616288185119629,63,11
1527,1,10.601634284758124,10.601634284758124,0.9318554752181173,0.9318554752181173,0,0,10.805564880371094,10.805564880371094,1,1
1527,2,8.762472678263633,8.762472678263633,0.9776547938393926,0.977654793839392,0,0,11.049877166748047,10.805564880371094,2,2
1527,3,8.0009823978854,8.0009823978854,0.9990230805073095,0.9990230805073068,0,0,11.482295989990234,10.805564880371094,3,3
1527,4,7.735139114307217,7.735139114307219,1.005067186036842,1.0050671860368412,0,0,11.719498634338379,10.805564880371094,4,4
1527,8,6.944671965799433,6.951831382691631,1.0196020109837287,1.0201537058297658,1,1,11.984463691711426,10.805564880371094,7,7
1527,16,6.3117188590060636,6.760848583694273,1.0299263689525264,1.0255762099136574,4,6,12.374632835388184,10.805564880371094,12,10
1527,32,5.736987089487777,6.735157815503774,1.0250591502281796,1.027170844060726,15,21,12.774580001831055,10.805564880371094,17,11
1527,64,4.321832750615683,6.575956355669744,1.0196978581765863,1.033129075250221,30,49,13.108513832092285,10.805564880371094,34,15
1527,128,2.409566211987665,6.431227551717771,1.0082331993847102,1.0398402934257036,61,111,13.409467697143555,10.805564880371094,67,17
1528,1,3.3207255200271217,3.320725520027122,0.9945500187370221,0.9945500187370225,0,0,3.325026512145996,3.325026512145996,1,1
1528,2,2.766182112163387,2.766182112163387,0.9983162201617679,0.9983162201617678,0,0,3.4001431465148926,3.325026512145996,2,2
1528,3,2.430374656632166,2.430374656632166,1.0007921740434118,1.000792174043411,0,0,3.4906678199768066,3.325026512145996,3,3
1528,4,2.146069728735793,2.1460697287357933,1.0025377067972676,1.0025377067972672,0,0,3.5724103450775146,3.325026512145996,4,4
1528,8,2.0420004409397103,2.0605660180456686,1.0025192490707349,1.002792274660994,1,1,3.861466884613037,3.325026512145996,7,7
1528,16,1.6279872663910797,1.8251087255857221,1.0017665981358062,1.0041386686375482,6,9,4.251729965209961,3.325026512145996,10,7
1528,32,1.2909743695684321,1.8058565937203506,1.0004195377589353,1.004641092875087,18,22,4.588364124298096,3.325026512145996,14,10
1528,64,0.5293678919090931,1.7537602206998983,1.0005501672077375,1.0060746987064242,32,53,4.9934773445129395,3.325026512145996,32,11
1528,128,0.03645028280993265,1.720733141102075,1.0000046240267602,1.0061736292901533,58,117,5.6168413162231445,3.325026512145996,70,11
1529,1,10.394915774694399,10.394915774694404,0.9386827362424512,0.9386827362424535,0,0,10.555684089660645,10.555684089660645,1,1
1529,2,8.683749572388733,8.683749572388733,0.98299578381348,0.9829957838134817,0,0,10.817907333374023,10.555684089660645,2,2
1529,3,8.672424626039708,8.683749572388733,0.9826891085382652,0.9829957838134817,1,1,11.422430992126465,10.555684089660645,2,2
1529,4,7.715364955708254,7.715364955708253,1.0078284607357002,1.0078284607357006,0,0,11.95604133605957,10.555684089660645,4,4
1529,8,7.076844823477017,7.096150794354124,1.02390936679802,1.0246768182248458,2,2,12.551464080810547,10.555684089660645,6,6
1529,16,6.39732747070436,7.047393076085879,1.0176245000550614,1.026593177789366,5,8,13.975589752197266,10.555684089660645,11,8
1529,32,5.845080587729365,6.963105944233456,1.0273291016033244,1.0362003546783882,12,18,14.52330493927002,10.555684089660645,20,14
1529,64,4.376760014938852,6.947274419636295,1.018302731541459,1.037874565046836,26,50,15.704973220825195,10.555684089660645,38,14
1529,128,2.7043748142563326,6.901048805930025,1.012470894495316,1.0415518046087247,60,113,17.130273818969727,10.555684089660645,68,15
1530,1,11.635480886166143,11.63548088616615,0.9111177661290951,0.9111177661290975,0,0,11.949405670166016,11.949405670166016,1,1
1530,2,10.839340575286027,10.839340575286029,0.9368104944603555,0.9368104944603566,0,0,12.355892181396484,11.949405670166016,2,2
1530,3,10.768461463153645,10.768461463153647,0.9388833312164173,0.9388833312164184,0,0,12.414529800415039,11.949405670166016,3,3
1530,4,10.728717335360503,10.728717335360505,0.9405405702925534,0.9405405702925541,0,0,12.516300201416016,11.949405670166016,4,4
1530,8,10.075061659038685,10.156758991263331,0.964491040518634,0.9614624584264444,3,3,13.028797149658203,11.949405670166016,5,5
1530,16,9.50719113659392,9.977470763020147,0.9781979873372338,0.9696370200865352,5,9,13.346516609191895,11.949405670166016,11,7
1530,32,8.071637498346655,9.082074735894103,1.007984783511886,1.001272418949379,17,23,13.872285842895508,11.949405670166016,15,9
1530,64,4.82689853784771,8.55283680844296,1.010479175986601,1.0214849547379452,29,52,14.676228523254395,11.949405670166016,35,12
1530,128,3.1183328651847777,8.442381584911395,1.0059508648336735,1.0262756179593118,65,117,15.316537857055664,11.949405670166016,63,11
1531,1,9.436592357542445,9.436592357542445,0.9498207561834301,0.9498207561834302,0,0,9.555505752563477,9.555505752563477,1,1
1531,2,7.499671740204766,7.499671740204765,0.9889780297948021,0.9889780297948019,0,0,9.821189880371094,9.555505752563477,2,2
1531,3,7.097422408186201,7.097422408186201,0.9957025859156199,0.9957025859156194,0,0,9.950446128845215,9.555505752563477,3,3
1531,4,7.09741446727014,7.097422408186201,0.9957194372642314,0.9957025859156189,1,1,9.967096328735352,9.555505752563477,3,3
1531,8,6.015067428923566,6.079080731537781,1.014209582842874,1.0121406354439721,2,2,10.204840660095215,9.555505752563477,6,6
1531,16,5.641806863215881,5.783862902519565,1.0212910403843087,1.0185476672688558,4,5,10.465300559997559,9.555505752563477,12,11
1531,32,4.922508247731,5.417016476750144,1.0268247944465902,1.0262489050981272,13,17,10.801198959350586,9.555505752563477,19,15
1531,64,3.6211744253913665,5.290696656122507,1.015685516090326,1.0308523328110912,32,46,11.278220176696777,9.555505752563477,32,18
1531,128,2.0051601583494496,5.263651916862392,1.0074816734900236,1.0331803537373423,60,106,11.83830451965332,9.555505752563477,68,22
1532,1,6.8214106510039745,6.821410651003977,0.9749957868474655,0.974995786847467,0,0,6.862573146820068,6.862573146820068,1,1
1532,2,5.468689692388377,5.468689692388377,0.9962963772087525,0.9962963772087525,0,0,6.891124248504639,6.862573146820068,2,2
1532,3,5.12143230600389,5.12143230600389,1.0010343933288752,1.0010343933288737,0,0,6.99240779876709,6.862573146820068,3,3
1532,4,4.859594826368914,4.859594826368914,1.0042286607200166,1.0042286607200168,0,0,7.082821846008301,6.862573146820068,4,4
1532,8,4.449810313230742,4.452254362552156,1.0097226830590227,1.0095888909456725,1,1,7.588770389556885,6.862573146820068,7,7
1532,16,3.4891735254141323,3.7456655268829473,1.0166576827924712,1.0166651964286841,6,8,8.000144004821777,6.862573146820068,10,8
1532,32,2.912495737761566,3.5570845059997036,1.0182839313885816,1.0207740191340693,14,20,8.59518051147461,6.862573146820068,18,12
1532,64,2.158144250882587,3.469388977668483,1.0071623810846415,1.022645924806155,28,50,9.315130233764648,6.862573146820068,36,14
1532,128,1.120876218440827,3.4484751213375375,1.0026726988338757,1.0234692003531525,67,113,10.14967155456543,6.862573146820068,61,15
1533,1,8.550149403797011,8.550149403797015,0.9547787863392229,0.9547787863392262,0,0,8.655922889709473,8.655922889709473,1,1
1533,2,7.1620484019660235,7.162048401966026,0.9847392987028921,0.9847392987028944,0,0,9.460561752319336,8.655922889709473,2,2
1533,3,6.9055460230254155,6.905546023025417,0.9896563016512455,0.9896563016512474,0,0,9.501935005187988,8.655922889709473,3,3
1533,4,6.560855228442091,6.56085522844209,0.9959453297684646,0.9959453297684655,0,0,9.544169425964355,8.655922889709473,4,4
1533,8,6.190001010264391,6.220040165563574,1.00479349232213,1.0040207485044892,2,3,9.836490631103516,8.655922889709473,6,5
1533,16,5.367788191763419,6.159418048627692,1.0147595316322362,1.00626298375107,4,10,10.502045631408691,8.655922889709473,12,6
1533,32,4.850136016848747,6.113497119860177,1.0140149943610652,1.0087627015499712,14,23,11.244040489196777,8.655922889709473,18,9
1533,64,3.161047334366083,6.036331814966008,1.0095926536786268,1.015796324522762,28,51,11.809432983398438,8.655922889709473,36,13
1533,128,1.827481745359372,5.7386465647665785,1.0024579645198428,1.028130335255962,58,117,12.499455451965332,8.655922889709473,70,11
1534,1,6.838868552060584,6.838868552060585,0.9723585405932116,0.9723585405932125,0,0,6.888553142547607,6.888553142547607,1,1
1534,2,6.229643482701255,6.229643482701256,0.9871280479859226,0.9871280479859226,0,0,8.891329765319824,6.888553142547607,2,2
1534,3,5.858951209367612,5.8589512093676115,0.9982885209066601,0.9982885209066585,0,0,8.909061431884766,6.888553142547607,3,3
1534,4,5.505866211660208,5.505866211660207,1.0038298783040198,1.0038298783040194,0,0,8.98629379272461,6.888553142547607,4,4
1534,8,5.009155418610536,5.188097733258455,1.0055795029155594,1.0080052472304006,2,2,9.180464744567871,6.888553142547607,6,6
1534,16,4.73858599747716,4.8838013578071005,1.0115886970716956,1.012767321105715,4,7,9.56162166595459,6.888553142547607,12,9
1534,32,3.869399013643177,4.653515799698684,1.0154006647005833,1.0188736974450772,14,20,9.993261337280273,6.888553142547607,18,12
1534,64,2.8851446682948962,4.3934010865508615,1.0081407038796462,1.022206351711839,28,53,10.652078628540039,6.888553142547607,36,11
1534,128,1.655326235596905,4.3930919822674275,1.0008412035517371,1.022282785729645,59,116,11.66511058807373,6.888553142547607,69,12
1535,1,6.82224183452988,6.822241834529861,0.974860208151686,0.9748602081516877,0,0,6.863369941711426,6.863369941711426,1,1
1535,2,5.900924651340201,5.900924651340202,0.992511469082406,0.9925114690824068,0,0,7.6525092124938965,6.863369941711426,2,2
1535,3,4.88442896400237,4.88442896400237,1.00567540822709,1.005675408227091,0,0,7.925494194030762,6.863369941711426,3,3
1535,4,4.853946581427519,4.85394658142752,1.0060172766083018,1.0060172766083018,0,0,7.962456703186035,6.863369941711426,4,4
1535,8,4.290470102904694,4.500403940130433,1.008850432428853,1.0096951282975422,3,2,8.519011497497559,6.863369941711426,5,6
1535,16,3.828142433450784,4.029731016702128,1.0180260185792402,1.0191103821352168,6,8,9.199697494506836,6.863369941711426,10,8
1535,32,3.317771086135944,3.8470598704679184,1.0165876406724565,1.022900887236146,15,22,9.886686325073242,6.863369941711426,17,10
1535,64,2.6335264868731314,3.8394054892133944,1.008279418384895,1.0241303728614066,32,50,10.680270195007324,6.863369941711426,32,14
1535,128,1.6127152208102082,3.828300415460225,1.0014460998298258,1.0245896520848354,65,114,11.518852233886719,6.863369941711426,63,14
1536,1,9.953867763354816,9.953867763354818,0.9466222260157144,0.9466222260157157,0,0,10.078493118286133,10.078493118286133,1,1
1536,2,8.090204822249875,8.090204822249875,0.9960352287443877,0.9960352287443885,0,0,11.563955307006836,10.078493118286133,2,2
1536,3,7.69322662086004,7.693226620860044,1.005296508736624,1.0052965087366244,0,0,11.90555477142334,10.078493118286133,3,3
1536,4,7.231014657441583,7.231014657441583,1.015638582872313,1.0156385828723127,0,0,11.951691627502441,10.078493118286133,4,4
1536,8,6.769094904853885,6.832120545263972,1.0251695430534795,1.0255016144209357,2,2,12.52741813659668,10.078493118286133,6,6
1536,16,6.095120917056345,6.574390145381247,1.038123916068694,1.038287328426993,6,7,13.484278678894043,10.078493118286133,10,9
1536,32,5.174681210515196,6.546016052933229,1.034900453982361,1.0412337099674747,13,21,14.225122451782227,10.078493118286133,19,11
1536,64,3.8173044431005785,6.483134944119094,1.015609080164564,1.0452369175839287,26,50,15.163972854614258,10.078493118286133,38,14
1536,128,2.4930010986442146,6.475715467679281,1.005364397026891,1.0463300801825115,62,111,16.021211624145508,10.078493118286133,66,17
1537,1,6.739603587167855,6.739603587167848,0.9815022719741552,0.9815022719741584,0,0,6.762134075164795,6.762134075164795,1,1
1537,2,6.251772376641296,6.251772376641298,0.9897121311225723,0.9897121311225747,0,0,7.676208019256592,6.762134075164795,2,2
1537,3,5.991436196633416,5.991436196633381,0.9928200506448114,0.9928200506448119,0,0,8.006612777709961,6.762134075164795,3,3
1537,4,5.082140150362819,5.082140150362819,1.0039682937378558,1.0039682937378567,0,0,8.254291534423828,6.762134075164795,4,4
1537,8,4.84278633024397,4.88053037207463,1.0106342249864437,1.0097462016027314,1,2,9.196897506713867,6.762134075164795,7,6
1537,16,3.9529555382624775,4.139142750254948,1.0233490673202577,1.0221126126089382,5,7,9.457958221435547,6.762134075164795,11,9
1537,32,3.578856218029872,4.037129114970269,1.0220009948260866,1.0242832878524328,11,21,10.013245582580566,6.762134075164795,21,11
1537,64,2.2304934226622914,3.991039581720097,1.0096519374390875,1.0259760854610205,36,53,10.707545280456543,6.762134075164795,28,11
1537,128,1.1441835574130428,3.939081022535039,1.003013243466303,1.0284780318184348,57,116,11.454034805297852,6.762134075164795,71,12
1538,1,9.403982095068327,9.403982095068327,0.9664027126296668,0.9664027126296677,0,0,9.456171035766602,9.456171035766602,1,1
1538,2,7.148609093647715,7.148609093647715,1.0047815392720936,1.004781539272094,0,0,9.475560188293457,9.456171035766602,2,2
1538,3,6.441879779055097,6.441879779055097,1.0185734820506456,1.0185734820506451,0,0,9.673151969909668,9.456171035766602,3,3
1538,4,6.379439100841691,6.379439100841691,1.0193912822980415,1.019391282298041,0,0,9.914637565612793,9.456171035766602,4,4
1538,8,5.444359856026765,5.4443598560267645,1.027490334630759,1.0274903346307593,0,0,10.449748039245605,9.456171035766602,8,8
1538,16,4.8608288243330176,5.3645560460515815,1.0294100697380477,1.028844022597871,6,6,11.105902671813965,9.456171035766602,10,10
1538,32,4.55353553452482,5.319546542942356,1.0290304400439,1.031978541071624,14,20,11.789031982421875,9.456171035766602,18,12
1538,64,3.7282918222507675,5.216407338511036,1.0261262736843697,1.0363166203236587,30,51,12.472735404968262,9.456171035766602,34,13
1538,128,2.2024308232868854,5.181716159915079,1.0141237800084293,1.0374510316057604,65,111,13.187116622924805,9.456171035766602,63,17
1539,1,7.552935369981544,7.5529353699815465,0.9667543397152956,0.9667543397152975,0,0,7.6193952560424805,7.6193952560424805,1,1
1539,2,6.198379293023818,6.198379293023818,0.9897213789225945,0.9897213789225952,0,0,7.7098774909973145,7.6193952560424805,2,2
1539,3,5.750722119373572,5.750722119373571,0.9959133154856411,0.9959133154856421,0,0,7.804177761077881,7.6193952560424805,3,3
1539,4,5.663311077983707,5.663311077983708,0.9983409964796575,0.9983409964796579,0,0,8.2141752243042,7.6193952560424805,4,4
1539,8,4.902485629583813,4.915268250494074,1.0109845276273617,1.0102169714175988,1,2,8.74467945098877,7.6193952560424805,7,6
1539,16,4.192476840820805,4.254815079103197,1.0187514182331452,1.0188452335788876,5,4,9.073019981384277,7.6193952560424805,11,12
1539,32,3.7798336239583517,4.099705963904758,1.0191878766232252,1.0216401952370437,15,15,9.45235538482666,7.6193952560424805,17,17
1539,64,3.1974160484994276,4.090880650649078,1.0136268996517055,1.022238933259819,29,45,10.109709739685059,7.6193952560424805,35,19
1539,128,1.744021094981013,4.061690296415404,1.0033327484276924,1.0248140232826295,57,106,10.991708755493164,7.6193952560424805,71,22
1540,1,7.811410274640406,7.811410274640406,0.9650730052898701,0.9650730052898706,0,0,7.882927417755127,7.882927417755127,1,1
1540,2,6.971771218298888,6.971771218298889,0.9822938335470125,0.9822938335470135,0,0,8.69521713256836,7.882927417755127,2,2
1540,3,5.722672212137982,5.722672212137983,1.003324981963392,1.0033249819633914,0,0,8.707659721374512,7.882927417755127,3,3
1540,4,5.245824826986624,5.245824826986594,1.010768920440363,1.0107689204403627,0,0,9.012770652770996,7.882927417755127,4,4
1540,8,4.9939962889296465,5.245824826986594,1.010457535165198,1.0107689204403627,3,4,9.958334922790527,7.882927417755127,5,4
1540,16,4.111863790283616,5.027872976371473,1.0127614353179828,1.0173597408246424,7,10,10.456890106201172,7.882927417755127,9,6
1540,32,3.4642627621237554,4.829312102379069,1.0154891730693123,1.0238739122288394,14,23,10.93106746673584,7.882927417755127,18,9
1540,64,2.4575158847135548,4.629177240946457,1.0120083824611739,1.0307995025272114,25,51,11.46038818359375,7.882927417755127,39,13
1540,128,1.3810289348547362,4.614622518549578,1.0015693060383781,1.031506473088058,66,114,12.037412643432617,7.882927417755127,62,14
1541,1,8.005211036537498,8.005211036537503,0.9675086011337349,0.9675086011337375,0,0,8.063204765319824,8.063204765319824,1,1
1541,2,6.912616783896371,6.912616783896371,0.9852953676232009,0.9852953676232014,0,0,8.12655258178711,8.063204765319824,2,2
1541,3,6.352302942270735,6.352302942270735,0.9971838234975341,0.9971838234975345,0,0,8.912618637084961,8.063204765319824,3,3
1541,4,6.227128736343209,6.227128736343209,0.999848700756418,0.9998487007564185,0,0,9.031954765319824,8.063204765319824,4,4
1541,8,5.45815504227897,5.481647536475369,1.0105477909415188,1.0105925375814397,2,2,9.897305488586426,8.063204765319824,6,6
1541,16,4.811582907435521,5.1755918655471405,1.0214173359834762,1.0211431687925534,2,5,10.298026084899902,8.063204765319824,14,11
1541,32,4.465124161900436,5.064738144859369,1.0196645610992805,1.0245800866785322,12,19,10.715916633605957,8.063204765319824,20,13
1541,64,3.1520766085253373,4.943170874815164,1.0081168172658042,1.0284099676956777,33,47,11.530887603759766,8.063204765319824,31,17
1541,128,1.8068593463876181,4.87849143042093,1.0025006244453376,1.0293096256882295,61,110,12.082690238952637,8.063204765319824,67,18
1542,1,6.389663080662969,6.389663080662969,0.9784930970264413,0.978493097026441,0,0,6.422767162322998,6.422767162322998,1,1
1542,2,5.997898963748928,5.997898963748928,0.984854452026644,0.9848544520266433,0,0,7.144197463989258,6.422767162322998,2,2
1542,3,4.587297752254733,4.587297752254733,1.004574973638301,1.0045749736382996,0,0,7.500755786895752,6.422767162322998,3,3
1542,4,4.405282682121441,4.405282682121442,1.008094966571766,1.0080949665717642,0,0,8.124080657958984,6.422767162322998,4,4
1542,8,4.374226749545667,4.380792882628529,1.0085735246562317,1.0090073599123792,2,1,8.26546859741211,6.422767162322998,6,7
1542,16,3.6962803607460466,3.838545775211404,1.017368548179801,1.0184580057459078,6,4,8.533964157104492,6.422767162322998,10,12
1542,32,3.0352125193473443,3.721398761107941,1.0164304295533575,1.0222694989346586,16,17,9.175383567810059,6.422767162322998,16,15
1542,64,2.1569714339280965,3.667367286541096,1.0085543144328724,1.0229041347645658,32,50,9.82717227935791,6.422767162322998,32,14
1542,128,1.0354430535203907,3.662301238818539,1.0002911442709053,1.0237421301948484,60,113,10.44935417175293,6.422767162322998,68,15
1543,1,9.396116711511558,9.39611671151156,0.9525406274034712,0.9525406274034744,0,0,9.503173828125,9.503173828125,1,1
1543,2,6.799548473377974,6.799548473377973,1.0046624329853437,1.004662432985345,0,0,10.592887878417969,9.503173828125,2,2
1543,3,6.6006879522951545,6.6006879522951545,1.0072927294247387,1.0072927294247376,0,0,10.796695709228516,9.503173828125,3,3
1543,4,6.595134398344097,6.595134398344097,1.0074473734504523,1.0074473734504505,0,0,11.000804901123047,9.503173828125,4,4
1543,8,5.833533688386575,6.0092676381123695,1.0240061710415125,1.0194322969772287,1,3,11.471294403076172,9.503173828125,7,5
1543,16,5.224101881344663,5.663491759568187,1.0289838182224658,1.0315463600768808,5,8,11.754226684570312,9.503173828125,11,8
1543,32,4.703137483447794,5.416778467100667,1.0285665904202763,1.0382807931414368,15,21,12.155013084411621,9.503173828125,17,11
1543,64,4.022094684360916,5.3865894154122245,1.018204909480682,1.0402295868292553,31,51,12.561685562133789,9.503173828125,33,13
1543,128,2.430525651171702,5.308622515349826,1.0066712540800151,1.0427038248221627,66,112,13.04100227355957,9.503173828125,62,16
1544,1,5.1647689678617095,5.164768967861709,0.9873592929283646,0.9873592929283644,0,0,5.178992748260498,5.178992748260498,1,1
1544,2,4.286633845258579,4.286633845258579,0.9978137111711243,0.9978137111711243,0,0,6.157417297363281,5.178992748260498,2,2
1544,3,4.265175351823023,4.265175351823023,0.9985860776184068,0.9985860776184067,0,0,6.4060821533203125,5.178992748260498,3,3
1544,4,3.8866091888447816,3.8874896065943068,1.0038475596579415,1.0039210520413653,1,1,6.841369152069092,5.178992748260498,3,3
1544,8,3.1578332274589935,3.4649376705027035,1.0080964617625159,1.0074714393762545,2,3,7.240386486053467,5.178992748260498,6,5
1544,16,2.8766428007564433,3.2487061945036704,1.0107134783664653,1.0135787816043964,6,7,7.612776279449463,5.178992748260498,10,9
1544,32,2.4610335805884955,3.009268369223585,1.0109418873623328,1.0161610146688151,13,23,8.243341445922852,5.178992748260498,19,9
1544,64,1.5774949554575661,3.009268369223586,1.0038986028574453,1.0161610146688151,30,55,8.965208053588867,5.178992748260498,34,9
1544,128,0.8197955801212036,3.0087564441879047,1.0017442019943537,1.0163248332558403,64,118,9.72858715057373,5.178992748260498,64,10
1545,1,10.489134741568492,10.489134741568499,0.939043546623607,0.9390435466236102,0,0,10.645333290100098,10.645333290100098,1,1
1545,2,9.235320224085124,9.235320224085129,0.9725154310469174,0.9725154310469202,0,0,11.438436508178711,10.645333290100098,2,2
1545,3,8.523992511503351,8.523992511503355,0.9901212594874562,0.990121259487459,0,0,11.525214195251465,10.645333290100098,3,3
1545,4,7.843874226263961,7.84387422626396,1.003308641014318,1.0033086410143195,0,0,11.675819396972656,10.645333290100098,4,4
1545,8,7.418721904837316,7.444932626550595,1.0131435733211676,1.013238418435109,1,1,12.048163414001465,10.645333290100098,7,7
1545,16,6.639370931129778,7.234163505140625,1.0182863147980423,1.0210331408494602,5,10,13.012636184692383,10.645333290100098,11,6
1545,32,5.7851218708672585,7.151964282247032,1.024566435432105,1.0277451060311313,14,20,13.803435325622559,10.645333290100098,18,12
1545,64,4.37587425033781,6.688583678453431,1.0242348111494086,1.043579316258425,26,51,14.843812942504883,10.645333290100098,38,13
1545,128,2.332332500387453,6.6667130358250795,1.0082297849780366,1.0457960134026452,57,114,15.820850372314453,10.645333290100098,71,14
1546,1,9.192743238697002,9.192743238697007,0.9541420567944853,0.9541420567944876,0,0,9.295816421508789,9.295816421508789,1,1
1546,2,7.548156945343763,7.548156945343763,0.9938007779893532,0.993800777989355,0,0,10.622777938842773,9.295816421508789,2,2
1546,3,7.279603666672811,7.279603666672812,1.001531228577979,1.00153122857798,0,0,11.13740348815918,9.295816421508789,3,3
1546,4,6.9744859593566595,6.974485959356659,1.0107675370220917,1.0107675370220934,0,0,11.426199913024902,9.295816421508789,4,4
1546,8,6.722733345969767,6.928964436356094,1.0097560774351275,1.0122367549889038,3,2,12.109809875488281,9.295816421508789,5,6
1546,16,5.501214783540681,5.9334515477256975,1.0386126202740131,1.0374671874821413,5,6,12.504067420959473,9.295816421508789,11,10
1546,32,5.131895270722071,5.69975974075185,1.038761916717972,1.0432152654047666,11,19,13.178910255432129,9.295816421508789,21,13
1546,64,3.659772172467864,5.6794520846383785,1.0203405375345076,1.0447012339263735,33,50,13.86682415008545,9.295816421508789,31,14
1546,128,2.1911120656116534,5.626098765652451,1.0035795512495473,1.0488071265840762,67,111,14.557427406311035,9.295816421508789,61,17
1547,1,8.531750426219578,8.531750426219581,0.9563528731728338,0.956352873172835,0,0,8.633448600769043,8.633448600769043,1,1
1547,2,7.771723807474973,7.771723807474945,0.9707647779980759,0.9707647779980764,0,0,8.71895980834961,8.633448600769043,2,2
1547,3,7.326041969800891,7.326041969800892,0.9765159619497488,0.9765159619497491,0,0,8.852413177490234,8.633448600769043,3,3
1547,4,7.1344433574544555,7.134443357454455,0.9797553830320279,0.979755383032028,0,0,8.856403350830078,8.633448600769043,4,4
1547,8,6.605998996271033,6.605998996271035,0.9898004352687355,0.9898004352687364,0,0,9.213598251342773,8.633448600769043,8,8
1547,16,5.609533077818747,5.832136872799788,1.008019051523379,1.0062831122664155,6,7,9.624815940856934,8.633448600769043,10,9
1547,32,4.516805440345351,5.174530395030929,1.0188219997708532,1.018714393557552,15,22,10.027419090270996,8.633448600769043,17,10
1547,64,3.291113647750133,4.974417069723114,1.014729733594233,1.0237601933713227,28,51,10.409563064575195,8.633448600769043,36,13
1547,128,1.849370265225736,4.915756826138693,1.0060487155499471,1.026002797131739,64,112,10.862344741821289,8.633448600769043,64,16
1548,1,3.1260826623018736,3.126082662301873,0.99641813277629,0.9964181327762913,0,0,3.1280453205108643,3.1280453205108643,1,1
1548,2,3.0119836585817517,3.011983658581752,0.9979574104361683,0.9979574104361693,0,0,3.706613540649414,3.1280453205108643,2,2
1548,3,2.502456751102103,2.502484366122345,0.9982166146302004,0.9982350736006091,1,1,3.713636875152588,3.1280453205108643,2,2
1548,4,2.49788224118135,2.498373822168872,0.9984996430225475,0.9985515381735495,1,1,3.944042682647705,3.1280453205108643,3,3
1548,8,2.277825791634077,2.4765372320346217,0.9997336759392778,0.9988712032775099,3,4,4.236496925354004,3.1280453205108643,5,4
1548,16,1.4500440805970394,1.8884944053407564,1.0012509914908985,1.0037025651672926,5,9,4.413317680358887,3.1280453205108643,11,7
1548,32,0.9426094608981823,1.8167616796070598,1.0015355748723118,1.0046516243842005,14,25,4.7412800788879395,3.1280453205108643,18,7
1548,64,0.5514357620260789,1.7382616928725936,1.0002362301581866,1.0050063028650422,30,56,5.32615852355957,3.1280453205108643,34,8
1548,128,0.037675884336520776,1.7216017973417108,1.0000258202236545,1.005342269657914,63,118,6.043277263641357,3.1280453205108643,65,10
1549,1,11.980446730670451,11.980446730670456,0.898255403850498,0.8982554038504995,0,0,12.377615928649902,12.377615928649902,1,1
1549,2,11.035747500245401,11.035747500245401,0.9290797966942519,0.9290797966942522,0,0,12.436656951904297,12.377615928649902,2,2
1549,3,10.199519595304256,10.199519595304258,0.9573261532969156,0.9573261532969166,0,0,12.522374153137207,12.377615928649902,3,3
1549,4,9.041320484411395,9.041320484411395,0.9877741918169867,0.9877741918169887,0,0,12.601256370544434,12.377615928649902,4,4
1549,8,8.797176466654385,8.845466337592956,0.9925284107088261,0.99213107585184,2,2,12.895498275756836,12.377615928649902,6,6
1549,16,8.348608396489173,8.824438132211972,0.9987536890601012,0.9936824564861766,7,8,13.107766151428223,12.377615928649902,9,8
1549,32,7.677901127773741,8.756869178592043,1.0021344592024561,0.9964345381354526,16,23,13.468177795410156,12.377615928649902,16,9
1549,64,6.017198179450829,8.327091559817346,1.010370512970302,1.010777268729679,33,52,13.687684059143066,12.377615928649902,31,12
1549,128,3.889356244175621,8.294770752229493,0.9962789574793929,1.0133929717142962,57,113,14.172663688659668,12.377615928649902,71,15
1550,1,7.987812537439349,7.987812537439348,0.9634776510457354,0.963477651045735,0,0,8.062819480895996,8.062819480895996,1,1
1550,2,6.155198310730248,6.155198310730247,0.9938515001278494,0.9938515001278492,0,0,8.297704696655273,8.062819480895996,2,2
1550,3,5.901642706869733,5.901642706869733,0.9972033033784524,0.9972033033784511,0,0,8.857804298400879,8.062819480895996,3,3
1550,4,5.8677830258167045,5.8677830258167045,0.9984531978021195,0.9984531978021194,0,0,9.10628890991211,8.062819480895996,4,4
1550,8,5.583135430856159,5.643671331884949,1.0048491420784125,1.0042547561708095,1,2,9.657597541809082,8.062819480895996,7,6
1550,16,5.1506220778345435,5.388646650050304,1.015806284682566,1.0137134373396193,5,5,10.524377822875977,8.062819480895996,11,11
1550,32,4.051867299124503,5.077631132785648,1.0141225761701316,1.0209388259701153,11,22,11.09422492980957,8.062819480895996,21,10
1550,64,2.980090168602311,4.893867605618856,1.0110314920082217,1.0273188762596703,27,46,12.002043724060059,8.062819480895996,37,18
1550,128,1.9250502518450017,4.795721434615484,1.002845431352535,1.0313355310420198,62,112,12.833455085754395,8.062819480895996,66,16
1551,1,10.208952119750679,10.208952119750682,0.9349638853427545,0.9349638853427567,0,0,10.390649795532227,10.390649795532227,1,1
1551,2,9.137896794564812,9.137896794564812,0.9674711016693351,0.9674711016693365,0,0,11.809249877929688,10.390649795532227,2,2
1551,3,8.455523988477946,8.455523988477946,0.9873948073764731,0.9873948073764747,0,0,12.631009101867676,10.390649795532227,3,3
1551,4,8.36310921091793,8.36310921091793,0.9899680035022873,0.989968003502289,0,0,12.8224515914917,10.390649795532227,4,4
1551,8,7.895595640061976,7.98117348799568,0.9978282554026636,1.000857687800823,2,3,13.628255844116211,10.390649795532227,6,5
1551,16,7.38404743227288,7.622158406560164,1.012619233623734,1.0133421890428138,7,8,14.00505256652832,10.390649795532227,9,8
1551,32,5.731421435892929,7.1834837711970865,1.0255592265909903,1.0235931919339194,14,22,14.471711158752441,10.390649795532227,18,10
1551,64,4.82457442218029,7.003102046534748,1.0271470751650704,1.0312526255994008,30,51,14.871968269348145,10.390649795532227,34,13
1551,128,3.194445732619964,6.974188579768706,1.0118938396783934,1.0310942694100376,63,116,15.249250411987305,10.390649795532227,65,12
1552,1,6.5833996063115725,6.583399606311573,0.9715592116608182,0.9715592116608192,0,0,6.639766693115234,6.639766693115234,1,1
1552,2,4.768844455849792,4.768844455849792,1.0011085027745108,1.0011085027745112,0,0,7.087924957275391,6.639766693115234,2,2
1552,3,4.5775632045544645,4.577563204554465,1.0043961201738805,1.0043961201738798,0,0,7.193450450897217,6.639766693115234,3,3
1552,4,4.569644145831517,4.569644145831517,1.0047293042510173,1.004729304251017,0,0,7.312019348144531,6.639766693115234,4,4
1552,8,4.1726361617636,4.219804599053634,1.0108079738253877,1.010579522763036,2,2,7.498476982116699,6.639766693115234,6,6
1552,16,3.8158488948776377,4.000763434618339,1.0140012804299305,1.0137591548938203,5,7,7.883899211883545,6.639766693115234,11,9
1552,32,3.293612385382916,3.7882604829526834,1.0166478536897088,1.0187832048684338,11,18,8.730829238891602,6.639766693115234,21,14
1552,64,2.3203068475904662,3.704332925563477,1.0044737887854385,1.0200520363413457,28,46,9.36260986328125,6.639766693115234,36,18
1552,128,1.1161588426788103,3.647828914780981,1.0030219615286964,1.021826258481312,54,112,10.0249662399292,6.639766693115234,74,16
1553,1,9.622144156857678,9.62214415685768,0.950543040900297,0.9505430409002978,0,0,9.735885620117188,9.735885620117188,1,1
1553,2,7.236695896331888,7.236695896331887,0.9983229364098085,0.9983229364098081,0,0,10.400689125061035,9.735885620117188,2,2
1553,3,7.166668175786143,7.166668175786143,1.0003416122982327,1.000341612298232,0,0,10.725198745727539,9.735885620117188,3,3
1553,4,7.0445376476225405,7.0445376476225405,1.0042829376641245,1.0042829376641245,0,0,10.868401527404785,9.735885620117188,4,4
1553,8,6.3488119311272095,6.360382906796505,1.0179957000556221,1.018189804330792,1,1,11.432570457458496,9.735885620117188,7,7
1553,16,5.727143062713535,6.0491180573011105,1.0267808030601169,1.027259862000459,6,6,11.753273010253906,9.735885620117188,10,10
1553,32,5.0623123760060755,5.774330908462209,1.0366861311619713,1.0355328396699353,13,17,12.236844062805176,9.735885620117188,19,15
1553,64,4.079199085146419,5.451898933885903,1.0329396529737565,1.044089740233849,26,47,12.707395553588867,9.735885620117188,38,17
1553,128,2.7800248446242923,5.2796946594729635,1.0153411571300066,1.048384667785868,63,111,13.213643074035645,9.735885620117188,65,17
1554,1,8.848298894576077,8.848298894576075,0.9570694747347246,0.9570694747347241,0,0,8.94490909576416,8.94490909576416,1,1
1554,2,8.038542465739411,8.03854246573941,0.9734614156908746,0.9734614156908736,0,0,9.1168212890625,8.94490909576416,2,2
1554,3,6.8527212468068655,6.852721246806865,0.9950727898493994,0.9950727898493971,0,0,9.537506103515625,8.94490909576416,3,3
1554,4,6.564786627519117,6.5647866275191165,0.9999299593790045,0.999929959379003,0,0,9.653398513793945,8.94490909576416,4,4
1554,8,5.729519020739942,5.733644201966736,1.0168320601563505,1.0167613717627249,1,1,10.048567771911621,8.94490909576416,7,7
1554,16,5.278282237295566,5.424904390842184,1.0202291434748756,1.0212493313617013,5,7,10.529393196105957,8.94490909576416,11,9
1554,32,4.148084870499166,5.234970727271402,1.0160880120267062,1.0265849696077027,13,20,10.845341682434082,8.94490909576416,19,12
1554,64,2.8109684640364736,4.996803935333888,1.0122645210148677,1.0319171573914128,32,47,11.416228294372559,8.94490909576416,32,17
1554,128,1.4008490566583705,4.933469517654808,1.0041465941827683,1.0350342336613458,60,108,11.89133071899414,8.94490909576416,68,20
1555,1,2.3646092966207326,2.3646092966207326,0.996441352752428,0.9964413527524298,0,0,2.3671681880950928,2.3671681880950928,1,1
1555,2,1.9073395819240737,1.9073395819240737,0.9996645172212804,0.9996645172212824,0,0,2.5632755756378174,2.3671681880950928,2,2
1555,3,1.864168809229358,1.8641688092293578,1.0002172143906531,1.000217214390654,0,0,2.774552822113037,2.3671681880950928,3,3
1555,4,1.8484541538424695,1.8484541538424697,1.0003546117990625,1.0003546117990645,0,0,2.8917477130889893,2.3671681880950928,4,4
1555,8,1.6844647435719107,1.7129941888554927,1.0010761626952176,1.001013012041474,2,3,3.1657259464263916,2.3671681880950928,6,5
1555,16,1.3772778148593814,1.5065499471658461,1.0023461131046933,1.0024281430265947,9,11,3.556515693664551,2.3671681880950928,7,5
1555,32,0.9724877403598332,1.405770752052538,1.0026178068972413,1.0034635202960422,14,22,3.8681983947753906,2.3671681880950928,18,10
1555,64,0.4744322695059359,1.3877385593008496,1.0001527260692324,1.0041700965373652,30,52,4.218003749847412,2.3671681880950928,34,12
1555,128,0.0401238481432451,1.3497940143619724,1.0000250206879735,1.0041809873723972,61,118,4.800876617431641,2.3671681880950928,67,10
1556,1,10.93149350522658,10.931493505226582,0.9249649422323857,0.9249649422323883,0,0,11.153266906738281,11.153266906738281,1,1
1556,2,9.020790669652813,9.020790669652815,0.9727852775365726,0.9727852775365751,0,0,11.516528129577637,11.153266906738281,2,2
1556,3,8.894348663993444,8.894348663993446,0.9753884936144399,0.9753884936144422,0,0,11.543521881103516,11.153266906738281,3,3
1556,4,8.774749275069578,8.774749275069581,0.9785571843440328,0.9785571843440348,0,0,11.834875106811523,11.153266906738281,4,4
1556,8,7.686574154707133,7.731592286937018,1.0106799333170735,1.0091968973656824,1,1,12.38713264465332,11.153266906738281,7,7
1556,16,6.919904719013658,6.964201236639601,1.0309174489978887,1.0297843658105785,6,8,12.954243659973145,11.153266906738281,10,8
1556,32,5.968082834156114,6.39062430266037,1.0397805951800896,1.0478238042484942,11,17,13.681171417236328,11.153266906738281,21,15
1556,64,4.736303550221724,6.35043486468494,1.026006441797458,1.0501680700929874,29,47,14.43116569519043,11.153266906738281,35,17
1556,128,3.005604477362868,6.320060195160746,1.0109934382106425,1.0520480804899979,61,110,15.196701049804688,11.153266906738281,67,18
1557,1,7.485060960035334,7.485060960035319,0.9588671340351999,0.958867134035201,0,0,7.588250637054443,7.588250637054443,1,1
1557,2,5.958993665059515,5.958993665059517,0.9864106209570169,0.9864106209570185,0,0,7.932337760925293,7.588250637054443,2,2
1557,3,5.429186259231765,5.429186259231765,0.9973000399384887,0.9973000399384905,0,0,8.398900032043457,7.588250637054443,3,3
1557,4,5.187310650169158,5.187310650169158,1.0032002834958689,1.0032002834958695,0,0,8.656099319458008,7.588250637054443,4,4
1557,8,4.916474066155044,4.916474066155043,1.009343466635646,1.0093434666356476,0,0,9.389150619506836,7.588250637054443,8,8
1557,16,4.283113363437027,4.361998221147601,1.0184792397963418,1.0194598904583905,5,5,9.841818809509277,7.588250637054443,11,11
1557,32,3.5365902980645907,4.092617307010425,1.0188314327857486,1.0264939334610619,15,19,10.458380699157715,7.588250637054443,17,13
1557,64,2.567705625683257,4.092617307010425,1.0066259179254802,1.0264939334610619,32,51,10.976506233215332,7.588250637054443,32,13
1557,128,1.323472598381444,4.028955761080559,1.0009640256826962,1.0302523300273023,60,110,11.633350372314453,7.588250637054443,68,18
1558,1,8.327001723808694,8.327001723808701,0.9588448558024578,0.9588448558024607,0,0,8.417156219482422,8.417156219482422,1,1
1558,2,6.434324636350521,6.434324636350521,0.9935099775206839,0.9935099775206858,0,0,8.939108848571777,8.417156219482422,2,2
1558,3,6.252592764418029,6.25259276441803,0.9985194029995098,0.9985194029995114,0,0,10.285151481628418,8.417156219482422,3,3
1558,4,6.249934966632762,6.249934966632762,0.9989232754000859,0.9989232754000879,0,0,10.311260223388672,8.417156219482422,4,4
1558,8,5.967594524562884,6.167792318640115,1.0019396304267267,1.0017068922723873,2,4,10.790417671203613,8.417156219482422,6,4
1558,16,5.030360198960713,5.473939281941327,1.0190070911063325,1.0201624970592078,8,10,11.254420280456543,8.417156219482422,8,6
1558,32,4.3173378344738085,5.45938442711201,1.0175611709827652,1.0223283060496664,14,24,11.87078857421875,8.417156219482422,18,8
1558,64,3.4376007704139795,5.275965809626891,1.0109125422824028,1.030109728465003,28,54,12.920886039733887,8.417156219482422,36,10
1558,128,1.977799956037886,5.224284083365693,1.006403669738117,1.0333906964033697,57,116,13.807251930236816,8.417156219482422,71,12
1559,1,8.913087575960224,8.913087575960224,0.956013683381018,0.9560136833810187,0,0,9.011842727661133,9.011842727661133,1,1
1559,2,6.9535197371880395,6.953519737188039,0.9899332498306904,0.9899332498306908,0,0,9.140475273132324,9.011842727661133,2,2
1559,3,6.023359011806333,6.023359011806334,1.0003509496414078,1.000350949641407,0,0,9.157394409179688,9.011842727661133,3,3
1559,4,6.023143490292211,6.023359011806334,1.0002943177262607,1.000350949641407,1,1,9.446732521057129,9.011842727661133,3,3
1559,8,5.112420042516364,5.112886951292838,1.0205523841918915,1.0206435097902675,1,1,9.899652481079102,9.011842727661133,7,7
1559,16,4.5635774470055255,4.833824119187242,1.0239155870297747,1.0256921576088183,3,4,10.130139350891113,9.011842727661133,13,12
1559,32,4.195813661781491,4.686379612402982,1.0260250858128557,1.0300566725982336,12,16,10.564935684204102,9.011842727661133,20,16
1559,64,2.8652086240784387,4.605209473914743,1.0103897048542871,1.0330181596815007,33,49,11.255651473999023,9.011842727661133,31,15
1559,128,1.453893520410736,4.59584536929999,1.0028694277077266,1.0338673694522462,66,112,11.757696151733398,9.011842727661133,62,16
1560,1,7.976674438735836,7.9766744387358415,0.9650056780506479,0.9650056780506502,0,0,8.04492473602295,8.04492473602295,1,1
1560,2,6.97898936252179,6.978989362521763,0.9842795487933076,0.9842795487933091,0,0,8.871617317199707,8.04492473602295,2,2
1560,3,6.6405511480246515,6.6405511480246515,0.990740492140027,0.9907404921400267,0,0,8.910728454589844,8.04492473602295,3,3
1560,4,6.0894381670024265,6.0894381670024265,1.0029461240082362,1.0029461240082376,0,0,8.997180938720703,8.04492473602295,4,4
1560,8,5.511043930921287,5.511876142226882,1.0128220392668505,1.012774088548635,1,1,9.827666282653809,8.04492473602295,7,7
1560,16,4.793658857002068,5.293119619517872,1.0176841152634402,1.0197603795958288,4,6,10.369213104248047,8.04492473602295,12,10
1560,32,4.372477062948339,5.109085787711718,1.0180751764351974,1.0243862833638875,12,21,10.70732593536377,8.04492473602295,20,11
1560,64,3.5717171245331176,4.94020195424614,1.0150045007280875,1.0311507972113225,30,46,11.178589820861816,8.04492473602295,34,18
1560,128,1.9752926565809052,4.870171191900055,1.0061723854716054,1.0339254250337324,59,110,11.829751968383789,8.04492473602295,69,18
1561,1,6.750895060356267,6.750895060356271,0.9696692174772092,0.9696692174772118,0,0,6.812657833099365,6.812657833099365,1,1
1561,2,5.9378870236763435,5.9378870236763355,0.9837932111261634,0.9837932111261659,0,0,7.668233394622803,6.812657833099365,2,2
1561,3,5.583392687107162,5.583392687107162,0.9919300366044153,0.9919300366044177,0,0,7.990769863128662,6.812657833099365,3,3
1561,4,5.4906702241733365,5.490670224173338,0.9940684169082779,0.9940684169082803,0,0,8.230690002441406,6.812657833099365,4,4
1561,8,4.547141820710671,4.741952813937065,1.007618515150146,1.009883977061602,1,1,9.18344783782959,6.812657833099365,7,7
1561,16,3.779974714710497,4.370732722247384,1.015500557493269,1.0185819904685696,5,6,9.774076461791992,6.812657833099365,11,10
1561,32,3.222703251180438,4.370732722247383,1.0132647778583033,1.0185819904685698,18,22,10.273771286010742,6.812657833099365,14,10
1561,64,2.383645951507397,4.269183830165731,1.0105405021397416,1.0231993580404595,28,50,10.824178695678711,6.812657833099365,36,14
1561,128,1.636918151453777,4.183115387892946,1.0025046765762897,1.0262148234741668,63,114,11.635618209838867,6.812657833099365,65,14
1562,1,9.830746255919285,9.830746255919287,0.9411516164569816,0.9411516164569824,0,0,9.983236312866211,9.983236312866211,1,1
1562,2,9.013337326465415,9.013337326465416,0.9612282925862209,0.9612282925862216,0,0,10.376446723937988,9.983236312866211,2,2
1562,3,8.227317860430082,8.227317860430084,0.9790300863412463,0.9790300863412467,0,0,11.190411567687988,9.983236312866211,3,3
1562,4,8.137609380513036,8.137609380513016,0.983291118117336,0.9832911181173364,0,0,11.197579383850098,9.983236312866211,4,4
1562,8,6.915458009472769,6.929156101256195,1.0193586329812983,1.018802244499243,1,2,11.707202911376953,9.983236312866211,7,6
1562,16,6.662585537742466,6.725161913678273,1.025664040235355,1.0246444234133503,3,4,12.213865280151367,9.983236312866211,13,12
1562,32,5.868045567323892,6.481607973147255,1.024719703850463,1.030422151853736,12,15,12.757219314575195,9.983236312866211,20,17
1562,64,3.8888495101280887,6.297074994400839,1.019340598689071,1.0377480468309352,32,46,13.382344245910645,9.983236312866211,32,18
1562,128,2.6805287785764675,6.202388823393888,1.005699304329794,1.0432248982128247,61,106,14.075029373168945,9.983236312866211,67,22
1563,1,5.859204690842915,5.859204690842917,0.9857351095086556,0.9857351095086573,0,0,5.875128746032715,5.875128746032715,1,1
1563,2,5.208312898075136,5.208312898075136,0.9960646483356086,0.9960646483356097,0,0,6.669569969177246,5.875128746032715,2,2
1563,3,4.553477831169328,4.553477831169327,1.0026535001780725,1.0026535001780736,0,0,6.88202428817749,5.875128746032715,3,3
1563,4,4.207161826587481,4.207161826587481,1.006083096864652,1.0060830968646521,0,0,7.094468593597412,5.875128746032715,4,4
1563,8,3.9020583774904773,3.937486458738679,1.0080989522715575,1.0088376732776554,2,1,7.762550354003906,5.875128746032715,6,7
1563,16,3.4845065690146626,3.6900550877323535,1.013368969964722,1.0147921879718904,5,7,8.21072769165039,5.875128746032715,11,9
1563,32,2.7011190467635053,3.548979010096782,1.0077617642487726,1.016156730938952,14,21,8.796242713928223,5.875128746032715,18,11
1563,64,1.8850161755189399,3.5489669414043803,1.0059870222685516,1.0161874129064126,31,52,9.365166664123535,5.875128746032715,33,12
1563,128,1.0648180846925916,3.53476874732975,1.0014255434139885,1.0175299006385985,62,113,10.30475902557373,5.875128746032715,66,15
1564,1,5.223930077029468,5.223930077029468,0.9865401665601359,0.986540166560136,0,0,5.240030288696289,5.240030288696289,1,1
1564,2,4.737738049726898,4.737738049726898,0.9934859728845303,0.9934859728845303,0,0,5.82883882522583,5.240030288696289,2,2
1564,3,4.251507137554955,4.251507137554955,1.000067375324365,1.0000673753243647,0,0,5.997828960418701,5.240030288696289,3,3
1564,4,3.9999767309842205,3.999976730984221,1.003547964918089,1.003547964918089,0,0,6.086581707000732,5.240030288696289,4,4
1564,8,3.178789267909603,3.1802453400181565,1.0087591742730786,1.0088656417511468,2,2,6.305688381195068,5.240030288696289,6,6
1564,16,2.9152085777417382,3.091320256700937,1.0087975452782902,1.0103919429136565,5,7,6.69213342666626,5.240030288696289,11,9
1564,32,2.4738686891791333,2.893912907780316,1.011867692089381,1.01164874782295,16,21,7.02392053604126,5.240030288696289,16,11
1564,64,1.8359786823534405,2.8074815005247142,1.007361169473307,1.0135922073181511,26,51,7.66480827331543,5.240030288696289,38,13
1564,128,0.7684093454406064,2.802198531827217,1.000670662092673,1.0139678742323377,68,112,8.308404922485352,5.240030288696289,60,16
1565,1,7.920957229528345,7.920957229528327,0.9674980638410087,0.96749806384101,0,0,7.980019569396973,7.980019569396973,1,1
1565,2,7.473377687744301,7.473377687744304,0.9765375762032493,0.9765375762032507,0,0,8.439186096191406,7.980019569396973,2,2
1565,3,5.876959759888781,5.876959759888781,1.0035196251777085,1.0035196251777085,0,0,8.785231590270996,7.980019569396973,3,3
1565,4,5.467741236382675,5.467741236382676,1.0102386045468112,1.0102386045468115,0,0,8.920520782470703,7.980019569396973,4,4
1565,8,4.868830492208101,4.870223475938617,1.018652030350814,1.01861344146101,1,1,9.071028709411621,7.980019569396973,7,7
1565,16,4.53448221290158,4.684872125460866,1.021336435032867,1.0213322806178353,5,5,9.70500373840332,7.980019569396973,11,11
1565,32,3.8386959919305332,4.477856600511301,1.019901826156479,1.0277981185977763,15,20,10.469265937805176,7.980019569396973,17,12
1565,64,2.9589535865952112,4.45341882793002,1.007408191313084,1.0295196951926875,28,51,11.33624267578125,7.980019569396973,36,13
1565,128,1.7818164746390464,4.4462263665162896,1.0044034654664733,1.0306085923301342,61,113,12.218378067016602,7.980019569396973,67,15
1566,1,6.908579309121572,6.908579309121575,0.9771132864494891,0.9771132864494905,0,0,6.944004058837891,6.944004058837891,1,1
1566,2,5.5035875132433505,5.5035875132433505,0.9989156363055132,0.9989156363055134,0,0,6.9867377281188965,6.944004058837891,2,2
1566,3,5.403680182657975,5.403680182657974,1.0006031923490273,1.0006031923490268,0,0,7.337459087371826,6.944004058837891,3,3
1566,4,5.315817678577321,5.315817678577321,1.0022882522383882,1.0022882522383876,0,0,7.513355731964111,6.944004058837891,4,4
1566,8,4.944152647474302,4.950470405201649,1.00864455362047,1.0084753801724045,2,2,8.033992767333984,6.944004058837891,6,6
1566,16,4.088225127131344,4.361597827679462,1.0157295319027908,1.0162460079129354,7,8,8.523219108581543,6.944004058837891,9,8
1566,32,3.3343545896834126,4.286253960408812,1.0128409845421396,1.0179433520332488,13,19,8.939988136291504,6.944004058837891,19,13
1566,64,2.2110324244249844,4.267994524205092,1.0026291808669503,1.0193388648570059,28,50,9.548087120056152,6.944004058837891,36,14
1566,128,1.0065640563845835,4.182278893161814,1.000598104889832,1.0220625102503824,70,113,10.160811424255371,6.944004058837891,58,15
1567,1,12.170361671975732,12.170361671975739,0.9103992341048269,0.9103992341048296,0,0,12.45080852508545,12.45080852508545,1,1
1567,2,10.416680558247673,10.416680558247673,0.958983791048877,0.9589837910488757,0,0,12.808767318725586,12.45080852508545,2,2
1567,3,10.235685588893979,10.235685588893977,0.9618688591416785,0.961868859141678,0,0,13.037989616394043,12.45080852508545,3,3
1567,4,9.645351514639524,9.645351514639525,0.978723656162872,0.9787236561628723,0,0,13.243627548217773,12.45080852508545,4,4
1567,8,8.711180326510098,8.711180326510098,1.0128564532800155,1.0128564532800164,1,1,13.56508731842041,12.45080852508545,7,7
1567,16,8.037879135044234,8.303750254342106,1.0248948867370855,1.0244515592543937,4,3,13.961843490600586,12.45080852508545,12,13
1567,32,6.836316391051711,7.965979650972389,1.0281463378537103,1.030714510050038,13,20,14.707119941711426,12.45080852508545,19,12
1567,64,5.427261086483889,7.742445788854705,1.0192016455201591,1.0443488184318268,34,48,15.614192008972168,12.45080852508545,30,16
1567,128,2.8504176765162508,7.628805284273981,1.0082177365295575,1.0509619059314566,65,110,16.318798065185547,12.45080852508545,63,18
1568,1,8.86448908953948,8.864489089539486,0.9637466365562605,0.9637466365562631,0,0,8.929594993591309,8.929594993591309,1,1
1568,2,7.900748896296496,7.900748896296497,0.9822874954483437,0.9822874954483451,0,0,9.27580738067627,8.929594993591309,2,2
1568,3,7.380192266252121,7.380192266252122,0.9956547691921681,0.9956547691921698,0,0,9.899962425231934,8.929594993591309,3,3
1568,4,7.212746968629895,7.212746968629894,0.9974967116405005,0.9974967116405004,0,0,10.411931991577148,8.929594993591309,4,4
1568,8,6.459940162012502,6.49795685775424,1.0124836203486085,1.0118181698119844,1,1,10.839680671691895,8.929594993591309,7,7
1568,16,5.811704792836154,6.244230959620857,1.0163733888269917,1.0181415489256622,5,4,11.442797660827637,8.929594993591309,11,12
1568,32,4.836314669208051,5.662191108829573,1.0208695123783098,1.032287088080948,14,20,11.803966522216797,8.929594993591309,18,12
1568,64,3.965092528238598,5.538782037251111,1.0114916800625828,1.0339333965697484,27,49,12.379426956176758,8.929594993591309,37,15
1568,128,2.1769182170795527,5.456996397718162,1.0030761186113033,1.0396698557416844,59,111,13.305644035339355,8.929594993591309,69,17
1569,1,8.960301117149692,8.960301117149694,0.9553232578494157,0.9553232578494171,0,0,9.058730125427246,9.058730125427246,1,1
1569,2,8.146549315013537,8.146549315013537,0.9787849489377805,0.978784948937782,0,0,10.768806457519531,9.058730125427246,2,2
1569,3,7.289722753038921,7.289722753038921,0.9997337705024906,0.9997337705024913,0,0,11.432673454284668,9.058730125427246,3,3
1569,4,6.95224904042113,6.95224904042113,1.0078373988358897,1.00783739883589,0,0,11.774823188781738,9.058730125427246,4,4
1569,8,6.3470214774433575,6.380465839910981,1.0206157638525248,1.0210069742492291,3,3,12.782482147216797,9.058730125427246,5,5
1569,16,6.113585660290412,6.379438403848894,1.0129995322889596,1.0214201836598855,8,10,13.301198959350586,9.058730125427246,8,6
1569,32,4.909064157544372,6.043781842644492,1.0184224005885112,1.0362017041053542,12,23,14.459189414978027,9.058730125427246,20,9
1569,64,4.095366292577237,5.972651845590679,1.0092348324993534,1.042559181282479,31,52,15.33714771270752,9.058730125427246,33,12
1569,128,2.914869974231442,5.967260974450058,1.006879089080177,1.0431330647742736,66,113,15.991080284118652,9.058730125427246,62,15
1570,1,10.751060986662864,10.75106098666287,0.9336181546392698,0.9336181546392716,0,0,10.928972244262695,10.928972244262695,1,1
1570,2,10.617478415177777,10.617478415177782,0.9413529501773914,0.9413529501773931,0,0,12.137781143188477,10.928972244262695,2,2
1570,3,9.674245325012741,9.67424532501274,0.9697866240733909,0.9697866240733898,0,0,12.159811973571777,10.928972244262695,3,3
1570,4,8.48679174441358,8.48679174441358,0.9987409828273153,0.9987409828273162,0,0,12.187621116638184,10.928972244262695,4,4
1570,8,7.463354902664317,7.529619562903863,1.0220986045629572,1.0222888752402857,2,2,12.359353065490723,10.928972244262695,6,6
1570,16,6.818969926005443,7.416927132842897,1.027115803310731,1.026107969449542,5,6,12.96338176727295,10.928972244262695,11,10
1570,32,6.0010886898905165,7.22720395957345,1.0324659232406188,1.03280687998824,13,19,13.351134300231934,10.928972244262695,19,13
1570,64,4.8940853761961085,7.117206077948914,1.021839349620871,1.0378861397533445,34,48,13.955430030822754,10.928972244262695,30,16
1570,128,2.9801906804157086,6.904789061540834,1.0008395627098736,1.0478773369130432,64,111,14.601733207702637,10.928972244262695,64,17
1571,1,7.570418076814121,7.570418076814099,0.9628687954019117,0.962868795401914,0,0,7.653947830200195,7.653947830200195,1,1
1571,2,6.3203508192776585,6.32035081927766,0.9855231482925488,0.9855231482925508,0,0,8.299968719482422,7.653947830200195,2,2
1571,3,4.5869231416163405,4.586923141616339,1.0099736439903495,1.0099736439903515,0,0,8.376583099365234,7.653947830200195,3,3
1571,4,4.433534450895342,4.43353445089534,1.0127210746379038,1.0127210746379054,0,0,8.43863296508789,7.653947830200195,4,4
1571,8,4.387604282286605,4.424525590678876,1.0123041080187178,1.012780376787132,2,2,9.176798820495605,7.653947830200195,6,6
1571,16,4.252913090774223,4.374950839138734,1.0126869433595922,1.0142488075912672,6,8,9.544644355773926,7.653947830200195,10,8
1571,32,3.5993305054863485,4.317605859264427,1.0137841150329951,1.016607240040822,15,21,9.813756942749023,7.653947830200195,17,11
1571,64,2.600952737443606,4.29506445319162,1.0049076627978901,1.0176194214010736,35,50,10.203594207763672,7.653947830200195,29,14
1571,128,1.4468134860494637,4.208926511039345,1.003467054756428,1.0188512031779289,70,117,10.744928359985352,7.653947830200195,58,11
1572,1,8.749980710057933,8.749980710057917,0.9582491135528852,0.9582491135528874,0,0,8.839853286743164,8.839853286743164,1,1
1572,2,7.983667441391499,7.9836674413914785,0.9738935557269126,0.9738935557269139,0,0,8.991488456726074,8.839853286743164,2,2
1572,3,7.059254108567029,7.059254108567029,0.9881551896612453,0.9881551896612456,0,0,9.007347106933594,8.839853286743164,3,3
1572,4,6.536108883464144,6.536108883464144,0.9951890288087093,0.9951890288087106,0,0,9.0487060546875,8.839853286743164,4,4
1572,8,5.650470432756795,5.71480295251823,1.0131217277018938,1.0117667745087326,1,1,9.309613227844238,8.839853286743164,7,7
1572,16,4.845955974533688,4.949026009111732,1.0238229334964852,1.0216755851325936,5,6,9.701033592224121,8.839853286743164,11,10
1572,32,3.9025859598423667,4.766485881937692,1.0196432399010256,1.027536595761885,11,16,10.240592956542969,8.839853286743164,21,16
1572,64,2.835594752254177,4.534355268138529,1.0149349958305984,1.0340381920573911,30,47,10.709200859069824,8.839853286743164,34,17
1572,128,1.5925947629248782,4.525219515847035,1.0061404182777456,1.0350052610498506,66,108,11.24950885772705,8.839853286743164,62,20
1573,1,9.593418341832797,9.593418341832791,0.9409782306563006,0.9409782306563023,0,0,9.75461196899414,9.75461196899414,1,1
1573,2,7.84705069183952,7.847050691839519,0.9776196981799758,0.9776196981799758,0,0,9.871805191040039,9.75461196899414,2,2
1573,3,7.574492140683979,7.5744921406839785,0.9827212364264468,0.9827212364264473,0,0,9.981335639953613,9.75461196899414,3,3
1573,4,7.240009268233012,7.24218584023954,0.9880505957057966,0.9880516277303794,1,1,10.158215522766113,9.75461196899414,3,3
1573,8,6.861584434735163,6.8780685126745595,1.0002372726828572,0.9996320857422485,1,1,10.840387344360352,9.75461196899414,7,7
1573,16,6.340467103042186,6.506161082879239,1.010518435659705,1.0104844363923333,4,7,11.232831001281738,9.75461196899414,12,9
1573,32,5.069851935110445,6.155829436796961,1.0247349207725758,1.0222357146711962,15,19,11.489347457885742,9.75461196899414,17,13
1573,64,4.388635152594402,5.844742426090822,1.0185000661307373,1.0252029113158274,27,48,11.942784309387207,9.75461196899414,37,16
1573,128,2.305099215642934,5.631075635979005,1.0051115372715118,1.0295768995810286,65,110,12.313722610473633,9.75461196899414,63,18
1574,1,10.948783539291737,10.948783539291744,0.9291933686556697,0.9291933686556721,0,0,11.146003723144531,11.146003723144531,1,1
1574,2,10.099605189923011,10.099605189923015,0.9621102160722678,0.9621102160722692,0,0,12.860984802246094,11.146003723144531,2,2
1574,3,9.920499165688199,9.9204991656882,0.9681319034539393,0.96813190345394,0,0,12.881430625915527,11.146003723144531,3,3
1574,4,9.852146464839622,9.852146464839624,0.9701307008947645,0.9701307008947648,0,0,12.918876647949219,11.146003723144531,4,4
1574,8,9.58223997819277,9.58247478160744,0.9813814798898566,0.9813467719033806,1,1,13.342761039733887,11.146003723144531,7,7
1574,16,7.925553369175716,8.080982291791296,1.026702275235205,1.0225683676866342,6,7,13.896315574645996,11.146003723144531,10,9
1574,32,6.562830071437284,7.9699903129918,1.0323414697197049,1.0274020654524287,13,20,14.789595603942871,11.146003723144531,19,12
1574,64,4.076351061117716,7.804147724230674,1.0202953773418981,1.038841574741546,26,52,15.688004493713379,11.146003723144531,38,12
1574,128,2.814236562868586,7.667753008612303,1.0144899948066668,1.0424237504830833,59,115,16.538227081298828,11.146003723144531,69,13
1575,1,7.081548249516797,7.081548249516797,0.9679463667794062,0.9679463667794097,0,0,7.145833969116211,7.145833969116211,1,1
1575,2,6.337221044849338,6.33722104484934,0.98716249541036,0.9871624954103619,0,0,9.685007095336914,7.145833969116211,2,2
1575,3,6.0493698397467375,6.049369839746738,0.9956560323427937,0.9956560323427944,0,0,9.982757568359375,7.145833969116211,3,3
1575,4,5.636529949838505,5.636529949838505,1.001858104206809,1.001858104206811,0,0,9.993788719177246,7.145833969116211,4,4
1575,8,5.412823346518589,5.414228426623735,1.0096329031569096,1.0095741029693188,1,1,10.774555206298828,7.145833969116211,7,7
1575,16,5.097998492244456,5.263991375716438,1.013546700283165,1.014099532275477,4,5,11.152480125427246,7.145833969116211,12,11
1575,32,4.221802085341015,5.08223036694018,1.0156145756000583,1.0207545954898396,14,20,11.74808120727539,7.145833969116211,18,12
1575,64,3.2615968499813497,5.079977950684275,1.0051113058704901,1.0211395564784795,28,51,12.385601043701172,7.145833969116211,36,13
1575,128,1.9048095131625464,5.062212864811063,1.0008273691047098,1.022838356418949,68,114,12.96921443939209,7.145833969116211,60,14
1576,1,5.655474385213638,5.65547438521364,0.9854165622762375,0.9854165622762397,0,0,5.672889232635498,5.672889232635498,1,1
1576,2,4.630737167627294,4.630737167627295,0.9971667847988438,0.9971667847988452,0,0,5.92481803894043,5.672889232635498,2,2
1576,3,4.467306389074797,4.467306389074798,0.9977847776400883,0.9977847776400888,0,0,6.194267272949219,5.672889232635498,3,3
1576,4,4.452022754555547,4.452022754555546,0.9979632107110589,0.9979632107110591,0,0,6.2215704917907715,5.672889232635498,4,4
1576,8,3.228129917972609,3.241335852647762,1.0107774428078293,1.010639945543356,1,1,6.766695022583008,5.672889232635498,7,7
1576,16,2.6310047406764308,3.0125748228012568,1.011568853790267,1.01459266108539,4,5,7.272244453430176,5.672889232635498,12,11
1576,32,2.21133281892249,2.9008282405254184,1.0101462365694787,1.0168360465445005,14,18,7.753419399261475,5.672889232635498,18,14
1576,64,1.7382745440358887,2.8569171449480026,1.0075571941293113,1.0187878445049958,30,49,8.398168563842773,5.672889232635498,34,15
1576,128,0.9127167814431025,2.842639500560298,1.001185988640957,1.0200422072501591,58,109,9.222955703735352,5.672889232635498,70,19
1577,1,7.949837911584493,7.949837911584493,0.9644603749059838,0.9644603749059834,0,0,8.021832466125488,8.021832466125488,1,1
1577,2,5.660400068759825,5.660400068759825,0.9941814849948549,0.994181484994855,0,0,8.164107322692871,8.021832466125488,2,2
1577,3,5.362487108653372,5.362487108653372,0.9999146993419117,0.9999146993419116,0,0,8.588898658752441,8.021832466125488,3,3
1577,4,4.997139322966399,4.9971393229664,1.0060666697192826,1.0060666697192824,0,0,8.589190483093262,8.021832466125488,4,4
1577,8,4.627759596087162,4.642179078553762,1.0116234846579883,1.0120805917642528,1,1,8.760986328125,8.021832466125488,7,7
1577,16,3.6410966292486244,3.829841116493776,1.0227162973272086,1.0228111920639615,5,6,9.192843437194824,8.021832466125488,11,10
1577,32,3.2622179522935917,3.7242464488938096,1.0237158548004497,1.0260761114890729,12,18,9.675274848937988,8.021832466125488,20,14
1577,64,2.2105809019919955,3.6998210496791515,1.0094767627647676,1.027368897414902,31,47,10.443901062011719,8.021832466125488,33,17
1577,128,1.0924939538457472,3.6998210496791524,1.0027669920374855,1.0273688974149024,60,111,11.30320930480957,8.021832466125488,68,17
1578,1,6.898992949917058,6.898992949917058,0.9790270622239521,0.9790270622239527,0,0,6.92767858505249,6.92767858505249,1,1
1578,2,5.522874567268117,5.522874567268118,0.9972240591833264,0.9972240591833266,0,0,7.012722015380859,6.92767858505249,2,2
1578,3,4.8852321825166065,4.8852321825166065,1.0032012763968126,1.0032012763968123,0,0,7.176130294799805,6.92767858505249,3,3
1578,4,4.698705057907871,4.698705057907871,1.0069638543874313,1.0069638543874315,0,0,7.881786823272705,6.92767858505249,4,4
1578,8,4.652400023179133,4.682032159893082,1.008578497927077,1.0079315030579687,2,2,8.454889297485352,6.92767858505249,6,6
1578,16,4.09270105617653,4.257332602776658,1.0177826249970394,1.0191986186429982,4,5,9.111042022705078,6.92767858505249,12,11
1578,32,3.386850110433128,4.152854091326503,1.0158885091455279,1.0215375927019124,15,18,9.630208969116211,6.92767858505249,17,14
1578,64,2.3750318220188538,4.076519242744707,1.0081305102137041,1.0237739468105291,30,49,10.221613883972168,6.92767858505249,34,15
1578,128,1.3108377131008595,4.0607158986615595,1.0039490951439132,1.0251725965453546,62,110,10.92635440826416,6.92767858505249,66,18
1579,1,7.942276259781233,7.942276259781238,0.9610243623454762,0.9610243623454777,0,0,8.028840065002441,8.028840065002441,1,1
1579,2,6.550986778875045,6.550986778875045,0.9876949359854409,0.9876949359854412,0,0,8.720939636230469,8.028840065002441,2,2
1579,3,6.183044542190741,6.183044542190743,0.993438757517735,0.9934387575177365,0,0,8.819622993469238,8.028840065002441,3,3
1579,4,5.905720768702664,5.905720768702664,0.9988099947861133,0.9988099947861142,0,0,8.822566986083984,8.028840065002441,4,4
1579,8,5.746964494512297,5.8401720781825635,0.9997066985772458,0.9997325631241522,3,3,9.303492546081543,8.028840065002441,5,5
1579,16,5.414691025532219,5.7209693085763496,1.0026262126636358,1.0042960626830015,6,8,9.63875961303711,8.028840065002441,10,8
1579,32,4.1598683114153285,5.260000280850637,1.0133474874946218,1.0142401686880265,13,22,10.111713409423828,8.028840065002441,19,10
1579,64,2.785650928471925,5.1088647195598265,1.0072061582997862,1.0205391599501068,29,50,10.701813697814941,8.028840065002441,35,14
1579,128,1.3929402997112816,5.100696603331353,1.0002994046698133,1.0217895525856977,58,111,11.64710807800293,8.028840065002441,70,17
1580,1,5.9311315829307345,5.931131582930736,0.9865757829643084,0.9865757829643096,0,0,5.945065021514893,5.945065021514893,1,1
1580,2,5.605793926919838,5.605793926919839,0.9923784654251966,0.9923784654251975,0,0,6.680975914001465,5.945065021514893,2,2
1580,3,4.683048955423432,4.683048955423432,1.0032111374038708,1.0032111374038712,0,0,6.9390549659729,5.945065021514893,3,3
1580,4,4.6456343978319365,4.6456343978319365,1.0048002558818974,1.0048002558818978,0,0,7.373943328857422,5.945065021514893,4,4
1580,8,3.8431446256567607,3.9903528292110115,1.0126557257725364,1.013153626479023,2,3,7.694132328033447,5.945065021514893,6,5
1580,16,3.651526122545509,3.96354921640019,1.0142123646404828,1.0145180411894557,6,8,8.178498268127441,5.945065021514893,10,8
1580,32,3.009501101365531,3.823120620185139,1.0120558013010765,1.018494298859959,11,20,8.617216110229492,5.945065021514893,21,12
1580,64,2.370506113609425,3.7164520252441937,1.0063731281533062,1.0214555879217377,28,49,9.362772941589355,5.945065021514893,36,15
1580,128,1.3588267904597309,3.691833464509003,1.0022308754721836,1.0233058141315936,66,111,9.984954833984375,5.945065021514893,62,17
1581,1,8.434102513857187,8.434102513857184,0.964724418923917,0.9647244189239178,0,0,8.50041675567627,8.50041675567627,1,1
1581,2,6.727724874098095,6.7277248740980955,0.9880338210862805,0.9880338210862827,0,0,8.677860260009766,8.50041675567627,2,2
1581,3,6.717939235648859,6.717939235648859,0.9880135000755855,0.988013500075587,0,0,9.202255249023438,8.50041675567627,3,3
1581,4,6.654948879195088,6.657219406675383,0.9905301027739267,0.990271227696579,1,1,9.4696683883667,8.50041675567627,3,3
1581,8,6.1521367940681575,6.317478008272484,1.0021602126375444,1.0010015763915714,2,3,9.891607284545898,8.50041675567627,6,5
1581,16,5.777120719148531,6.27861044281322,1.0024698816581854,1.001754558640482,6,10,10.44287395477295,8.50041675567627,10,6
1581,32,4.809415452733261,5.842714057321644,1.0088820226609103,1.014343609665949,13,22,11.046529769897461,8.50041675567627,19,10
1581,64,3.6140049255083753,5.770015121320693,1.007959873914365,1.0185608185742587,36,53,11.627805709838867,8.50041675567627,28,11
1581,128,2.423572983230948,5.544364904446551,1.0035736410268226,1.0268990743410296,67,116,12.210028648376465,8.50041675567627,61,12
1582,1,3.329350282655407,3.329350282655408,0.9921789158806433,0.9921789158806444,0,0,3.338139295578003,3.338139295578003,1,1
1582,2,2.411953635023854,2.411953635023854,0.9983975056766248,0.9983975056766253,0,0,3.4782211780548096,3.338139295578003,2,2
1582,3,2.1472795668485873,2.147279566848588,0.9998627174737805,0.9998627174737812,0,0,3.634969711303711,3.338139295578003,3,3
1582,4,2.1057897773314163,2.1057897773314163,1.0001624630019719,1.000162463001973,0,0,3.918915033340454,3.338139295578003,4,4
1582,8,1.8998677184592268,2.0016434334987316,1.0013800171310256,1.001230782637773,2,2,4.0414228439331055,3.338139295578003,6,6
1582,16,1.6626468701810844,1.9768762339818144,1.000767578458171,1.0012355475060024,7,8,4.279524803161621,3.338139295578003,9,8
1582,32,1.3773941705296797,1.9139412541813348,1.000750332095573,1.0025541754612237,15,23,4.901361465454102,3.338139295578003,17,9
1582,64,0.6923234495238836,1.8265443246838744,0.9999956972932458,1.003759265931263,30,54,5.19127082824707,3.338139295578003,34,10
1582,128,0.05323168372901613,1.7518611013680463,1.000044576512271,1.004485005047264,59,119,5.569143295288086,3.338139295578003,69,9
1583,1,9.181239299069082,9.181239299069082,0.9528422490653254,0.9528422490653257,0,0,9.288005828857422,9.288005828857422,1,1
1583,2,7.905033222885808,7.90503322288581,0.9811810702719375,0.9811810702719382,0,0,9.576007843017578,9.288005828857422,2,2
1583,3,6.747670663854548,6.747670663854547,0.9975314937369748,0.9975314937369728,0,0,9.909330368041992,9.288005828857422,3,3
1583,4,6.419341026576124,6.419341026576125,1.0023591424733995,1.0023591424733975,0,0,9.932098388671875,9.288005828857422,4,4
1583,8,5.803426946720473,5.803599074525783,1.0134407539867665,1.0134162017431512,1,1,10.112037658691406,9.288005828857422,7,7
1583,16,5.5648711926928245,5.6455313838244585,1.0159892176908905,1.0155026011534671,3,4,10.379717826843262,9.288005828857422,13,12
1583,32,4.8564474560558955,5.439768921778363,1.0203064861977187,1.021465427517304,12,16,10.966012954711914,9.288005828857422,20,16
1583,64,3.7923470620139663,5.31246358777954,1.0179823444083884,1.025043477565132,29,47,11.358269691467285,9.288005828857422,35,17
1583,128,1.7673499345846615,5.16266835328988,1.0059609200556692,1.0295173875911576,68,110,11.938957214355469,9.288005828857422,60,18
1584,1,7.4993229956617995,7.499322995661803,0.9676232497625197,0.9676232497625216,0,0,7.559830188751221,7.559830188751221,1,1
1584,2,6.186585917193883,6.186585917193882,0.9894713248053348,0.9894713248053347,0,0,7.847189426422119,7.559830188751221,2,2
1584,3,5.694369171123374,5.694369171123374,0.9989490153308855,0.9989490153308861,0,0,9.820281982421875,7.559830188751221,3,3
1584,4,5.600258660857276,5.600258660857276,1.0015874125648958,1.0015874125648965,0,0,10.094225883483887,7.559830188751221,4,4
1584,8,5.514270485439296,5.547681171406279,1.0013045008896253,1.0026504539441163,2,2,10.713385581970215,7.559830188751221,6,6
1584,16,4.872241520159626,5.166881174294313,1.0148023716759114,1.0171798188906656,3,4,11.051128387451172,7.559830188751221,13,12
1584,32,4.677297307647415,5.078463088478719,1.0173846763177319,1.019106729387366,13,17,11.626530647277832,7.559830188751221,19,15
1584,64,3.6609200257688133,4.8766374637742365,1.015684895770219,1.025416692922963,26,49,12.166459083557129,7.559830188751221,38,15
1584,128,1.9652591405000521,4.855897143685593,0.9993678999176816,1.0257832870048837,61,110,12.491414070129395,7.559830188751221,67,18
1585,1,7.955090380718915,7.95509038071892,0.9766282515114436,0.9766282515114464,0,0,7.985812187194824,7.985812187194824,1,1
1585,2,6.984350321570513,6.984350321570515,0.9915646940658456,0.991564694065847,0,0,8.014497756958008,7.985812187194824,2,2
1585,3,5.9994424427123025,5.999442442712302,1.0139384497770747,1.0139384497770751,0,0,9.94037914276123,7.985812187194824,3,3
1585,4,5.495942811703708,5.495942811703709,1.0234572990117825,1.0234572990117825,0,0,9.960620880126953,7.985812187194824,4,4
1585,8,4.901405030029421,5.177175794526816,1.0253380547088993,1.0274935404234171,2,2,10.496980667114258,7.985812187194824,6,6
1585,16,4.55145902518831,4.975045441557642,1.024573395257377,1.0344518343925713,6,8,11.215993881225586,7.985812187194824,10,8
1585,32,4.2618326266488,4.952043406481512,1.0251980629007107,1.0362761858861234,16,22,12.207534790039062,7.985812187194824,16,10
1585,64,3.153605699913431,4.928088159900358,1.0079375109181312,1.0384360286625718,33,52,12.816021919250488,7.985812187194824,31,12
1585,128,2.143973459290759,4.91668962001852,1.0066483236468726,1.0400248659892983,60,113,13.70421314239502,7.985812187194824,68,15
1586,1,5.946293617976775,5.946293617976748,0.9813120737056629,0.981312073705666,0,0,5.973172187805176,5.973172187805176,1,1
1586,2,5.013947131826132,5.013947131826131,0.9982322672660215,0.998232267266024,0,0,8.249402046203613,5.973172187805176,2,2
1586,3,4.6431644651948245,4.643164465194824,1.0038848113592356,1.003884811359238,0,0,8.512801170349121,5.973172187805176,3,3
1586,4,4.630032766178977,4.643164465194824,1.0028428590541556,1.003884811359238,1,1,8.600007057189941,5.973172187805176,3,3
1586,8,4.5199249226340354,4.53939179688836,1.0082996785015246,1.0092004522481026,2,2,9.198481559753418,5.973172187805176,6,6
1586,16,3.9543694986861224,4.27096775263921,1.0136241058664182,1.0147151495383513,4,7,9.545428276062012,5.973172187805176,12,9
1586,32,3.2846370381017715,4.083695390396518,1.013945463003425,1.0201189524255136,12,19,10.016087532043457,5.973172187805176,20,13
1586,64,2.386690574647155,3.863378860230874,1.0042118657026955,1.0236747177009964,31,49,10.782322883605957,5.973172187805176,33,15
1586,128,1.5004326504357492,3.8565141176753572,1.0020414591590279,1.0245745113193296,59,109,11.536898612976074,5.973172187805176,69,19
1587,1,8.135701555685612,8.135701555685618,0.9624331005853717,0.9624331005853741,0,0,8.212926864624023,8.212926864624023,1,1
1587,2,6.897934911954646,6.897934911954647,0.9872257539676141,0.9872257539676162,0,0,8.43580436706543,8.212926864624023,2,2
1587,3,6.686375447424129,6.686375447424129,0.990277272223942,0.9902772722239435,0,0,8.809268951416016,8.212926864624023,3,3
1587,4,6.686347963093084,6.686347963093085,0.9903182933873319,0.9903182933873338,0,0,9.887394905090332,8.212926864624023,4,4
1587,8,5.214961747628119,5.331620651249175,1.0188244075225281,1.0198853250609559,3,3,10.48471450805664,8.212926864624023,5,5
1587,16,4.76866061653928,5.094894165148851,1.0224379975633902,1.0236147740290968,5,8,10.914694786071777,8.212926864624023,11,8
1587,32,4.3588532853696025,5.066966496046418,1.0214173603547922,1.026050242188499,14,23,11.421843528747559,8.212926864624023,18,9
1587,64,3.359673431985775,4.9539831577981115,1.0163546945514463,1.0325317317377212,26,48,11.986757278442383,8.212926864624023,38,16
1587,128,1.8947426225330815,4.8852976153191605,1.0045032908185498,1.0361718068873205,67,110,12.736035346984863,8.212926864624023,61,18
1588,1,8.440640420709869,8.440640420709869,0.9654179421061492,0.96541794210615,0,0,8.501949310302734,8.501949310302734,1,1
1588,2,6.4164536567163015,6.416453656716301,0.998321073597491,0.9983210735974912,0,0,8.561417579650879,8.501949310302734,2,2
1588,3,6.093390671440231,6.093390671440231,1.0026077280299717,1.0026077280299701,0,0,8.662839889526367,8.501949310302734,3,3
1588,4,5.861113263537532,5.861113263537529,1.0061422675648575,1.0061422675648553,0,0,9.230927467346191,8.501949310302734,4,4
1588,8,5.263287909626755,5.263287909626756,1.0149152353749045,1.014915235374903,0,0,10.032894134521484,8.501949310302734,8,8
1588,16,4.96465343540786,5.04602410140891,1.0210108356309606,1.0210838907145838,3,6,10.440099716186523,8.501949310302734,13,10
1588,32,4.050911327390617,4.7578865146783675,1.0238823660407703,1.0313299215687879,12,17,10.9053955078125,8.501949310302734,20,15
1588,64,3.5887253521013744,4.650586900309934,1.018001241677248,1.0338635461191936,32,49,11.50272274017334,8.501949310302734,32,15
1588,128,2.2601305021744302,4.6115341209813465,1.0104577352721282,1.0371317039008519,66,107,12.229887008666992,8.501949310302734,62,21
1589,1,9.073494092637063,9.073494092637066,0.9621074055772867,0.9621074055772888,0,0,9.140905380249023,9.140905380249023,1,1
1589,2,8.641440498516632,8.641440498516634,0.9764700836185383,0.9764700836185398,0,0,11.109212875366211,9.140905380249023,2,2
1589,3,8.305800621040346,8.305800621040346,0.987519233722327,0.9875192337223284,0,0,11.44160270690918,9.140905380249023,3,3
1589,4,8.151558869364354,8.151558869364354,0.9936054964536618,0.9936054964536631,0,0,11.467991828918457,9.140905380249023,4,4
1589,8,7.270091491256304,7.320073345929982,1.0121466430899082,1.012422454574866,2,3,12.01053237915039,9.140905380249023,6,5
1589,16,6.954830929898823,7.214970645156325,1.0174877163387186,1.016583275290981,6,9,12.691065788269043,9.140905380249023,10,7
1589,32,5.646630492556146,7.0304910591895196,1.0217662327413228,1.0272540811702047,14,23,13.694927215576172,9.140905380249023,18,9
1589,64,4.020054480780163,6.838592968113186,1.007492874960336,1.0373422801571106,28,55,14.755393028259277,9.140905380249023,36,9
1589,128,2.606619145260341,6.8384991012474465,1.005359039553647,1.0375772389104405,63,118,15.754749298095703,9.140905380249023,65,10
1590,1,8.778563980960017,8.778563980959998,0.9512952454679743,0.9512952454679756,0,0,8.897745132446289,8.897745132446289,1,1
1590,2,8.033270851249917,8.033270851249918,0.9679675569914443,0.9679675569914445,0,0,9.132174491882324,8.897745132446289,2,2
1590,3,7.28006984224693,7.280069842246928,0.9826834558645061,0.9826834558645061,0,0,9.16067886352539,8.897745132446289,3,3
1590,4,6.654668857200929,6.654668857200929,0.9955683124658679,0.9955683124658683,0,0,9.720022201538086,8.897745132446289,4,4
1590,8,6.4566492643686155,6.522896558274047,1.001089293287997,1.0012906276778848,1,1,10.172689437866211,8.897745132446289,7,7
1590,16,5.714430679607511,6.291742138127374,1.0107749844662521,1.0092393602848702,6,7,10.879733085632324,8.897745132446289,10,9
1590,32,4.425542989635387,5.879141969850693,1.0179468187782599,1.0188075227893458,14,24,11.57421588897705,8.897745132446289,18,8
1590,64,3.3375731601983354,5.701990006427562,1.0158538786524849,1.0254457244141826,34,53,12.16463851928711,8.897745132446289,30,11
1590,128,1.9758484152671556,5.654835570244081,1.007566091692231,1.0295485528207529,66,115,12.991819381713867,8.897745132446289,62,13
1591,1,9.019440112607914,9.019440112607917,0.9506753625501231,0.9506753625501242,0,0,9.141276359558105,9.141276359558105,1,1
1591,2,7.677833151034175,7.677833151034176,0.9805221420081048,0.9805221420081056,0,0,9.596053123474121,9.141276359558105,2,2
1591,3,7.279026918943782,7.2790269189437815,0.992376063816029,0.992376063816029,0,0,9.957442283630371,9.141276359558105,3,3
1591,4,6.965606403389914,6.965606403389914,1.0006259942670408,1.0006259942670412,0,0,10.027053833007812,9.141276359558105,4,4
1591,8,6.125016883405737,6.144183616931254,1.0157498632088091,1.0142336762772564,1,1,10.182180404663086,9.141276359558105,7,7
1591,16,5.591489722964434,5.752475840148352,1.024294331444422,1.0236075616530673,6,6,10.96387004852295,9.141276359558105,10,10
1591,32,4.901382931963251,5.561140544221229,1.033676955589003,1.0303296707933203,14,19,11.365478515625,9.141276359558105,18,13
1591,64,4.198117250240207,5.424710483715134,1.0274333111728386,1.035109373612784,34,49,11.886300086975098,9.141276359558105,30,15
1591,128,2.1641253613631974,5.399134682925761,1.0086431336229047,1.0378139735225023,65,111,12.413871765136719,9.141276359558105,63,17
1592,1,8.199260826750297,8.199260826750297,0.9543759187068911,0.9543759187068911,0,0,8.317848205566406,8.317848205566406,1,1
1592,2,7.6736284978364075,7.673628497836407,0.9662122192450792,0.9662122192450786,0,0,8.328390121459961,8.317848205566406,2,2
1592,3,7.397732367804961,7.39773236780496,0.971727572130116,0.9717275721301151,0,0,8.427217483520508,8.317848205566406,3,3
1592,4,7.060657448601093,7.060657448601091,0.9801788512725892,0.9801788512725881,0,0,8.57822036743164,8.317848205566406,4,4
1592,8,5.690653207634653,5.692359545872266,1.0032441482478938,1.0032022387210333,1,1,8.965616226196289,8.317848205566406,7,7
1592,16,4.993332979649765,5.486028859228156,1.014066982322861,1.0078167154788251,5,5,9.372673034667969,8.317848205566406,11,11
1592,32,3.9427323967403174,4.948466106465216,1.0199192343604855,1.0186836830895203,15,20,9.71794605255127,8.317848205566406,17,12
1592,64,2.5438346075534874,4.606703314427854,1.0115918655526217,1.0281548034441885,26,51,10.230908393859863,8.317848205566406,38,13
1592,128,1.5905395489932197,4.416539172842077,1.0036482409792462,1.0326303102416408,55,111,10.97477912902832,8.317848205566406,73,17
1593,1,6.213061194072169,6.213061194072168,0.9767030616622067,0.9767030616622069,0,0,6.253420829772949,6.253420829772949,1,1
1593,2,5.4106479426210585,5.410647942621057,0.990853743418086,0.9908537434180855,0,0,6.999753475189209,6.253420829772949,2,2
1593,3,4.636044101510644,4.6360441015106435,0.9993191744061871,0.9993191744061861,0,0,7.177148342132568,6.253420829772949,3,3
1593,4,4.517722607064585,4.517722607064585,1.0016843397041861,1.0016843397041855,0,0,7.299821376800537,6.253420829772949,4,4
1593,8,4.287207427367826,4.287491328008131,1.0053382678757798,1.0054390421599426,1,1,8.267403602600098,6.253420829772949,7,7
1593,16,3.801391372701087,4.110615029214642,1.0072787466156474,1.009601936007608,7,9,8.426528930664062,6.253420829772949,9,7
1593,32,3.186070970849502,3.999198324910262,1.007713940370406,1.0126616332235177,13,19,9.127922058105469,6.253420829772949,19,13
1593,64,2.0124127162022525,3.954369696388626,1.0046233825270148,1.015035850518711,27,49,9.818121910095215,6.253420829772949,37,15
1593,128,0.8685020136742212,3.8994848689785924,1.003001494579442,1.0173201672667218,62,112,10.522205352783203,6.253420829772949,66,16
1594,1,8.824455605617183,8.824455605617185,0.9578534897168132,0.9578534897168138,0,0,8.91435432434082,8.91435432434082,1,1
1594,2,8.38579117841438,8.38579117841438,0.9666474893395601,0.9666474893395601,0,0,8.922135353088379,8.91435432434082,2,2
1594,3,7.82754954396452,7.827549543964521,0.9782104583046403,0.9782104583046394,0,0,8.941936492919922,8.91435432434082,3,3
1594,4,7.413717232292161,7.41371723229216,0.9845528572298792,0.9845528572298792,0,0,9.074152946472168,8.91435432434082,4,4
1594,8,6.248343647972743,6.3191906264552316,1.0049872223634178,1.0035676502156305,2,2,9.480587005615234,8.91435432434082,6,6
1594,16,5.957299206971608,6.1662171102132595,1.0110640897865866,1.0072991444145083,6,5,9.863272666931152,8.91435432434082,10,11
1594,32,5.005708237041459,5.512978505287766,1.0234666239244523,1.0208619445400293,15,20,10.285353660583496,8.91435432434082,17,12
1594,64,3.674425147198441,5.402342699621253,1.0100704775428042,1.025700292244102,32,49,10.715357780456543,8.91435432434082,32,15
1594,128,1.963209964191456,5.391067756173172,0.99702081959372,1.0266267161064366,68,111,11.256734848022461,8.91435432434082,60,17
1595,1,7.2235726494240815,7.223572649424086,0.9722698979119502,0.9722698979119518,0,0,7.272762775421143,7.272762775421143,1,1
1595,2,5.91061157218341,5.910611572183411,0.9898470876823722,0.989847087682374,0,0,7.406972885131836,7.272762775421143,2,2
1595,3,5.7972005015189385,5.79720050151894,0.9922956761524075,0.9922956761524089,0,0,7.536473274230957,7.272762775421143,3,3
1595,4,5.518960009893958,5.51896000989396,0.9964463464948534,0.9964463464948551,0,0,7.61478328704834,7.272762775421143,4,4
1595,8,4.728703770903938,4.953440559347819,1.006394066499565,1.006901934807091,2,4,8.695548057556152,7.272762775421143,6,4
1595,16,4.325728344804207,4.80183758534793,1.0110632760387754,1.0110213275840985,7,9,9.033068656921387,7.272762775421143,9,7
1595,32,2.977635470850708,4.576896416325147,1.0068174591025372,1.0192059285515591,15,24,9.824772834777832,7.272762775421143,17,8
1595,64,2.17437522682975,4.326597105089256,1.0053197964260732,1.026792976740463,32,54,10.495323181152344,7.272762775421143,32,10
1595,128,1.024800503246018,4.247814167526,0.9999503209244991,1.0312583387210472,58,115,11.215864181518555,7.272762775421143,70,13
1596,1,5.091333794543737,5.091333794543739,0.9911339087884938,0.9911339087884945,0,0,5.098271369934082,5.098271369934082,1,1
1596,2,4.746027958294142,4.7460279582941425,0.9982050917883809,0.9982050917883813,0,0,6.590146541595459,5.098271369934082,2,2
1596,3,4.714091772525954,4.714091772525954,0.9990084336990958,0.9990084336990962,0,0,6.735554218292236,5.098271369934082,3,3
1596,4,4.237890359386199,4.237890359386198,1.0051826753995254,1.0051826753995254,0,0,7.023865699768066,5.098271369934082,4,4
1596,8,4.156095755470716,4.208324622332135,1.005554159746668,1.0064899551642768,2,3,7.752964496612549,5.098271369934082,6,5
1596,16,3.5858238587753597,3.881967638105942,1.010153247709773,1.0129636846872716,6,8,8.24803352355957,5.098271369934082,10,8
1596,32,3.064105843436063,3.8444274192505246,1.006860706158049,1.0146188975532524,16,23,9.221582412719727,5.098271369934082,16,9
1596,64,1.9853345922685492,3.7867011098460637,1.0048210017936205,1.018552383473078,26,52,9.969218254089355,5.098271369934082,38,12
1596,128,1.1955735060463788,3.7867011098460637,1.0013414104258709,1.018552383473078,59,116,10.638959884643555,5.098271369934082,69,12
1597,1,6.166501783234329,6.166501783234315,0.9839347775465004,0.983934777546504,0,0,6.185434341430664,6.185434341430664,1,1
1597,2,4.891844268764834,4.891844268764833,0.9958105858202948,0.995810585820295,0,0,6.463737964630127,6.185434341430664,2,2
1597,3,4.3587735075454015,4.3587735075454015,1.0034594098012355,1.0034594098012373,0,0,7.325074195861816,6.185434341430664,3,3
1597,4,4.315895935136487,4.358773507545401,1.002847825136384,1.0034594098012373,1,1,7.332624435424805,6.185434341430664,3,3
1597,8,3.9646155813988297,4.127626501480254,1.0058405627219367,1.0065941365865738,3,3,7.552861213684082,6.185434341430664,5,5
1597,16,3.5588436234347864,4.024519737131627,1.0107135979606077,1.0096177789007283,5,7,7.910577774047852,6.185434341430664,11,9
1597,32,3.0719649256814643,3.7072772834690872,1.0151959532989934,1.0163038202783823,15,21,8.414543151855469,6.185434341430664,17,11
1597,64,2.2796004147805613,3.634093668849006,1.0079687364429408,1.0188175912418074,30,51,8.950142860412598,6.185434341430664,34,13
1597,128,1.1185881976559262,3.595992888784364,1.0024930559680882,1.0193889594969168,62,111,9.664362907409668,6.185434341430664,66,17
1598,1,9.768197732477748,9.768197732477748,0.9357109452738346,0.9357109452738351,0,0,9.952791213989258,9.952791213989258,1,1
1598,2,7.340602652260697,7.3406026522606975,0.9906326707293514,0.9906326707293516,0,0,10.479537963867188,9.952791213989258,2,2
1598,3,6.587761498624107,6.587761498624106,1.0048381529794899,1.0048381529794912,0,0,10.782758712768555,9.952791213989258,3,3
1598,4,6.565874762221435,6.565874762221439,1.0059402708642566,1.0059402708642573,0,0,10.98028564453125,9.952791213989258,4,4
1598,8,6.185117784108727,6.18941118982246,1.0126400360582926,1.0129302429362101,2,2,11.476971626281738,9.952791213989258,6,6
1598,16,5.68689474437369,6.028865277425673,1.0171556022537638,1.017434830598137,7,8,11.859251976013184,9.952791213989258,9,8
1598,32,5.112633709390463,5.984105243361547,1.0171202089877456,1.0212613315336863,16,17,12.472893714904785,9.952791213989258,16,15
1598,64,4.114073879988095,5.982574787278536,1.0092651695120427,1.0215554765835173,30,49,13.104247093200684,9.952791213989258,34,15
1598,128,2.5093965352671117,5.7562089324452845,1.006964088754858,1.0328105424514373,53,114,14.056102752685547,9.952791213989258,75,14
1599,1,7.48688451655758,7.486884516557581,0.9752008993267958,0.9752008993267964,0,0,7.523919105529785,7.523919105529785,1,1
1599,2,6.174594612913564,6.174594612913564,0.9919778330650924,0.9919778330650928,0,0,7.686763763427734,7.523919105529785,2,2
1599,3,6.034039241039088,6.034039241039089,0.9940837796784148,0.9940837796784143,0,0,7.909893035888672,7.523919105529785,3,3
1599,4,5.957543627727636,5.957543627727635,0.9962585217061304,0.9962585217061306,0,0,8.08012866973877,7.523919105529785,4,4
1599,8,5.103587838854949,5.180437169695099,1.0121477415422586,1.009826139650721,1,1,8.605667114257812,7.523919105529785,7,7
1599,16,4.660776602265825,4.79511586667477,1.016756569119786,1.0166800952905972,5,7,9.083810806274414,7.523919105529785,11,9
1599,32,3.9122635235155103,4.51366235096133,1.0221167364075394,1.0225528049948585,15,19,9.827420234680176,7.523919105529785,17,13
1599,64,2.7245255047328154,4.317298043972177,1.012561963539591,1.02822335195307,30,47,10.366389274597168,7.523919105529785,34,17
1599,128,1.6835927666413042,4.295915826583216,1.0041206995861427,1.0300276366940744,55,109,10.953181266784668,7.523919105529785,73,19
1600,1,8.573523246903608,8.573523246903614,0.9613808103721802,0.9613808103721831,0,0,8.649778366088867,8.649778366088867,1,1
1600,2,6.673963668714753,6.673963668714753,0.9889180777857343,0.9889180777857357,0,0,8.860352516174316,8.649778366088867,2,2
1600,3,6.483558512768774,6.483558512768773,0.9924706672072472,0.9924706672072483,0,0,9.447210311889648,8.649778366088867,3,3
1600,4,6.150706860216989,6.150706860216989,0.9993501098160481,0.9993501098160491,0,0,9.779135704040527,8.649778366088867,4,4
1600,8,5.87322271327335,6.041807804017674,1.0040209858312874,1.0040913361625667,3,2,10.298751831054688,8.649778366088867,5,6
1600,16,5.435937432010779,5.7933123741662484,1.0137104332185491,1.0128605717011303,7,7,10.837909698486328,8.649778366088867,9,9
1600,32,4.415159877717927,5.7175225381923305,1.014603734419472,1.0165471152818775,13,19,11.420098304748535,8.649778366088867,19,13
1600,64,3.3234618289834104,5.352508397509168,1.0147989965978597,1.0271898137521234,30,50,11.883745193481445,8.649778366088867,34,14
1600,128,2.1678461126862647,5.3375006437671235,1.0082971900296482,1.029514234571181,62,111,12.429491996765137,8.649778366088867,66,17
1601,1,10.647499982203835,10.647499982203842,0.9204503001549502,0.9204503001549527,0,0,10.90914535522461,10.90914535522461,1,1
1601,2,10.332055648441981,10.33205564844195,0.9390930020198606,0.9390930020198627,0,0,14.302441596984863,10.90914535522461,2,2
1601,3,9.946559931219655,9.946559931219655,0.9534558555206498,0.9534558555206505,0,0,14.697029113769531,10.90914535522461,3,3
1601,4,9.797607651447056,9.946559931219655,0.9504342736692056,0.9534558555206505,1,1,14.972699165344238,10.90914535522461,3,3
1601,8,8.369771189567748,8.434934847116141,1.0066144787038507,1.0101860260968254,2,3,15.78329086303711,10.90914535522461,6,5
1601,16,7.416117516958366,7.919824968239832,1.0323441061698708,1.0353724485667288,5,9,16.446491241455078,10.90914535522461,11,7
1601,32,6.917997641217477,7.893450965838319,1.0223250786310674,1.0369179200418261,15,24,16.991313934326172,10.90914535522461,17,8
1601,64,5.461502582824121,7.84074306670325,1.0193185756251701,1.0366426721427717,33,55,17.384029388427734,10.90914535522461,31,9
1601,128,3.6214068320157877,7.80387432017027,1.0192641859168348,1.0399902888192631,63,114,17.887109756469727,10.90914535522461,65,14
1602,1,6.282752122172109,6.282752122172111,0.9765611625657014,0.9765611625657029,0,0,6.32297420501709,6.32297420501709,1,1
1602,2,5.616259141740994,5.616259141740997,0.984548917659159,0.9845489176591606,0,0,6.344549655914307,6.32297420501709,2,2
1602,3,5.521721447105645,5.521721447105635,0.9854494320318159,0.9854494320318185,0,0,6.381899356842041,6.32297420501709,3,3
1602,4,4.354248646745849,4.40032554322939,1.0006306886076595,1.0001003813511695,1,1,6.434366703033447,6.32297420501709,3,3
1602,8,3.8135730372943795,3.9244822130031696,1.009522688456224,1.008179947626447,3,3,7.603046894073486,6.32297420501709,5,5
1602,16,3.4785534815428987,3.596041714443872,1.0140571147308544,1.013700201590907,6,8,8.501705169677734,6.32297420501709,10,8
1602,32,3.009124173532266,3.5651804486969594,1.011023046046143,1.015138627914094,14,22,8.982266426086426,6.32297420501709,18,10
1602,64,2.163683089866727,3.4467620290428758,1.0006393100784208,1.0170645196525325,29,50,9.659981727600098,6.32297420501709,35,14
1602,128,1.16666273797009,3.443737916408147,1.0019902693205827,1.0178621996881942,59,110,10.432440757751465,6.32297420501709,69,18
1603,1,3.027818473960649,3.027818473960647,0.993874474144621,0.9938744741446235,0,0,3.0337672233581543,3.0337672233581543,1,1
1603,2,2.655686584577136,2.6556865845771367,0.9969783269631778,0.9969783269631797,0,0,3.7522454261779785,3.0337672233581543,2,2
1603,3,2.4542675371893985,2.454267537189399,0.999468670504079,0.9994686705040807,0,0,3.8442471027374268,3.0337672233581543,3,3
1603,4,2.3907800758818083,2.454267537189399,0.9985948803318239,0.9994686705040807,1,1,3.933349370956421,3.0337672233581543,3,3
1603,8,2.3093113652984627,2.413718439344817,0.9996106970602934,1.0003667875924973,2,2,4.142157554626465,3.0337672233581543,6,6
1603,16,1.7583560073778397,2.114258889807667,1.0043151509551653,1.0037208888947946,5,7,4.354144096374512,3.0337672233581543,11,9
1603,32,1.4093696666378295,2.0179479345844573,1.0040432080875616,1.004511401983022,16,24,4.800302028656006,3.0337672233581543,16,8
1603,64,0.6318518038825792,1.9478542930654106,0.9998063795854444,1.0054465236915435,32,54,5.314276218414307,3.0337672233581543,32,10
1603,128,0.09659818689176321,1.812041188055583,0.9999418108770279,1.0084144363947456,66,114,5.914297103881836,3.0337672233581543,62,14
1604,1,8.588832707868288,8.588832707868288,0.9595666758730816,0.9595666758730825,0,0,8.673179626464844,8.673179626464844,1,1
1604,2,7.587746273985005,7.587746273984976,0.9869335754898161,0.9869335754898166,0,0,10.628519058227539,8.673179626464844,2,2
1604,3,7.119141390126987,7.119141390126987,0.9980221907507232,0.9980221907507238,0,0,10.730257987976074,8.673179626464844,3,3
1604,4,7.0801133687551685,7.080113368755168,1.0016588285440322,1.0016588285440329,0,0,10.748014450073242,8.673179626464844,4,4
1604,8,5.558192729604516,5.613108876332602,1.0250423089948693,1.0261925395795295,1,2,10.928038597106934,8.673179626464844,7,6
1604,16,4.883316315383232,5.188353830675823,1.0361898614014033,1.0361271812053396,7,9,11.81564712524414,8.673179626464844,9,7
1604,32,4.444922451620182,5.14567320550527,1.0341912734866288,1.0393062499848444,15,21,12.632948875427246,8.673179626464844,17,11
1604,64,3.136402803185284,5.088524932959523,1.0156283764122591,1.0436540857706613,29,49,13.300853729248047,8.673179626464844,35,15
1604,128,2.145263680663299,4.985523980904637,1.0037111372126999,1.0454810686290297,60,115,14.225743293762207,8.673179626464844,68,13
1605,1,8.526467061927361,8.526467061927361,0.9583658045983586,0.9583658045983593,0,0,8.617173194885254,8.617173194885254,1,1
1605,2,6.922640280070074,6.922640280070074,0.9862830417327538,0.9862830417327539,0,0,8.833067893981934,8.617173194885254,2,2
1605,3,6.23937868728703,6.239378687287031,0.9996027701330066,0.9996027701330064,0,0,8.858057022094727,8.617173194885254,3,3
1605,4,5.941892888292636,5.941892888292636,1.0049492078598972,1.004949207859897,0,0,8.90473461151123,8.617173194885254,4,4
1605,8,5.064004829837324,5.09292802999907,1.018923329265986,1.0179753888840057,1,1,9.183874130249023,8.617173194885254,7,7
1605,16,4.763781016702981,4.883744729500817,1.0245990993344476,1.0231544804726234,5,6,9.7269868850708,8.617173194885254,11,10
1605,32,4.0805387266482365,4.509197800682607,1.0315764908786902,1.0311188825682183,11,16,10.228995323181152,8.617173194885254,21,16
1605,64,3.1178501071307703,4.4587522286343395,1.0179169156540078,1.0328480335918844,31,48,10.749520301818848,8.617173194885254,33,16
1605,128,1.969703591735987,4.42498941242674,1.0081477533518144,1.0346411387686014,59,111,11.412751197814941,8.617173194885254,69,17
1606,1,8.300788113410912,8.300788113410892,0.9588060958189003,0.958806095818903,0,0,8.395458221435547,8.395458221435547,1,1
1606,2,8.11669142992017,8.116691429920174,0.9653156171763759,0.9653156171763779,0,0,9.060794830322266,8.395458221435547,2,2
1606,3,6.78582791311744,6.78582791311744,0.9918533668701548,0.9918533668701555,0,0,9.06212043762207,8.395458221435547,3,3
1606,4,6.625576570906089,6.625576570906088,0.994743600624012,0.9947436006240137,0,0,9.309243202209473,8.395458221435547,4,4
1606,8,6.261991961823985,6.264080055070093,1.004551852548184,1.0047673632699856,2,2,9.92199993133545,8.395458221435547,6,6
1606,16,5.307673055432327,5.647468088293788,1.017192686878737,1.0172466113830976,7,8,10.170605659484863,8.395458221435547,9,8
1606,32,4.291166310323226,5.1351299525247045,1.0269912189164785,1.0306183206213246,15,18,10.741822242736816,8.395458221435547,17,14
1606,64,3.0800497564459857,5.047657788478133,1.0144470735776638,1.0335581773928513,28,47,11.495887756347656,8.395458221435547,36,17
1606,128,1.8574197688714553,4.993819099189034,1.0040766504680685,1.0356288111360907,60,112,12.136709213256836,8.395458221435547,68,16
1607,1,6.237179205570121,6.237179205570124,0.97955499199349,0.9795549919934914,0,0,6.268491268157959,6.268491268157959,1,1
1607,2,5.877679758399092,5.8776797583990925,0.9883031263227007,0.988303126322702,0,0,7.201282978057861,6.268491268157959,2,2
1607,3,5.842792074280169,5.84279207428017,0.989473295069178,0.9894732950691794,0,0,7.40059757232666,6.268491268157959,3,3
1607,4,4.955799130437294,4.955799130437294,1.0031161651640188,1.0031161651640195,0,0,8.116049766540527,6.268491268157959,4,4
1607,8,4.828781618110845,4.8392930530252505,1.006812050060737,1.006686533749903,1,2,8.754733085632324,6.268491268157959,7,6
1607,16,4.282163565147114,4.419179140915704,1.0154375452875193,1.0162742779257563,4,8,9.556656837463379,6.268491268157959,12,8
1607,32,3.263364960107548,4.019938142556723,1.013955226896026,1.0244962485843663,12,18,9.971641540527344,6.268491268157959,20,14
1607,64,2.318814839306705,3.954287059797141,1.0062115151548958,1.025395580737074,32,50,10.36330509185791,6.268491268157959,32,14
1607,128,1.2197036706646607,3.8291923991112227,1.0014923811105663,1.0271122523376466,64,110,10.818522453308105,6.268491268157959,64,18
1608,1,7.594445270989565,7.594445270989565,0.9717200817703555,0.9717200817703562,0,0,7.6419243812561035,7.6419243812561035,1,1
1608,2,6.450312681150076,6.450312681150076,0.990086641865275,0.9900866418652752,0,0,8.000171661376953,7.6419243812561035,2,2
1608,3,5.59179551406158,5.59179551406158,1.0035171156202127,1.0035171156202125,0,0,8.035333633422852,7.6419243812561035,3,3
1608,4,5.546332474460956,5.546332474460956,1.0048188686449282,1.0048188686449284,0,0,8.215267181396484,7.6419243812561035,4,4
1608,8,4.064703562633471,4.074044725177497,1.0219738707378587,1.022165898801687,2,2,8.486047744750977,7.6419243812561035,6,6
1608,16,3.9138135611066014,4.01541689867875,1.0232041690397171,1.0232638274901678,5,6,9.088113784790039,7.6419243812561035,11,10
1608,32,3.2370412715421732,3.749735977699755,1.0237911270569338,1.0291000628318785,11,17,9.737081527709961,7.6419243812561035,21,15
1608,64,2.605945735155864,3.749735977699755,1.0172566226558368,1.0291000628318785,29,49,10.567097663879395,7.6419243812561035,35,15
1608,128,1.5593904152543616,3.723335693209317,1.0042316934968147,1.0316874528844338,68,112,11.279011726379395,7.6419243812561035,60,16
1609,1,12.749458088061107,12.74945808806111,0.9055712484823489,0.9055712484823518,0,0,13.053060531616211,13.053060531616211,1,1
1609,2,10.071903538932693,10.071903538932695,0.9920469017227107,0.9920469017227147,0,0,14.278112411499023,13.053060531616211,2,2
1609,3,9.993401086340912,9.993401086340912,0.9975694934194796,0.9975694934194833,0,0,14.875211715698242,13.053060531616211,3,3
1609,4,9.680653427568974,9.680653427568975,1.0081148014817558,1.0081148014817591,0,0,14.998154640197754,13.053060531616211,4,4
1609,8,9.59460624530034,9.680653427568975,1.0063634829611536,1.0081148014817591,2,4,16.126218795776367,13.053060531616211,6,4
1609,16,8.865023924471917,9.178912032020051,1.0263267372009606,1.0302761988688554,5,8,16.40545082092285,13.053060531616211,11,8
1609,32,8.344600446755285,8.968388496041152,1.0338813219495244,1.0398595252648113,13,21,16.72062873840332,13.053060531616211,19,11
1609,64,6.482309844866285,8.538073017435531,1.0231914518361498,1.0508589908072294,37,49,17.220441818237305,13.053060531616211,27,15
1609,128,4.09815486105173,8.419737469216482,1.00875761018085,1.0581925648782275,66,111,17.687837600708008,13.053060531616211,62,17
1610,1,10.890762669810519,10.890762669810515,0.9399117449345773,0.9399117449345813,0,0,11.033379554748535,11.033379554748535,1,1
1610,2,9.713296643320401,9.713296643320403,0.9699499115629897,0.9699499115629928,0,0,11.22985553741455,11.033379554748535,2,2
1610,3,9.548470338369963,9.548470338369954,0.9742542676273113,0.9742542676273138,0,0,11.58459186553955,11.033379554748535,3,3
1610,4,8.438941235859069,8.43894123585907,0.9909589471921902,0.9909589471921908,0,0,12.134123802185059,11.033379554748535,4,4
1610,8,8.040333185796653,8.242942868059954,0.9984796056111436,1.0019901582827986,2,3,13.708508491516113,11.033379554748535,6,5
1610,16,7.566773727497604,8.19384089942905,1.0024118215445725,1.0074069031764954,6,8,14.023199081420898,11.033379554748535,10,8
1610,32,6.784296334563585,7.879825120028726,1.0087770985980995,1.0302461816258242,15,23,14.888972282409668,11.033379554748535,17,9
1610,64,5.816519353402592,7.8778371652831645,0.9954866621527052,1.0307707937070292,35,52,15.536476135253906,11.033379554748535,29,12
1610,128,4.1593648309895075,7.868948628027942,0.9872041015673042,1.033035993374405,60,118,16.50874900817871,11.033379554748535,68,10
1611,1,10.191132328685606,10.191132328685608,0.9492184333853606,0.9492184333853623,0,0,10.303606033325195,10.303606033325195,1,1
1611,2,8.794172276874644,8.794172276874644,0.9722605473240014,0.9722605473240025,0,0,10.30496883392334,10.303606033325195,2,2
1611,3,8.659087314572705,8.659087314572709,0.9761264132737417,0.9761264132737425,0,0,10.41426944732666,10.303606033325195,3,3
1611,4,8.619293906678148,8.61929390667815,0.9763044917040554,0.9763044917040563,0,0,10.47237491607666,10.303606033325195,4,4
1611,8,7.69000097689835,7.690311962802277,0.9968729920561079,0.9967303226547704,1,1,10.733429908752441,10.303606033325195,7,7
1611,16,7.056406821006612,7.189485322125888,1.0093695607608841,1.0087238876337585,4,8,11.349953651428223,10.303606033325195,12,8
1611,32,5.955025886580991,6.449274079908233,1.0294369611706613,1.0290349554447569,11,21,11.79881477355957,10.303606033325195,21,11
1611,64,3.994734450820675,6.169417695344501,1.0241107878865352,1.0348325126190507,33,47,12.271799087524414,10.303606033325195,31,17
1611,128,2.5702736406315587,6.083319913197222,1.0103298495902877,1.0402212285487515,64,106,12.800688743591309,10.303606033325195,64,22
1612,1,8.896108890994833,8.896108890994839,0.9598514142560354,0.9598514142560369,0,0,8.975920677185059,8.975920677185059,1,1
1612,2,7.879114229616224,7.879114229616223,0.9854648559520014,0.9854648559520021,0,0,10.216729164123535,8.975920677185059,2,2
1612,3,7.741912385524664,7.741912385524665,0.9895472748296104,0.9895472748296119,0,0,10.428436279296875,8.975920677185059,3,3
1612,4,7.130042327587448,7.130042327587449,1.0007345716785385,1.0007345716785392,0,0,10.489652633666992,8.975920677185059,4,4
1612,8,6.838830306460165,6.8388303064601645,1.0095605821636866,1.009560582163687,0,0,11.2054443359375,8.975920677185059,8,8
1612,16,6.587759411702388,6.769399516637935,1.0115141460473578,1.012137841037531,5,8,11.697497367858887,8.975920677185059,11,8
1612,32,5.342670874913133,6.130210038431142,1.027287163398046,1.0304580707463158,10,21,12.275418281555176,8.975920677185059,22,11
1612,64,3.95480300675439,6.039457599636318,1.0207714124166491,1.0333279888420914,29,50,13.041064262390137,8.975920677185059,35,14
1612,128,2.279116940145126,5.868570137223397,1.0108277002787485,1.0387489231792735,58,111,13.68933391571045,8.975920677185059,70,17
1613,1,9.39800383620026,9.39800383620026,0.9610196640036314,0.9610196640036313,0,0,9.4675931930542,9.4675931930542,1,1
1613,2,7.583763823730028,7.583763823730028,0.9897522509310512,0.9897522509310515,0,0,9.694892883300781,9.4675931930542,2,2
1613,3,7.011780553642199,7.011780553642198,0.9998979850787962,0.9998979850787966,0,0,10.19637680053711,9.4675931930542,3,3
1613,4,6.60556839559982,6.60556839559982,1.0088959738921863,1.0088959738921868,0,0,10.538065910339355,9.4675931930542,4,4
1613,8,6.178839591440071,6.204169450026203,1.0158565293534785,1.0162872459461751,1,1,11.05522346496582,9.4675931930542,7,7
1613,16,5.718501417029619,5.794118163256895,1.0264884709439501,1.0273234989693534,6,7,11.55695915222168,9.4675931930542,10,9
1613,32,4.905523649078342,5.657487189817746,1.025292261633817,1.0323388114530834,10,19,12.463733673095703,9.4675931930542,22,13
1613,64,3.3634491926318373,5.361111001245851,1.023247383385115,1.0435869307402816,30,47,13.161375045776367,9.4675931930542,34,17
1613,128,1.9846682001476315,5.352559766423592,1.005583659523043,1.0441040801267247,63,110,14.059449195861816,9.4675931930542,65,18
1614,1,9.048554182694557,9.048554182694561,0.9568989370672024,0.9568989370672041,0,0,9.141135215759277,9.141135215759277,1,1
1614,2,8.353237526457383,8.353237526457383,0.973986225107883,0.9739862251078837,0,0,9.50525188446045,9.141135215759277,2,2
1614,3,7.914932478856919,7.914932478856918,0.9807601795605414,0.9807601795605423,0,0,9.717926979064941,9.141135215759277,3,3
1614,4,7.001552010600056,7.001552010600058,0.9980685754222294,0.9980685754222314,0,0,9.884257316589355,9.141135215759277,4,4
1614,8,6.0414573512501075,6.100581510381642,1.0120689029287715,1.0121159671493287,2,2,10.043827056884766,9.141135215759277,6,6
1614,16,5.505619789192278,5.6698675634035665,1.0199380280897028,1.0210503690493524,4,6,10.601962089538574,9.141135215759277,12,10
1614,32,4.540942779208534,5.362598259070645,1.0240855969022744,1.028208055522552,13,21,11.314713478088379,9.141135215759277,19,11
1614,64,3.633167767307172,5.358113313418746,1.021673964264213,1.0289096362570265,30,49,11.86915397644043,9.141135215759277,34,15
1614,128,1.9652338447678117,5.3283463002603,1.0095108547256677,1.0314314369943673,60,111,12.329833030700684,9.141135215759277,68,17
1615,1,9.6139299185308,9.613929918530758,0.9386882809478952,0.9386882809478979,0,0,9.7838773727417,9.7838773727417,1,1
1615,2,8.667474274766663,8.667474274766661,0.9609085742183516,0.9609085742183527,0,0,9.92586612701416,9.7838773727417,2,2
1615,3,7.9242122233398025,7.924212223339799,0.9784137068301544,0.9784137068301553,0,0,9.948748588562012,9.7838773727417,3,3
1615,4,7.799350935723906,7.799350935723907,0.9820555847373718,0.9820555847373731,0,0,11.216715812683105,9.7838773727417,4,4
1615,8,7.265447690391192,7.26844854971076,0.9974487730604789,0.9979372898205678,1,1,11.95195198059082,9.7838773727417,7,7
1615,16,5.983014850523655,6.961047601427851,1.0198816851288015,1.01341625930557,4,6,12.504167556762695,9.7838773727417,12,10
1615,32,5.22578239778522,6.676395784896448,1.0211849909475914,1.024030782197445,15,20,13.208078384399414,9.7838773727417,17,12
1615,64,3.8968298723454806,6.546998340261641,1.0116871954015172,1.029797195284509,28,50,13.94501781463623,9.7838773727417,36,14
1615,128,2.665748691143794,6.515006301210761,1.005230702472847,1.0318483153137197,58,112,14.698870658874512,9.7838773727417,70,16
1616,1,10.73502887904483,10.735028879044835,0.917753168607319,0.9177531686073215,0,0,11.010469436645508,11.010469436645508,1,1
1616,2,8.93750613850653,8.937506138506532,0.9659300115905001,0.9659300115905005,0,0,11.31128215789795,11.010469436645508,2,2
1616,3,8.161618749849026,8.161618749849026,0.9826393428920785,0.9826393428920797,0,0,11.477035522460938,11.010469436645508,3,3
1616,4,8.161296177655894,8.161618749849026,0.9825284317516882,0.9826393428920797,1,1,12.140266418457031,11.010469436645508,3,3
1616,8,7.751490224531373,7.752875745143068,0.9970614729122784,0.9968015334641717,1,1,12.206205368041992,11.010469436645508,7,7
1616,16,6.522277361441872,7.099502779235623,1.0213894040759361,1.017994935409377,5,6,13.034588813781738,11.010469436645508,11,10
1616,32,5.177885108953005,6.944332672669382,1.0199384011504402,1.024311105295073,13,21,13.88559341430664,11.010469436645508,19,11
1616,64,4.038088912173466,6.7296748009332585,1.0153711701451034,1.035868793727015,34,47,14.918662071228027,11.010469436645508,30,17
1616,128,2.7355591775214454,6.642554034247714,1.0010877668359233,1.042690165661459,65,109,15.678586959838867,11.010469436645508,63,19
1617,1,11.19165930592513,11.19165930592513,0.928999380827706,0.9289993808277085,0,0,11.38530158996582,11.38530158996582,1,1
1617,2,9.617664290950295,9.617664290950296,0.9700367965618448,0.9700367965618457,0,0,11.417181015014648,11.38530158996582,2,2
1617,3,9.473671734714907,9.473671734714909,0.9725689366579462,0.9725689366579467,0,0,11.685763359069824,11.38530158996582,3,3
1617,4,8.655456683277174,8.661682506679147,0.9899956165711817,0.9897467525245152,1,1,11.696554183959961,11.38530158996582,3,3
1617,8,7.235733146766083,7.478330372163291,1.0183143347767991,1.0136841636560054,1,1,11.838754653930664,11.38530158996582,7,7
1617,16,6.627729721186627,6.850997359393802,1.0355958717859868,1.0305291205017544,6,7,12.204252243041992,11.38530158996582,10,9
1617,32,6.06528815828961,6.608429908989138,1.0473379376457363,1.0367392203584485,15,18,12.508328437805176,11.38530158996582,17,14
1617,64,4.421828773019909,6.178493543897417,1.0364673676694547,1.0488350866842149,29,46,13.106027603149414,11.38530158996582,35,18
1617,128,2.8539856577488067,5.984317081132093,1.0170261853663574,1.0562652006574738,56,108,13.646581649780273,11.38530158996582,72,20
1618,1,13.983775434003537,13.983775434003542,0.9007826718153455,0.900782671815347,0,0,14.287694931030273,14.287694931030273,1,1
1618,2,10.380212618329187,10.380212618329187,1.0031002729900984,1.0031002729900993,0,0,14.464616775512695,14.287694931030273,2,2
1618,3,10.161705013006612,10.161705013006614,1.0090764976337128,1.0090764976337139,0,0,14.504325866699219,14.287694931030273,3,3
1618,4,9.870270396392687,9.870270396392687,1.0173464821631188,1.0173464821631184,0,0,14.600057601928711,14.287694931030273,4,4
1618,8,9.132222442982213,9.14011806514334,1.0382846566204718,1.0379807929319456,2,2,14.885159492492676,14.287694931030273,6,6
1618,16,8.537080203018437,8.676847820476551,1.050956711151443,1.0484337631324594,4,6,15.277612686157227,14.287694931030273,12,10
1618,32,7.336250240641418,8.620118983550382,1.055446169184465,1.052500408435569,15,21,16.019960403442383,14.287694931030273,17,11
1618,64,6.036836096377097,8.555505907978604,1.0391345813251558,1.0589156974627691,26,50,16.763565063476562,14.287694931030273,38,14
1618,128,3.9733663991343784,8.440278761278663,1.0196527511688824,1.0626758531911729,69,114,17.208528518676758,14.287694931030273,59,14
1619,1,6.779009239333943,6.779009239333945,0.9757599909999686,0.9757599909999698,0,0,6.81761360168457,6.81761360168457,1,1
1619,2,5.8929205457660006,5.892920545766,0.9890789923203567,0.9890789923203567,0,0,6.825782299041748,6.81761360168457,2,2
1619,3,5.094632207705022,5.094632207705021,1.0004019884135642,1.000401988413565,0,0,6.901717662811279,6.81761360168457,3,3
1619,4,4.6454256383069055,4.6454256383069055,1.0056849381960236,1.005684938196023,0,0,6.956200122833252,6.81761360168457,4,4
1619,8,4.374607840079662,4.374607840079662,1.0117595154507013,1.011759515450701,0,0,7.444707870483398,6.81761360168457,8,8
1619,16,3.5220375277445473,3.698037520588132,1.0166288119056943,1.018248791634231,2,3,8.311301231384277,6.81761360168457,14,13
1619,32,3.095957827873305,3.6304942911487754,1.009269364784303,1.020510084288125,10,18,9.345763206481934,6.81761360168457,22,14
1619,64,2.18240068118087,3.568665203656832,1.002870076305974,1.0223250436368758,32,51,10.0728759765625,6.81761360168457,32,13
1619,128,1.235956511249804,3.549539190292018,0.9999097815421416,1.0242165354280202,64,111,11.210766792297363,6.81761360168457,64,17
1620,1,8.656179953069566,8.656179953069568,0.9634211657565042,0.9634211657565114,0,0,8.725728988647461,8.725728988647461,1,1
1620,2,7.808749269054139,7.808749269054141,0.9809109885869607,0.9809109885869653,0,0,9.872576713562012,8.725728988647461,2,2
1620,3,7.6653065629932104,7.665306562993214,0.9852926691093116,0.9852926691093158,0,0,10.156078338623047,8.725728988647461,3,3
1620,4,6.95934597439375,6.959345974393748,1.0016675274627467,1.0016675274627498,0,0,10.163217544555664,8.725728988647461,4,4
1620,8,6.19207251164798,6.257099158838862,1.0156249176938008,1.016322533784534,1,1,11.487010955810547,8.725728988647461,7,7
1620,16,5.341608475045175,5.544636978211484,1.0365341306798046,1.0363975840714397,6,8,12.505865097045898,8.725728988647461,10,8
1620,32,4.605736218144115,5.532341954818398,1.0227192137894443,1.037396737936342,14,20,13.325169563293457,8.725728988647461,18,12
1620,64,3.451277655117478,5.371938044039784,1.019538238154221,1.046439889396357,30,51,14.10964584350586,8.725728988647461,34,13
1620,128,2.351641346674424,5.219529747553757,1.0053866564584444,1.0505384921650702,59,114,14.86991024017334,8.725728988647461,69,14
1621,1,9.301243980978617,9.301243980978622,0.9579314869833115,0.9579314869833137,0,0,9.384723663330078,9.384723663330078,1,1
1621,2,8.086220496072277,8.086220496072277,0.9839304325427869,0.9839304325427887,0,0,9.84852123260498,9.384723663330078,2,2
1621,3,6.730956888077778,6.730956888077778,1.0102767700165014,1.0102767700165027,0,0,9.865220069885254,9.384723663330078,3,3
1621,4,6.699884525514521,6.699884525514521,1.0118121069457975,1.011812106945798,0,0,10.333892822265625,9.384723663330078,4,4
1621,8,5.708964673699897,5.708964673699881,1.031118100967624,1.0311181009676227,0,0,10.778543472290039,9.384723663330078,8,8
1621,16,5.200811461650928,5.424255811765129,1.0350557200730839,1.0369565452747975,5,6,11.512568473815918,9.384723663330078,11,10
1621,32,4.708244173619776,5.0987323636436575,1.0435987194662137,1.0481343004421282,12,16,12.070406913757324,9.384723663330078,20,16
1621,64,3.804197295384787,4.92016160844866,1.0349416396790945,1.0541359929890255,29,46,12.617594718933105,9.384723663330078,35,18
1621,128,2.1523272863414356,4.889475197747729,1.0100157173755102,1.0566347540689474,65,108,13.382271766662598,9.384723663330078,63,20
1622,1,6.653032837066152,6.653032837066153,0.9810391111145845,0.9810391111145862,0,0,6.6772050857543945,6.6772050857543945,1,1
1622,2,5.389423450358711,5.389423450358711,0.9978486366721575,0.9978486366721575,0,0,7.239713668823242,6.6772050857543945,2,2
1622,3,5.236435053168076,5.236435053168077,0.999677228208319,0.999677228208318,0,0,7.519524574279785,6.6772050857543945,3,3
1622,4,5.184614624706183,5.184614624706183,1.0007628907195332,1.0007628907195323,0,0,7.591439247131348,6.6772050857543945,4,4
1622,8,4.099531752180301,4.099547872245731,1.0192253068337411,1.019206797380031,1,1,8.100176811218262,6.6772050857543945,7,7
1622,16,3.7298179321680367,3.8397211753562894,1.021298126717661,1.0232474596920567,7,6,9.133065223693848,6.6772050857543945,9,10
1622,32,3.0021774400569057,3.823355165172344,1.0153520453142835,1.023870674992082,13,21,9.623485565185547,6.6772050857543945,19,11
1622,64,2.3260758626315075,3.8177525306481916,1.0101684463009477,1.024358950072898,31,52,10.405003547668457,6.6772050857543945,33,12
1622,128,1.0671094273104262,3.817091774546061,1.0007588701557197,1.0246151914112545,60,116,11.217065811157227,6.6772050857543945,68,12
1623,1,10.867023290070456,10.86702329007041,0.9201577415023141,0.9201577415023159,0,0,11.119049072265625,11.119049072265625,1,1
1623,2,8.423220190919192,8.423220190919194,0.9829804086813949,0.9829804086813967,0,0,11.43187141418457,11.119049072265625,2,2
1623,3,7.550442204703544,7.550442204703544,1.0036509861307907,1.0036509861307927,0,0,11.449962615966797,11.119049072265625,3,3
1623,4,7.351067039818238,7.351067039818237,1.008709678219332,1.0087096782193337,0,0,11.479201316833496,11.119049072265625,4,4
1623,8,7.107619188562875,7.115407998241867,1.0122358857202725,1.01216498426111,3,3,11.81048583984375,11.119049072265625,5,5
1623,16,6.155172509136582,7.022966113859658,1.0221647735578028,1.0149385463123077,6,9,12.276121139526367,11.119049072265625,10,7
1623,32,5.4370536513708005,6.8970049326029255,1.0294119294999347,1.0215938719154436,14,23,12.911819458007812,11.119049072265625,18,9
1623,64,3.9470273783695333,6.7827456540287,1.0152623321583045,1.0275503474748744,33,53,13.633585929870605,11.119049072265625,31,11
1623,128,2.5591293045085983,6.515040129822076,1.0052711305578728,1.0432869589389782,64,113,14.540668487548828,11.119049072265625,64,15
1624,1,6.937415743931522,6.937415743931526,0.9776749164547582,0.9776749164547607,0,0,6.970922470092773,6.970922470092773,1,1
1624,2,5.574272199232345,5.574272199232345,0.9972107602491618,0.997210760249164,0,0,7.008724689483643,6.970922470092773,2,2
1624,3,5.168085297378998,5.168085297378998,1.001306663298028,1.0013066632980285,0,0,7.022554397583008,6.970922470092773,3,3
1624,4,4.815337428018944,4.815337428018943,1.0055347612583305,1.005534761258332,0,0,7.397975444793701,6.970922470092773,4,4
1624,8,4.6085161721882075,4.690605058833388,1.0076260509393318,1.0079516761745926,2,2,7.70068883895874,6.970922470092773,6,6
1624,16,4.242118684753126,4.351714705226143,1.0129535900783955,1.0127198269852518,7,7,7.9936299324035645,6.970922470092773,9,9
1624,32,3.1239227719202898,4.048686991984367,1.0123717836261668,1.0170888509412945,14,24,8.465258598327637,6.970922470092773,18,8
1624,64,1.9274815167665105,3.966125581190128,1.003149234210933,1.018617540544112,29,56,9.241349220275879,6.970922470092773,35,8
1624,128,0.964179236050802,3.888247715053255,1.0000915584279029,1.022092321286615,66,113,9.789430618286133,6.970922470092773,62,15
1625,1,7.093090835338062,7.093090835338022,0.9655505446735674,0.9655505446735679,0,0,7.169606685638428,7.169606685638428,1,1
1625,2,6.557841810594694,6.557841810594695,0.9769200965920017,0.9769200965920021,0,0,7.997311592102051,7.169606685638428,2,2
1625,3,6.162150742422283,6.162150742422283,0.9862767064492386,0.9862767064492385,0,0,8.109649658203125,7.169606685638428,3,3
1625,4,6.120156950631493,6.120156950631492,0.9873830729983237,0.987383072998324,0,0,8.315922737121582,7.169606685638428,4,4
1625,8,5.748096919191918,5.912080719186021,0.9911649198701453,0.9907521527762324,2,2,8.940479278564453,7.169606685638428,6,6
1625,16,4.820745149702238,5.144842861013188,1.0113514513169632,1.0093759804902673,5,7,9.51496696472168,7.169606685638428,11,9
1625,32,4.398489799246857,5.083539626480275,1.0116604703198333,1.0133264619772593,13,20,10.18668270111084,7.169606685638428,19,12
1625,64,3.423785846595494,4.952569528390644,1.0036736000720172,1.0180798951376284,31,50,10.964139938354492,7.169606685638428,33,14
1625,128,2.031994665898225,4.8836406910595,1.0015569012189565,1.0225448937751902,66,110,11.605634689331055,7.169606685638428,62,18
1626,1,7.847780137037912,7.847780137037915,0.9629056429224496,0.9629056429224508,0,0,7.926830291748047,7.926830291748047,1,1
1626,2,6.370438402863698,6.370438402863699,0.9860760105946783,0.9860760105946788,0,0,8.386137962341309,7.926830291748047,2,2
1626,3,6.107048539874849,6.107048539874844,0.9926354314844144,0.9926354314844152,0,0,8.598793983459473,7.926830291748047,3,3
1626,4,5.980294909329875,5.980294909329875,0.994660355540047,0.9946603555400484,0,0,8.617875099182129,7.926830291748047,4,4
1626,8,5.345281925999378,5.352159809993668,1.0058923410478489,1.0058119069070288,2,2,9.03548526763916,7.926830291748047,6,6
1626,16,4.795241129597561,5.107396065965506,1.0154577101334339,1.011922602328147,6,7,9.499258041381836,7.926830291748047,10,9
1626,32,3.928541248484423,4.741982208796037,1.0219858762034693,1.0219944851394471,12,21,10.261588096618652,7.926830291748047,20,11
1626,64,2.709803006919874,4.622223643487038,1.0137566883942948,1.027506081454606,28,50,11.011167526245117,7.926830291748047,36,14
1626,128,1.676977841736783,4.449068385802947,1.0050895784074902,1.0327300525568603,59,112,11.66456413269043,7.926830291748047,69,16
1627,1,12.282072321926893,12.282072321926897,0.9043883901831699,0.9043883901831724,0,0,12.606780052185059,12.606780052185059,1,1
1627,2,10.22223438868842,10.222234388688424,0.968498416564427,0.9684984165644286,0,0,13.416961669921875,12.606780052185059,2,2
1627,3,9.967592903776694,9.967592903776694,0.9775727436512134,0.9775727436512142,0,0,13.574790954589844,12.606780052185059,3,3
1627,4,9.364742646337362,9.364750494500745,0.9961669429854758,0.9961705816572541,1,1,13.847917556762695,12.606780052185059,3,3
1627,8,8.24484273308001,8.27446193142347,1.0375658943478938,1.037025080925406,2,3,15.207573890686035,12.606780052185059,6,5
1627,16,7.802992206798171,8.106670172668816,1.0446119773945537,1.0438034289023637,7,7,16.183311462402344,12.606780052185059,9,9
1627,32,6.902552132643157,7.588185185195349,1.0613173962893936,1.0624633503479903,13,19,16.772357940673828,12.606780052185059,19,13
1627,64,5.519214278551749,7.502444699523525,1.0474015561481036,1.0665762005273414,28,48,17.489160537719727,12.606780052185059,36,16
1627,128,3.394517779159953,7.449236594681509,1.0108678429561726,1.070163423104655,61,111,18.123889923095703,12.606780052185059,67,17
1628,1,6.719453462833422,6.719453462833406,0.9759990684042916,0.9759990684042922,0,0,6.757791042327881,6.757791042327881,1,1
1628,2,5.787790268521552,5.787790268521552,0.9904470173996047,0.9904470173996048,0,0,7.7915849685668945,6.757791042327881,2,2
1628,3,5.530637914727415,5.530637914727414,0.9938117354424725,0.9938117354424718,0,0,7.997124195098877,6.757791042327881,3,3
1628,4,5.292032181722952,5.292032181722952,0.9994381166925249,0.9994381166925249,0,0,8.056814193725586,6.757791042327881,4,4
1628,8,4.570792906417539,4.693039550213458,1.0058798384330938,1.0064223239674237,1,2,8.988396644592285,6.757791042327881,7,6
1628,16,4.312587015277492,4.656497060066555,1.0078759055952036,1.009182843479148,5,7,9.780564308166504,6.757791042327881,11,9
1628,32,4.131828920144811,4.648446859167216,1.0109152242068,1.010253245379653,14,21,10.277268409729004,6.757791042327881,18,11
1628,64,3.186689746093224,4.56719987577951,1.0073988973748653,1.014813612852358,31,47,10.868330001831055,6.757791042327881,33,17
1628,128,1.8237466765394243,4.560820595291851,0.9987301895294323,1.0156171085527415,66,111,11.549067497253418,6.757791042327881,62,17
1629,1,7.981763021223641,7.981763021223641,0.9619411171104022,0.9619411171104023,0,0,8.061331748962402,8.061331748962402,1,1
1629,2,6.4855818293742615,6.485581829374261,0.9886044998609373,0.9886044998609369,0,0,8.658756256103516,8.061331748962402,2,2
1629,3,6.360540252550243,6.360540252550243,0.9912077492562187,0.9912077492562174,0,0,8.932862281799316,8.061331748962402,3,3
1629,4,6.187581805803561,6.187581805803561,0.9942829167310485,0.9942829167310476,0,0,9.368963241577148,8.061331748962402,4,4
1629,8,5.583343674735391,5.583343674735391,1.0058319220197467,1.0058319220197465,0,0,9.819467544555664,8.061331748962402,8,8
1629,16,5.000944175436152,5.1794945154310446,1.0183738256940345,1.0176200594467022,4,5,10.537277221679688,8.061331748962402,12,11
1629,32,3.9994691880040474,5.011406197545381,1.015255344046127,1.0227607754034418,11,19,11.075916290283203,8.061331748962402,21,13
1629,64,3.003686892989359,4.927540578050858,1.0082952519298904,1.025164723812149,32,50,11.664814949035645,8.061331748962402,32,14
1629,128,1.6379335779635218,4.885529571982769,1.0035213075634204,1.0285422615347453,59,112,12.447758674621582,8.061331748962402,69,16
1630,1,2.5644784227764714,2.564478422776472,0.9980090544564825,0.9980090544564836,0,0,2.5652108192443848,2.5652108192443848,1,1
1630,2,1.9982550431658772,1.9982550431658772,1.0003331128829382,1.000333112882939,0,0,2.695601224899292,2.5652108192443848,2,2
1630,3,1.9597279781198078,1.9597279781198078,1.0004428941379613,1.0004428941379615,0,0,2.774958372116089,2.5652108192443848,3,3
1630,4,1.9511891829874133,1.951189182987413,1.0005575015221877,1.0005575015221886,0,0,2.843644142150879,2.5652108192443848,4,4
1630,8,1.8964095594832746,1.9287135741525456,1.00057476313721,1.0007366473295305,2,1,3.146151542663574,2.5652108192443848,6,7
1630,16,1.7286439118229528,1.7840270616120573,1.0017488726467894,1.001896202435238,5,6,3.4173169136047363,2.5652108192443848,11,10
1630,32,1.0914418856539698,1.5913437848765157,1.0017722804334048,1.00349510282903,13,22,3.6944308280944824,2.5652108192443848,19,10
1630,64,0.2923726480667628,1.4610161528154044,1.0001972718861243,1.004570810552049,26,52,4.175917148590088,2.5652108192443848,38,12
1630,128,0.02551560551884619,1.4304578682230853,0.9999883387745395,1.0047380291011245,67,115,4.9935407638549805,2.5652108192443848,61,13
1631,1,7.111680410918809,7.111680410918809,0.972986428777115,0.972986428777115,0,0,7.158603668212891,7.158603668212891,1,1
1631,2,5.298909911679372,5.298909911679372,0.9975733932498072,0.9975733932498076,0,0,8.0194091796875,7.158603668212891,2,2
1631,3,5.102736520586631,5.102736520586631,1.000979869089683,1.0009798690896834,0,0,8.2545804977417,7.158603668212891,3,3
1631,4,5.091912702231686,5.091912702231686,1.001571255290618,1.0015712552906177,0,0,8.336984634399414,7.158603668212891,4,4
1631,8,4.613451758913645,4.6172832303802815,1.0101188701323291,1.0103949723376036,2,2,8.756026268005371,7.158603668212891,6,6
1631,16,4.452742235488527,4.549845145331555,1.0140377806905343,1.0130877363912347,3,5,9.26419448852539,7.158603668212891,13,11
1631,32,3.8168291525981206,4.3022518776504,1.0160912595574612,1.019512141384327,13,18,9.638335227966309,7.158603668212891,19,14
1631,64,2.52819059357297,4.10545869994251,1.0073488858538064,1.0246286069115358,30,50,10.35791015625,7.158603668212891,34,14
1631,128,1.2519335612299052,4.0381593967879095,1.0028515493861838,1.0265567322863762,58,109,11.044178009033203,7.158603668212891,70,19
1632,1,5.53816531077433,5.53816531077432,0.9862103689217171,0.9862103689217216,0,0,5.553940773010254,5.553940773010254,1,1
1632,2,4.933808715023164,4.933808715023164,0.9949965619824981,0.9949965619825019,0,0,6.792677879333496,5.553940773010254,2,2
1632,3,4.40757407183813,4.4075740718381295,1.000264367595201,1.0002643675952037,0,0,6.900057315826416,5.553940773010254,3,3
1632,4,4.38097070886975,4.380970708869749,1.0020896895181859,1.0020896895181888,0,0,6.906047821044922,5.553940773010254,4,4
1632,8,3.7221115989448457,3.7221115989448443,1.0123064112605107,1.012306411260513,1,1,7.250067234039307,5.553940773010254,7,7
1632,16,3.043253161391674,3.4928349559955048,1.011623429307369,1.0141438466555692,4,8,8.044857025146484,5.553940773010254,12,8
1632,32,2.346684894953757,3.2508957826007228,1.0088924752256696,1.0177219593385292,15,22,8.603946685791016,5.553940773010254,17,10
1632,64,1.7252788366194494,3.1837566396234225,1.0047428536916398,1.0201251467414245,32,50,9.328167915344238,5.553940773010254,32,14
1632,128,1.1324015099448763,3.1673339496366086,1.0015039408009034,1.0218851090802326,60,110,10.065857887268066,5.553940773010254,68,18
1633,1,2.390850556984115,2.3908505569841156,0.997932844252099,0.9979328442520998,0,0,2.391740083694458,2.391740083694458,1,1
1633,2,2.236574924593333,2.2365749245933326,0.9995008022346241,0.9995008022346241,0,0,2.672067642211914,2.391740083694458,2,2
1633,3,1.9690093078592275,1.9690093078592277,1.000438823454846,1.000438823454846,0,0,2.9539077281951904,2.391740083694458,3,3
1633,4,1.8787147194908593,1.878714719490859,1.000638459657531,1.000638459657531,0,0,2.965996265411377,2.391740083694458,4,4
1633,8,1.5268209301177251,1.5337601492500372,1.0021185098349403,1.00227450521397,2,2,3.1877715587615967,2.391740083694458,6,6
1633,16,1.1699892198272637,1.3196507642036486,1.0036698300709364,1.0035047168086852,5,8,3.4168503284454346,2.391740083694458,11,8
1633,32,0.8031845118618667,1.101971515697491,1.0028414860437453,1.0048699847062659,12,21,3.7183210849761963,2.391740083694458,20,11
1633,64,0.35970053917564315,1.0340044969975954,1.0002812926784799,1.0048142813767518,31,49,4.1845703125,2.391740083694458,33,15
1633,128,0.03880883917874946,1.026175506094966,1.0000499396400593,1.0051048090254797,64,111,4.732574462890625,2.391740083694458,64,17
1634,1,7.772273554574015,7.772273554574016,0.9699842286552082,0.9699842286552087,0,0,7.825639247894287,7.825639247894287,1,1
1634,2,7.026992899677011,7.026992899677011,0.981745692242564,0.9817456922425647,0,0,8.123095512390137,7.825639247894287,2,2
1634,3,6.431375882710142,6.431375882710142,0.9915471508047511,0.991547150804751,0,0,8.299394607543945,7.825639247894287,3,3
1634,4,5.634486502941742,5.634486502941744,1.0051838745193897,1.0051838745193884,0,0,8.507698059082031,7.825639247894287,4,4
1634,8,4.996706895802971,5.024969179562838,1.0143181929601344,1.0138049347775027,1,1,8.662656784057617,7.825639247894287,7,7
1634,16,4.289124907074739,4.502095299454176,1.0194025394773374,1.0190733249219104,5,7,9.000746726989746,7.825639247894287,11,9
1634,32,3.6585616968186523,4.29307847617174,1.0217364041193968,1.0225795169455556,14,19,9.26183032989502,7.825639247894287,18,13
1634,64,2.7674617765269,4.226741017068311,1.0150755201834722,1.0244934173446172,30,51,9.863298416137695,7.825639247894287,34,13
1634,128,1.097329935720864,4.206567024489025,1.0030853135039794,1.0265410906993486,65,109,10.387765884399414,7.825639247894287,63,19
1635,1,9.230251862080163,9.230251862080168,0.9533508744595606,0.9533508744595622,0,0,9.337273597717285,9.337273597717285,1,1
1635,2,7.955820011661371,7.955820011661371,0.9818531580121596,0.9818531580121601,0,0,9.797501564025879,9.337273597717285,2,2
1635,3,7.679456826240689,7.679456826240691,0.9875938045572886,0.9875938045572888,0,0,10.125251770019531,9.337273597717285,3,3
1635,4,7.300746943801247,7.300746943801247,0.9942166545551356,0.9942166545551361,0,0,10.22554874420166,9.337273597717285,4,4
1635,8,6.7202242549720985,6.8504445506057206,1.0080246121631347,1.0059750762097979,2,3,10.840209007263184,9.337273597717285,6,5
1635,16,5.941811067267157,6.454476323983915,1.023862154088069,1.0192063613966158,5,7,11.284608840942383,9.337273597717285,11,9
1635,32,5.339272249890321,6.140746899928924,1.0294303677425822,1.0277268987822534,14,17,11.824299812316895,9.337273597717285,18,15
1635,64,4.317800665228272,5.943126257997246,1.018191223508215,1.035641825948389,34,47,12.43606185913086,9.337273597717285,30,17
1635,128,2.223949587257482,5.8990286626136985,1.0078056260922914,1.0378314444054415,63,109,12.919194221496582,9.337273597717285,65,19
1636,1,8.432746999775157,8.432746999775159,0.9652491069009603,0.9652491069009611,0,0,8.496718406677246,8.496718406677246,1,1
1636,2,6.757549582352565,6.757549582352565,0.993350600749206,0.9933506007492061,0,0,8.92870044708252,8.496718406677246,2,2
1636,3,6.392131521976592,6.392131521976592,1.0013493025514004,1.0013493025514004,0,0,9.41522216796875,8.496718406677246,3,3
1636,4,6.391920189046554,6.392131521976592,1.0012337954832653,1.0013493025514004,1,1,9.871541976928711,8.496718406677246,3,3
1636,8,5.952254896022455,5.978966739249942,1.0132056930280222,1.0132473320939914,1,1,10.762443542480469,8.496718406677246,7,7
1636,16,5.582162616121704,5.849953233133298,1.0175776287475795,1.0154579188994144,3,6,10.91872787475586,8.496718406677246,13,10
1636,32,4.560537146606938,5.465439558735733,1.026441929236866,1.0299125900691295,14,19,11.479938507080078,8.496718406677246,18,13
1636,64,3.6070208116800857,5.324640104787667,1.0178372002078828,1.034138088573529,30,49,12.10519790649414,8.496718406677246,34,15
1636,128,2.3407391533348867,5.219486783963104,1.0080917990903175,1.038699753621288,59,114,12.90644359588623,8.496718406677246,69,14
1637,1,8.658097819149342,8.658097819149345,0.9608540925330749,0.9608540925330757,0,0,8.738173484802246,8.738173484802246,1,1
1637,2,7.1853059231219945,7.185305923121995,0.9893161139243865,0.9893161139243866,0,0,9.872581481933594,8.738173484802246,2,2
1637,3,6.419397630382221,6.419397630382222,1.0052783117053259,1.0052783117053252,0,0,9.930839538574219,8.738173484802246,3,3
1637,4,6.135117233862544,6.135117233862544,1.010309487687418,1.0103094876874166,0,0,10.132596015930176,8.738173484802246,4,4
1637,8,5.0781983744096655,5.129634683560551,1.0262126833650602,1.0269955001048867,2,2,10.444835662841797,8.738173484802246,6,6
1637,16,4.733580953167876,4.885946826700396,1.0311745411108513,1.0331295197822066,4,7,10.765134811401367,8.738173484802246,12,9
1637,32,4.320692211517455,4.767086522571826,1.0324444471269023,1.0358832220449756,13,19,11.46432113647461,8.738173484802246,19,13
1637,64,3.2691282083264883,4.720372110155192,1.0208284196807038,1.0372766554950061,30,48,11.977113723754883,8.738173484802246,34,16
1637,128,1.797782128808389,4.584542360689429,1.0032621039190863,1.0424983639864862,68,109,12.502697944641113,8.738173484802246,60,19
1638,1,7.002571066090564,7.002571066090569,0.9707611950349662,0.9707611950349692,0,0,7.057390213012695,7.057390213012695,1,1
1638,2,6.231323574680086,6.231323574680076,0.9849067018726856,0.9849067018726875,0,0,7.9186787605285645,7.057390213012695,2,2
1638,3,5.730508914625285,5.730508914625286,0.993583156676068,0.9935831566760702,0,0,8.18331241607666,7.057390213012695,3,3
1638,4,5.73043399142644,5.73043399142644,0.9935606975818728,0.9935606975818738,0,0,8.205204010009766,7.057390213012695,4,4
1638,8,4.17388730523295,4.419310211083166,1.0164069639709605,1.0135307475416482,3,3,8.43958854675293,7.057390213012695,5,5
1638,16,3.547725363601841,3.921695071361558,1.0236991939497262,1.0220840935507005,6,7,8.914908409118652,7.057390213012695,10,9
1638,32,3.001877119834025,3.708746180552567,1.0170177552023314,1.0267304032936293,13,21,9.697627067565918,7.057390213012695,19,11
1638,64,2.4005148973355026,3.572118827200921,1.007858804556192,1.0289069936467925,28,53,10.565601348876953,7.057390213012695,36,11
1638,128,1.4526908410236388,3.5611183772378117,1.001916427396248,1.030118592787125,68,113,11.561738014221191,7.057390213012695,60,15
1639,1,8.129096985134735,8.129096985134737,0.9509474318361288,0.9509474318361293,0,0,8.26289176940918,8.26289176940918,1,1
1639,2,7.3155081611329305,7.315508161132931,0.9671647963949079,0.9671647963949082,0,0,8.577484130859375,8.26289176940918,2,2
1639,3,6.444965848510443,6.444965848510442,0.9872353568877695,0.987235356887769,0,0,9.37390422821045,8.26289176940918,3,3
1639,4,6.140107591680098,6.140107591680097,0.9928648407657211,0.9928648407657201,0,0,9.551567077636719,8.26289176940918,4,4
1639,8,5.539785734961759,5.540244065337627,1.0091457054232866,1.0091309675016926,1,1,9.873567581176758,8.26289176940918,7,7
1639,16,5.094800511554898,5.155604521396633,1.020246410139119,1.0202902520599073,5,5,10.295015335083008,8.26289176940918,11,11
1639,32,4.530804997816646,4.991938006802127,1.0236590053914236,1.024934266277451,12,16,10.78775691986084,8.26289176940918,20,16
1639,64,3.4426493872944914,4.897887660298297,1.0145604008676363,1.029396293279642,29,45,11.376510620117188,8.26289176940918,35,19
1639,128,1.909733907176006,4.893135235061846,1.0028926540217862,1.0301027382832555,57,107,12.114422798156738,8.26289176940918,71,21
1640,1,11.040209949828228,11.040209949828235,0.9286924303795775,0.9286924303795804,0,0,11.241512298583984,11.241512298583984,1,1
1640,2,9.81317397330657,9.813173973306572,0.9604806743278633,0.9604806743278643,0,0,11.476503372192383,11.241512298583984,2,2
1640,3,8.831040382667188,8.83104038266719,0.9863213844586067,0.9863213844586076,0,0,11.53210735321045,11.241512298583984,3,3
1640,4,8.597035251741355,8.5973065947834,0.9914644041811818,0.9914383530697994,1,1,11.772435188293457,11.241512298583984,3,3
1640,8,8.06783333089164,8.121401804222259,1.0017461900621139,1.000503423300736,2,2,12.162236213684082,11.241512298583984,6,6
1640,16,6.980439747799309,7.449367612217542,1.0214998816766445,1.01875575058192,5,8,12.767190933227539,11.241512298583984,11,8
1640,32,6.028078954311737,6.989520566177569,1.0330312428349562,1.0296522878312722,13,19,13.344476699829102,11.241512298583984,19,13
1640,64,4.622981982519196,6.735513953749169,1.0319001701007975,1.0383728678911357,29,47,13.848756790161133,11.241512298583984,35,17
1640,128,2.9219037018874023,6.547205578332396,1.0143251365683728,1.0454732303688372,60,109,14.355552673339844,11.241512298583984,68,19
1641,1,14.699233232812876,14.699233232812878,0.8676406165760262,0.8676406165760279,0,0,15.210808753967285,15.210808753967285,1,1
1641,2,12.930450393402875,12.930450393402877,0.9399028744715885,0.9399028744715898,0,0,15.756807327270508,15.210808753967285,2,2
1641,3,12.759916021110866,12.759916021110861,0.9468238915740075,0.9468238915740089,0,0,15.967596054077148,15.210808753967285,3,3
1641,4,11.137064303803216,11.137064303803214,0.9976728148624103,0.9976728148624112,0,0,15.986907958984375,15.210808753967285,4,4
1641,8,10.81846594242985,10.81846594242985,1.008761851553885,1.0087618515538863,0,0,16.132314682006836,15.210808753967285,8,8
1641,16,10.496593666939482,10.77319127844894,1.0198006484305804,1.0109137185232457,6,8,16.541383743286133,15.210808753967285,10,8
1641,32,9.621809547524068,10.448586285190183,1.037318500156791,1.0241166479925512,11,20,16.893796920776367,15.210808753967285,21,12
1641,64,7.9523979065893355,9.984635078325338,1.0574091963711603,1.0512775031839254,31,48,17.174686431884766,15.210808753967285,33,16
1641,128,4.913692916671067,9.845998594509764,1.0295766939268858,1.0584420191008947,60,108,17.586162567138672,15.210808753967285,68,20
1642,1,9.925148047222743,9.92514804722274,0.9365718171840237,0.9365718171840257,0,0,10.10206413269043,10.10206413269043,1,1
1642,2,8.26081999392977,8.260819993929776,0.9731957269917262,0.9731957269917259,0,0,10.343738555908203,10.10206413269043,2,2
1642,3,7.6957355994245376,7.6957355994245376,0.9873382991444777,0.9873382991444775,0,0,10.494414329528809,10.10206413269043,3,3
1642,4,7.471166215673969,7.471166215673968,0.9923816692770573,0.9923816692770562,0,0,11.213301658630371,10.10206413269043,4,4
1642,8,7.172647986544366,7.172647986544366,0.9997389867839936,0.9997389867839922,0,0,11.479331016540527,10.10206413269043,8,8
1642,16,6.755296186096294,7.058836323409665,1.0080619627541938,1.005961821354363,5,6,12.27783489227295,10.10206413269043,11,10
1642,32,5.617728009436748,6.608230002118924,1.0265749770773547,1.019757348039244,13,19,12.825543403625488,10.10206413269043,19,13
1642,64,4.326120423146964,6.367185029018082,1.0187522021971525,1.0269117958710057,31,53,13.59272289276123,10.10206413269043,33,11
1642,128,2.4283792230888754,6.020899202326688,1.0075257033584248,1.0386454966273548,60,112,14.215599060058594,10.10206413269043,68,16
1643,1,2.523472504637778,2.523472504637778,0.9969215707202437,0.996921570720244,0,0,2.52523136138916,2.52523136138916,1,1
1643,2,2.343425323649705,2.343425323649705,0.9979604927518242,0.9979604927518244,0,0,3.030992031097412,2.52523136138916,2,2
1643,3,2.163861746200753,2.1638617462007526,0.9995493580668425,0.9995493580668422,0,0,3.104362964630127,2.52523136138916,3,3
1643,4,1.8977938423269158,1.8979507332971635,0.999830769630877,0.9998238661334949,1,1,3.2095043659210205,2.52523136138916,3,3
1643,8,1.7781595720420618,1.798140747494057,1.000968685573584,1.000729615451573,1,2,3.3465120792388916,2.52523136138916,7,6
1643,16,1.4115094827351076,1.6116844309210905,1.0028042065199285,1.0024265435496396,4,8,3.6243233680725098,2.52523136138916,12,8
1643,32,0.979552011679813,1.574962560508216,1.0032750736149318,1.0032343564458446,14,23,4.066365718841553,2.52523136138916,18,9
1643,64,0.42155593935898683,1.4465157417664158,1.0007656587636373,1.0049252852626909,34,52,4.5662126541137695,2.52523136138916,30,12
1643,128,0.06586843260084724,1.4289063513689158,1.0000259496676667,1.0053991742102788,62,115,5.253518581390381,2.52523136138916,66,13
1644,1,7.236895087551317,7.236895087551317,0.9727850298381991,0.9727850298381993,0,0,7.282790184020996,7.282790184020996,1,1
1644,2,5.063614203676524,5.063614203676524,1.0013744133587912,1.0013744133587918,0,0,7.449453353881836,7.282790184020996,2,2
1644,3,4.98580525235125,4.98580525235125,1.0015721285603867,1.001572128560386,0,0,7.4575910568237305,7.282790184020996,3,3
1644,4,4.979181787805565,4.979181787805564,1.001968597354971,1.001968597354971,0,0,7.690183162689209,7.282790184020996,4,4
1644,8,4.640024419275844,4.677189932682516,1.0080858805047912,1.008404147780141,2,2,8.469353675842285,7.282790184020996,6,6
1644,16,4.248531903158754,4.500999018751846,1.0114817164964316,1.0137564090328055,6,7,9.800436973571777,7.282790184020996,10,9
1644,32,3.1707976128314592,4.255467285597791,1.0091356260058608,1.0220916507981983,16,21,10.723236083984375,7.282790184020996,16,11
1644,64,2.3531171192215115,4.065937752789671,1.0026998845579986,1.0274288625954697,35,49,11.180427551269531,7.282790184020996,29,15
1644,128,1.605703382563117,4.038235535573058,1.0015490797766635,1.0296324674862465,64,109,11.632678985595703,7.282790184020996,64,19
1645,1,8.07390090684637,8.073900906846376,0.9626036461772592,0.9626036461772617,0,0,8.15110969543457,8.15110969543457,1,1
1645,2,6.533607601484791,6.533607601484789,0.987877032358361,0.9878770323583617,0,0,8.423752784729004,8.15110969543457,2,2
1645,3,5.820669702386012,5.820669702386012,0.9997228925626968,0.9997228925626983,0,0,8.741045951843262,8.15110969543457,3,3
1645,4,5.532181656723652,5.532181656723652,1.004068993285254,1.0040689932852547,0,0,8.77743148803711,8.15110969543457,4,4
1645,8,5.223859469643017,5.302703844651954,1.0092132376200802,1.0086323627004539,2,2,9.119999885559082,8.15110969543457,6,6
1645,16,4.860797770257847,5.11774411341719,1.0102851119819398,1.0126227241235455,6,8,10.025003433227539,8.15110969543457,10,8
1645,32,4.118286684304901,4.822565031113785,1.0117743060962785,1.0224944949863481,14,21,10.913365364074707,8.15110969543457,18,11
1645,64,3.031586009372905,4.822565031113784,1.000720281317657,1.0224944949863481,37,53,11.599029541015625,8.15110969543457,27,11
1645,128,1.8472578192651752,4.82164486878966,1.0001674740302866,1.0229016308932612,65,116,12.419035911560059,8.15110969543457,63,12
1646,1,3.5122573135134156,3.512257313513416,0.9942110717722548,0.9942110717722553,0,0,3.5167675018310547,3.5167675018310547,1,1
1646,2,3.1077583608863617,3.1077583608863604,0.995609378493147,0.9956093784931459,0,0,3.5877773761749268,3.5167675018310547,2,2
1646,3,2.6640430424426182,2.6640430424426182,0.997815618188087,0.9978156181880862,0,0,3.595172166824341,3.5167675018310547,3,3
1646,4,2.5268639308327256,2.5268639308327256,0.9988333637107824,0.9988333637107825,0,0,3.852478504180908,3.5167675018310547,4,4
1646,8,2.1601841805408357,2.193863821537155,0.9999316439351565,1.0001323131135644,2,3,3.9046921730041504,3.5167675018310547,6,5
1646,16,1.808218714000077,2.147197960863816,1.0009598833555817,1.0009759748361342,7,10,4.184215545654297,3.5167675018310547,9,6
1646,32,1.2838489312839712,1.9185912614403753,1.0033421215379517,1.003826264953668,13,24,4.498488903045654,3.5167675018310547,19,8
1646,64,0.7990525159856546,1.883432751019595,1.0019453582742397,1.0044380051716697,33,54,4.866522789001465,3.5167675018310547,31,10
1646,128,0.1711066358386999,1.8627308145897339,1.000165316744782,1.0050134453344794,57,116,5.30403470993042,3.5167675018310547,71,12
1647,1,5.282177805283914,5.282177805283914,0.9841869676093697,0.9841869676093699,0,0,5.303677558898926,5.303677558898926,1,1
1647,2,4.677845078443172,4.6778450784431715,0.991008510199957,0.9910085101999564,0,0,5.604984283447266,5.303677558898926,2,2
1647,3,4.61795521544791,4.61795521544791,0.992120001059023,0.9921200010590231,0,0,6.354267597198486,5.303677558898926,3,3
1647,4,4.157198806094034,4.157198806094035,0.9994355954896154,0.999435595489615,0,0,6.410439491271973,5.303677558898926,4,4
1647,8,3.420259598282569,3.4652845075417384,1.0085399781097621,1.0080020202374214,1,1,6.688263893127441,5.303677558898926,7,7
1647,16,3.122827393847608,3.2980500312614223,1.0090452911602943,1.0100868219104666,6,6,7.218573093414307,5.303677558898926,10,10
1647,32,2.6811945246753397,3.212913700476508,1.0096460952165958,1.013464098502653,13,22,7.916777610778809,5.303677558898926,19,10
1647,64,1.8575199072501298,3.2082467479233587,1.002828097488956,1.0136185809637996,33,50,8.611486434936523,5.303677558898926,31,14
1647,128,0.8546383330215852,3.203990929718222,1.000694699741353,1.013889626389407,66,110,9.231451034545898,5.303677558898926,62,18
1648,1,5.815906963630426,5.8159069636304,0.9804351665814964,0.9804351665814988,0,0,5.846296787261963,5.846296787261963,1,1
1648,2,4.4556112297908355,4.455611229790835,0.9980482160922006,0.998048216092202,0,0,6.415213584899902,5.846296787261963,2,2
1648,3,4.439244229068854,4.439244229068854,0.9987003415520692,0.9987003415520708,0,0,7.180833339691162,5.846296787261963,3,3
1648,4,4.366184181835637,4.366184181835637,1.0001845064749717,1.0001845064749728,0,0,7.32133150100708,5.846296787261963,4,4
1648,8,4.033731595804262,4.033826346588639,1.0078452763816266,1.0078119082686106,1,1,7.87177038192749,5.846296787261963,7,7
1648,16,3.2727617398064432,3.7120293426691693,1.0114745530938756,1.013523622007324,6,8,8.139226913452148,5.846296787261963,10,8
1648,32,2.7386235213481624,3.700607393358434,1.0071538512847218,1.0137378444786584,13,23,8.69296932220459,5.846296787261963,19,9
1648,64,1.8726099091557566,3.6120034581304026,1.0050952429239746,1.0164604888904514,31,51,9.281328201293945,5.846296787261963,33,13
1648,128,0.8695736321690376,3.5400137236984563,1.0011656240298554,1.0182024844258484,66,116,9.762255668640137,5.846296787261963,62,12
1649,1,7.362309086283705,7.362309086283709,0.9685622305615125,0.9685622305615144,0,0,7.423349380493164,7.423349380493164,1,1
1649,2,6.17632791489091,6.176327914890909,0.9905517898874621,0.9905517898874626,0,0,8.860018730163574,7.423349380493164,2,2
1649,3,5.801688745044475,5.801688745044475,0.9987938387648774,0.9987938387648769,0,0,9.197504997253418,7.423349380493164,3,3
1649,4,5.630918806172942,5.630918806172943,1.0034069479116168,1.0034069479116166,0,0,9.58686351776123,7.423349380493164,4,4
1649,8,5.3749137271153336,5.401633840594074,1.0093839754988942,1.00979657114941,1,2,10.136270523071289,7.423349380493164,7,6
1649,16,4.671364254238297,5.276210076183803,1.0159936681131894,1.0142213727652105,6,8,10.60519790649414,7.423349380493164,10,8
1649,32,4.185933508023532,5.211736376969813,1.0145250036362383,1.0173618876466466,16,23,11.18877124786377,7.423349380493164,16,9
1649,64,3.1818185631574107,5.166271611158191,1.0107534882802982,1.0205859542247677,32,54,11.844391822814941,7.423349380493164,32,10
1649,128,1.9100004792249614,4.987999421405402,1.00421370773687,1.0281431326803259,62,113,12.593681335449219,7.423349380493164,66,15
1650,1,8.317200803322205,8.317200803322207,0.9550915612026576,0.9550915612026589,0,0,8.421978950500488,8.421978950500488,1,1
1650,2,7.322817903826576,7.322817903826579,0.9735643624291941,0.9735643624291956,0,0,8.776365280151367,8.421978950500488,2,2
1650,3,7.224247663176376,7.224247663176378,0.9753573775676521,0.9753573775676536,0,0,8.815868377685547,8.421978950500488,3,3
1650,4,6.941151886913714,6.941151886913715,0.9782059750135916,0.9782059750135929,0,0,8.832975387573242,8.421978950500488,4,4
1650,8,6.193447790857761,6.193793887704027,0.9953630210292832,0.9954969315254707,2,1,9.566873550415039,8.421978950500488,6,7
1650,16,5.801234660813941,5.991277504129557,1.0041066285439357,1.003065152541042,4,8,10.550978660583496,8.421978950500488,12,8
1650,32,4.638960116159923,5.683250627601233,1.0129142249439367,1.0116653349643372,11,21,11.122236251831055,8.421978950500488,21,11
1650,64,3.723933630313452,5.532765725595242,1.0132085552685148,1.0199239343367228,29,52,11.905524253845215,8.421978950500488,35,12
1650,128,2.21142007397351,5.417434255036766,1.0030679857679745,1.0256746133481136,62,114,12.712149620056152,8.421978950500488,66,14
1651,1,7.699391628137444,7.699391628137449,0.9672128780587994,0.967212878058802,0,0,7.7610626220703125,7.7610626220703125,1,1
1651,2,5.810216271541176,5.810216271541179,0.9937158124505634,0.9937158124505657,0,0,8.031489372253418,7.7610626220703125,2,2
1651,3,5.515279547542432,5.515279547542432,0.9976893896783328,0.9976893896783346,0,0,8.035300254821777,7.7610626220703125,3,3
1651,4,5.279047028871673,5.279047028871672,1.0028664023081455,1.0028664023081486,0,0,8.209043502807617,7.7610626220703125,4,4
1651,8,4.566581856641838,4.566581856641834,1.014528018003109,1.0145280180031118,0,0,8.448031425476074,7.7610626220703125,8,8
1651,16,4.230181516839803,4.325696803014776,1.0202639575507284,1.0211393283393118,2,5,9.324462890625,7.7610626220703125,14,11
1651,32,3.8591966291875184,4.292369363130333,1.0158509116383208,1.0226740144747613,13,18,9.761926651000977,7.7610626220703125,19,14
1651,64,2.7878604566683483,4.217798506840814,1.0072832575817487,1.0248836617156085,31,46,10.327839851379395,7.7610626220703125,33,18
1651,128,1.3966317295681718,4.216266844696165,0.9996700848810347,1.0249941408162506,67,111,11.081440925598145,7.7610626220703125,61,17
1652,1,7.751823371122887,7.751823371122886,0.9667976235388468,0.9667976235388466,0,0,7.816411018371582,7.816411018371582,1,1
1652,2,4.996444418727313,4.996444418727314,1.0086083038921165,1.0086083038921148,0,0,7.882061004638672,7.816411018371582,2,2
1652,3,4.719704122596861,4.719704122596863,1.0140594920239707,1.0140594920239692,0,0,8.477002143859863,7.816411018371582,3,3
1652,4,4.682157016831688,4.68215701683169,1.0150343905004668,1.0150343905004646,0,0,8.63093376159668,7.816411018371582,4,4
1652,8,4.490150678538756,4.511866018641066,1.0178294622344783,1.0181518339136075,1,1,8.966924667358398,7.816411018371582,7,7
1652,16,4.118319288126279,4.3928685054761845,1.0191996433657213,1.021023272284568,5,6,9.569535255432129,7.816411018371582,11,10
1652,32,3.745582663176145,4.371315102495569,1.018484019614518,1.0222541281093482,16,17,10.151518821716309,7.816411018371582,16,15
1652,64,2.708616269735664,4.301276440563842,1.009115381102116,1.0260152617779856,32,50,10.949402809143066,7.816411018371582,32,14
1652,128,1.7070156263099132,4.293928956880353,1.006043623785573,1.02707372336797,65,111,11.615440368652344,7.816411018371582,63,17
1653,1,9.168729851894804,9.168729851894787,0.953591381891756,0.9535913818917571,0,0,9.27214527130127,9.27214527130127,1,1
1653,2,7.252416837479741,7.252416837479741,0.9888490470460982,0.9888490470460969,0,0,9.562101364135742,9.27214527130127,2,2
1653,3,6.621110795309188,6.621110795309189,1.0023611409131319,1.0023611409131308,0,0,10.266655921936035,9.27214527130127,3,3
1653,4,6.29512256937407,6.295122569374071,1.0090987142344352,1.0090987142344343,0,0,10.376110076904297,9.27214527130127,4,4
1653,8,6.100310961255656,6.159991340079813,1.014592835964172,1.013463132288805,1,1,10.904129028320312,9.27214527130127,7,7
1653,16,5.649875374738191,5.822119850125155,1.0253266014093707,1.0206718364912213,4,3,11.36641788482666,9.27214527130127,12,13
1653,32,4.817559158898743,5.561895910033925,1.0276684521883492,1.0313054980164833,12,18,11.73746109008789,9.27214527130127,20,14
1653,64,3.8233261573278283,5.5032106504834575,1.0218044208760735,1.0340822357170147,28,49,12.605671882629395,9.27214527130127,36,15
1653,128,2.095635530935082,5.415095069310888,1.0038069161712049,1.03692234618163,63,115,13.225138664245605,9.27214527130127,65,13
1654,1,11.382929625016311,11.382929625016317,0.9336088176698685,0.93360881766987,0,0,11.556177139282227,11.556177139282227,1,1
1654,2,9.692184188704323,9.692184188704324,0.9796249611393637,0.9796249611393644,0,0,12.525994300842285,11.556177139282227,2,2
1654,3,8.722621726701028,8.722621726701028,1.0025712264239182,1.002571226423918,0,0,12.601410865783691,11.556177139282227,3,3
1654,4,8.318394135831157,8.318394135831157,1.0125780673440579,1.0125780673440574,0,0,12.674407005310059,11.556177139282227,4,4
1654,8,8.026306118671771,8.093148457123787,1.0204222048810625,1.02167228099653,2,1,13.909518241882324,11.556177139282227,6,7
1654,16,7.519081840838318,7.959278924261217,1.0252627029661499,1.027310071766626,4,7,14.260430335998535,11.556177139282227,12,9
1654,32,6.57534208527151,7.7532441930528275,1.028436089397169,1.0340848511107759,16,23,14.895232200622559,11.556177139282227,16,9
1654,64,5.288985622538886,7.702929050188698,1.021722484943972,1.0392896787987354,33,51,15.666350364685059,11.556177139282227,31,13
1654,128,3.195101727277012,7.350847768249671,1.0021292856356157,1.0511428285075066,64,116,16.403657913208008,11.556177139282227,64,12
1655,1,8.921353034911018,8.921353034911018,0.9592954043980083,0.9592954043980082,0,0,9.002333641052246,9.002333641052246,1,1
1655,2,7.050719698593971,7.050719698593971,0.9926199805639746,0.9926199805639727,0,0,10.123981475830078,9.002333641052246,2,2
1655,3,6.7689228216766315,6.7689228216766315,0.9994450017659121,0.9994450017659091,0,0,10.456448554992676,9.002333641052246,3,3
1655,4,6.647183039510455,6.647183039510455,1.0018853339543305,1.001885333954328,0,0,10.568460464477539,9.002333641052246,4,4
1655,8,6.032949653152476,6.186980747933362,1.0147954451195147,1.0133079108621026,2,2,11.044833183288574,9.002333641052246,6,6
1655,16,5.790715673232813,6.047596678329786,1.0198163947303427,1.0173269974164194,4,5,11.552865028381348,9.002333641052246,12,11
1655,32,5.334199326758686,5.811731087815473,1.0229360440749362,1.0227605236362747,15,17,11.786849021911621,9.002333641052246,17,15
1655,64,3.5600660388688055,5.589795699308095,1.0185575063527321,1.029236682816244,29,50,12.325876235961914,9.002333641052246,35,14
1655,128,2.2355274799742455,5.468244793854164,1.0093069657836256,1.0328688894922795,62,111,12.944087028503418,9.002333641052246,66,17
1656,1,9.760993184338393,9.760993184338396,0.9460106643926192,0.9460106643926207,0,0,9.894207000732422,9.894207000732422,1,1
1656,2,7.733834704065162,7.733834704065163,0.9913094410772103,0.9913094410772101,0,0,10.860673904418945,9.894207000732422,2,2
1656,3,7.208731897770312,7.208731897770312,1.003253634607724,1.003253634607724,0,0,11.001191139221191,9.894207000732422,3,3
1656,4,7.152758370068656,7.152758370068656,1.0050567661027867,1.0050567661027865,0,0,11.590412139892578,9.894207000732422,4,4
1656,8,6.964716079388493,6.9927966192210596,1.0128565278922146,1.0127213725266941,2,2,11.889385223388672,9.894207000732422,6,6
1656,16,6.352358078087766,6.8679207724283,1.0193734820343057,1.0160446483178345,6,8,12.438064575195312,9.894207000732422,10,8
1656,32,5.79942255838093,6.809819680728267,1.0234337264424724,1.0227993596294196,15,19,13.195107460021973,9.894207000732422,17,13
1656,64,4.179199128010081,6.438679119300984,1.022742445167832,1.034338541163712,29,51,13.902826309204102,9.894207000732422,35,13
1656,128,2.374330016258988,6.398562091130699,1.0044274270012306,1.0342672829426636,57,112,14.524964332580566,9.894207000732422,71,16
1657,1,2.6660010895656945,2.666001089565695,1.0028076156934265,1.002807615693426,0,0,2.667445421218872,2.667445421218872,1,1
1657,2,2.308740328803394,2.3087403288033923,1.0056207302284754,1.0056207302284748,0,0,3.201120138168335,2.667445421218872,2,2
1657,3,2.2220433664239994,2.2220433664239967,1.0057530476866199,1.0057530476866192,0,0,3.708660840988159,2.667445421218872,3,3
1657,4,2.193287155229221,2.193287155229221,1.0062870787112634,1.0062870787112634,0,0,3.8291561603546143,2.667445421218872,4,4
1657,8,2.174045488553014,2.1791644769985727,1.006477817060351,1.0066932740445353,2,2,3.932199001312256,2.667445421218872,6,6
1657,16,1.9235928103152786,2.1785526940424966,1.0059051701541923,1.0068002876849689,5,8,4.3943915367126465,2.667445421218872,11,8
1657,32,1.3550912976175626,2.124459303208759,1.0030798751450365,1.0079691016288281,14,23,4.845290184020996,2.667445421218872,18,9
1657,64,0.6822589919112089,2.122325133310307,1.000220789739012,1.0080796030930477,30,53,5.318360328674316,2.667445421218872,34,11
1657,128,0.027693374565702023,2.1067897772289075,1.000037388813284,1.0089597313518146,58,116,5.822714805603027,2.667445421218872,70,12
1658,1,8.551169633743203,8.551169633743209,0.9544123086463485,0.9544123086463507,0,0,8.661208152770996,8.661208152770996,1,1
1658,2,7.336257086266606,7.33625708626661,0.9758089778098882,0.9758089778098895,0,0,8.819823265075684,8.661208152770996,2,2
1658,3,7.010088490487207,7.010088490487209,0.9823026434868567,0.9823026434868576,0,0,8.958073616027832,8.661208152770996,3,3
1658,4,6.43166523417613,6.43166523417613,0.9945641705125156,0.9945641705125163,0,0,9.376065254211426,8.661208152770996,4,4
1658,8,5.9968877715846745,6.003185073118581,1.0047082043585762,1.0042964211682013,1,1,10.06467056274414,8.661208152770996,7,7
1658,16,5.543811936779729,5.913441765200978,1.0086076899454248,1.0085889826819174,4,7,11.334113121032715,8.661208152770996,12,9
1658,32,4.567980016911128,5.6163996881156075,1.0112212721930658,1.0147805962103955,14,21,11.900535583496094,8.661208152770996,18,11
1658,64,3.383622197929131,5.435699615430935,1.0075847147642087,1.0213172571807907,30,50,12.344595909118652,8.661208152770996,34,14
1658,128,1.9781990660966362,5.411304081583467,1.0035701248680284,1.022648635440732,64,112,12.732786178588867,8.661208152770996,64,16
1659,1,2.5109771266597978,2.5109771266597987,0.9964893569392261,0.9964893569392269,0,0,2.513347864151001,2.513347864151001,1,1
1659,2,2.2613435403103144,2.261343540310315,0.9984622321554499,0.9984622321554508,0,0,2.525027275085449,2.513347864151001,2,2
1659,3,2.2191037151855406,2.2191037151855406,0.999314614983259,0.9993146149832592,0,0,2.9381518363952637,2.513347864151001,3,3
1659,4,2.0778172914427686,2.077979007674822,0.9999591209722855,0.9999917393453486,1,1,2.9497580528259277,2.513347864151001,3,3
1659,8,1.892965931233956,1.915234588743522,1.0018369831050276,1.0018926675540074,1,1,3.277618408203125,2.513347864151001,7,7
1659,16,1.4428026809792167,1.6894813372905109,1.0037267777886776,1.0031707249077342,7,8,3.5038070678710938,2.513347864151001,9,8
1659,32,1.1251781480516787,1.5562611716426122,1.0028536732436235,1.0042756395722532,11,25,3.7035534381866455,2.513347864151001,21,7
1659,64,0.6343210893290272,1.5345447727998534,1.0006691456205357,1.0045033754498598,30,54,4.122628211975098,2.513347864151001,34,10
1659,128,0.02544214159516711,1.5062357403321194,0.9999896321576456,1.005435757455917,61,114,4.769830226898193,2.513347864151001,67,14
1660,1,5.370625131339888,5.370625131339889,0.9825427157645857,0.9825427157645875,0,0,5.397284030914307,5.397284030914307,1,1
1660,2,5.168759326611285,5.168759326611288,0.9846727052210169,0.9846727052210187,0,0,5.7591705322265625,5.397284030914307,2,2
1660,3,4.534677366143225,4.534677366143226,0.9938410593536873,0.9938410593536888,0,0,5.8467793464660645,5.397284030914307,3,3
1660,4,4.5053517176739994,4.5053517176739994,0.9944618678088457,0.994461867808846,0,0,5.983504772186279,5.397284030914307,4,4
1660,8,3.756790898652142,3.7983458999061632,1.0051696892551711,1.0043813106648531,1,2,6.679010391235352,5.397284030914307,7,6
1660,16,3.328338792149802,3.589470579916646,1.0048363455879206,1.005837430640672,3,7,7.666849136352539,5.397284030914307,13,9
1660,32,2.848140414644306,3.371171579809799,1.0038020049019194,1.0107315820454028,14,20,8.30562686920166,5.397284030914307,18,12
1660,64,1.4728712054646877,3.222632597555751,1.0022151629046154,1.0128609683939223,28,54,8.99853801727295,5.397284030914307,36,10
1660,128,0.8047544821984497,3.1005450515974293,1.0009597538389867,1.0194618630183758,67,114,9.63979721069336,5.397284030914307,61,14
1661,1,9.513487088878302,9.5134870888783,0.939586697386592,0.9395866973865912,0,0,9.68893051147461,9.68893051147461,1,1
1661,2,7.034894678810606,7.034894678810606,0.9933982235857852,0.9933982235857851,0,0,9.734234809875488,9.68893051147461,2,2
1661,3,6.560922450503435,6.560922450503434,1.0019370298862256,1.001937029886225,0,0,9.773003578186035,9.68893051147461,3,3
1661,4,6.55810525596248,6.55810525596248,1.002039096924912,1.002039096924912,0,0,9.92463493347168,9.68893051147461,4,4
1661,8,6.191161508672379,6.2127676053004555,1.0066726833306285,1.0072205577241469,2,2,10.462045669555664,9.68893051147461,6,6
1661,16,5.373513864475959,5.7699011185716875,1.0160656475008734,1.0159130537660934,6,8,10.6397066116333,9.68893051147461,10,8
1661,32,4.922132638422367,5.686403967933445,1.0194406495894992,1.0197683436900011,12,19,11.259363174438477,9.68893051147461,20,13
1661,64,3.7180937004697086,5.51324111755691,1.009070020510381,1.0271922816208312,33,51,11.819489479064941,9.68893051147461,31,13
1661,128,2.2620321904627114,5.361246333036883,1.0046920331487916,1.030222351254347,67,112,12.41925048828125,9.68893051147461,61,16
1662,1,8.088404256292465,8.088404256292462,0.9583225610740154,0.9583225610740164,0,0,8.185577392578125,8.185577392578125,1,1
1662,2,6.883919596680148,6.883919596680148,0.9808596863309562,0.9808596863309564,0,0,8.297112464904785,8.185577392578125,2,2
1662,3,5.595870312346852,5.595870312346852,1.0015368755519023,1.0015368755519016,0,0,8.323283195495605,8.185577392578125,3,3
1662,4,5.103828230336486,5.103828230336486,1.0097758200559297,1.0097758200559293,0,0,8.6786527633667,8.185577392578125,4,4
1662,8,4.439206075300955,4.475305592865033,1.0204617074347095,1.0195626773225317,2,2,9.019840240478516,8.185577392578125,6,6
1662,16,4.109005087834834,4.380315655490913,1.01895864619479,1.0222152536672695,7,9,9.702437400817871,8.185577392578125,9,7
1662,32,3.598670104268664,4.2257223442245095,1.0167429393662575,1.0237916083406515,13,23,10.18455696105957,8.185577392578125,19,9
1662,64,2.891057125923864,4.182013499118875,1.011336432359301,1.025997104791598,28,53,10.717413902282715,8.185577392578125,36,11
1662,128,1.5672891749323916,4.180729385886729,0.9980810312710929,1.026275806172336,63,116,11.479660987854004,8.185577392578125,65,12
1663,1,10.89730537000604,10.897305370005986,0.9138277157529521,0.9138277157529536,0,0,11.191263198852539,11.191263198852539,1,1
1663,2,8.265633109903844,8.265633109903844,0.9791525885075837,0.9791525885075838,0,0,11.357976913452148,11.191263198852539,2,2
1663,3,8.258644758652597,8.258644758652597,0.9797341075741627,0.9797341075741619,0,0,11.749995231628418,11.191263198852539,3,3
1663,4,8.078357365533984,8.104149344547915,0.9867644340693514,0.9862565584759633,1,1,11.97758960723877,11.191263198852539,3,3
1663,8,7.566513380692391,7.576555387479163,1.0028979895658656,1.0027165228504051,1,1,12.235406875610352,11.191263198852539,7,7
1663,16,7.181709517069019,7.310729445065482,1.017021389633287,1.015270568972916,5,4,13.045097351074219,11.191263198852539,11,12
1663,32,6.712260876370234,7.298213753400033,1.0190864319024664,1.0160763035598537,11,19,13.595125198364258,11.191263198852539,21,13
1663,64,5.14159364372997,7.08916072029636,1.019356174946769,1.0262896158345844,29,48,14.295268058776855,11.191263198852539,35,16
1663,128,3.5350169546513466,7.066187986395248,0.9997076550250643,1.0277404545461528,61,111,14.841875076293945,11.191263198852539,67,17
1664,1,7.086385317377012,7.086385317377018,0.9643845542809633,0.9643845542809658,0,0,7.166871070861816,7.166871070861816,1,1
1664,2,6.155147981210312,6.155147981210307,0.981999664890213,0.9819996648902142,0,0,7.932164669036865,7.166871070861816,2,2
1664,3,5.517897870666508,5.51789787066651,0.9923291257206264,0.992329125720628,0,0,8.059524536132812,7.166871070861816,3,3
1664,4,5.380612954553153,5.380612954553154,0.9960247530225553,0.9960247530225573,0,0,8.264881134033203,7.166871070861816,4,4
1664,8,4.643300823713531,4.644398372254685,1.0101696005644332,1.0103037820680483,1,1,9.341056823730469,7.166871070861816,7,7
1664,16,4.182933905823386,4.421807568385752,1.015382449253006,1.0175322025976883,7,7,9.847864151000977,7.166871070861816,9,9
1664,32,3.3365263903286073,4.227782591678288,1.0139329744798007,1.0228312850001173,14,19,10.539274215698242,7.166871070861816,18,13
1664,64,2.379191132625959,4.159901179130965,1.0030063780973357,1.0251794369649034,29,49,11.210861206054688,7.166871070861816,35,15
1664,128,1.359444088207277,4.159128357075913,1.002061494171619,1.025622603694217,58,110,11.843064308166504,7.166871070861816,70,18
1665,1,7.190248188116443,7.190248188116445,0.9688624493977427,0.968862449397743,0,0,7.251743793487549,7.251743793487549,1,1
1665,2,6.6662831406667875,6.6662831406667875,0.9781350753475455,0.9781350753475455,0,0,7.626942157745361,7.251743793487549,2,2
1665,3,5.647257652800493,5.647257652800493,0.994432212310498,0.9944322123104976,0,0,7.84521484375,7.251743793487549,3,3
1665,4,5.482262217795433,5.482262217795432,0.9957747077719042,0.9957747077719041,0,0,7.90205717086792,7.251743793487549,4,4
1665,8,4.819810621617646,4.821827432902495,1.0085121971547448,1.0088190362797933,1,1,8.304106712341309,7.251743793487549,7,7
1665,16,4.142280918647268,4.730038306367351,1.011331952309888,1.0110926599857875,4,7,8.632533073425293,7.251743793487549,12,9
1665,32,3.551405190807768,4.370594429550488,1.0138147216983304,1.0172914571796379,10,18,9.09911823272705,7.251743793487549,22,14
1665,64,2.6865280822723254,4.332515644107136,1.0074150864054285,1.0195028507401898,31,45,9.623501777648926,7.251743793487549,33,19
1665,128,1.3286216414242469,4.301031127712976,1.0025920858392905,1.0216360836706482,59,105,10.14887809753418,7.251743793487549,69,23
1666,1,5.961287871697627,5.961287871697629,0.9770958605603872,0.9770958605603883,0,0,6.000819683074951,6.000819683074951,1,1
1666,2,5.302161217018497,5.3021612170184955,0.9854037592362557,0.9854037592362548,0,0,6.172401428222656,6.000819683074951,2,2
1666,3,5.112629115765627,5.112629115765627,0.9891215392175358,0.9891215392175357,0,0,6.928261756896973,6.000819683074951,3,3
1666,4,5.079472024572657,5.079472024572656,0.9903896798048603,0.9903896798048596,0,0,7.060956001281738,6.000819683074951,4,4
1666,8,4.777505532948389,4.782787668996813,0.996839616194768,0.9970639354792619,2,2,7.489611625671387,6.000819683074951,6,6
1666,16,4.0559687352628995,4.42225831146221,1.0038901796262778,1.0062698105032983,7,8,8.284014701843262,6.000819683074951,9,8
1666,32,3.0139833308665507,3.949125669672985,1.0121120616237391,1.0160529301429437,11,21,8.776952743530273,6.000819683074951,21,11
1666,64,2.158528219689395,3.8282926241732596,1.005133452355553,1.018971427719238,31,48,9.562712669372559,6.000819683074951,33,16
1666,128,1.043905225663563,3.666534365541181,0.9997316747369424,1.022186010016075,65,111,10.2648344039917,6.000819683074951,63,17
1667,1,5.1716683000432315,5.171668300043233,0.9847204184603281,0.9847204184603294,0,0,5.193216323852539,5.193216323852539,1,1
1667,2,4.782840280671486,4.782840280671487,0.9893531775382989,0.9893531775382995,0,0,5.399419784545898,5.193216323852539,2,2
1667,3,4.662251841698863,4.662251841698856,0.9900792954623765,0.9900792954623785,0,0,5.720156192779541,5.193216323852539,3,3
1667,4,4.63212409910478,4.6321240991047725,0.9907584255960453,0.9907584255960475,0,0,5.961832523345947,5.193216323852539,4,4
1667,8,4.387899936916137,4.523884098061857,0.9923327268939178,0.9934475204962714,2,2,6.082312107086182,5.193216323852539,6,6
1667,16,3.6714071210291097,4.231435696432708,0.9988893574297981,0.9989730449184981,5,9,6.38175630569458,5.193216323852539,11,7
1667,32,2.807936823646279,3.603848485464703,1.003854811787627,1.0074622506089774,11,27,6.734729766845703,5.193216323852539,21,5
1667,64,1.9265339660891556,3.4590181996231495,1.0038592966384607,1.0099646512171763,25,56,6.925530433654785,5.193216323852539,39,8
1667,128,0.4283631241626225,3.458736439315558,1.0000204583413548,1.0099763030962217,68,118,7.307523250579834,5.193216323852539,60,10
1668,1,4.605457951401569,4.605457951401569,0.9840097696719312,0.9840097696719318,0,0,4.6308722496032715,4.6308722496032715,1,1
1668,2,4.153625596932037,4.153625596932039,0.9918134596230432,0.9918134596230439,0,0,5.97732400894165,4.6308722496032715,2,2
1668,3,3.1758535117823423,3.175853511782342,1.003990083281081,1.0039900832810815,0,0,6.333159446716309,4.6308722496032715,3,3
1668,4,2.998746850831329,2.998746850831329,1.006572341298334,1.0065723412983343,0,0,6.366332530975342,4.6308722496032715,4,4
1668,8,2.8922025765380406,2.8926835652694534,1.007647167702122,1.007670920278163,1,1,6.613017559051514,4.6308722496032715,7,7
1668,16,2.4017733181977152,2.7147623476723712,1.0097649638772999,1.0102290108246272,5,8,7.009761333465576,4.6308722496032715,11,8
1668,32,2.1523998833938625,2.5915527246860623,1.0084329293217686,1.0121874004636944,13,22,7.599062442779541,4.6308722496032715,19,10
1668,64,1.5661116587476926,2.5713802833301727,1.0037806911070564,1.0131419962622328,33,53,8.26014232635498,4.6308722496032715,31,11
1668,128,0.6009012872789703,2.571346534328394,1.0004030996611415,1.0131533778094597,63,116,8.827459335327148,4.6308722496032715,65,12
1669,1,9.178162469312007,9.17816246931199,0.9502276130786453,0.950227613078647,0,0,9.295448303222656,9.295448303222656,1,1
1669,2,7.598071614920708,7.598071614920709,0.9883700682282444,0.9883700682282457,0,0,10.345376968383789,9.295448303222656,2,2
1669,3,7.167540456516396,7.167540456516396,0.9947574929021027,0.9947574929021031,0,0,10.438779830932617,9.295448303222656,3,3
1669,4,6.729487598960193,6.729487598960192,1.0047108788045658,1.0047108788045658,0,0,10.538180351257324,9.295448303222656,4,4
1669,8,6.089745013741349,6.08974501374135,1.0175063850753643,1.017506385075364,0,0,10.655111312866211,9.295448303222656,8,8
1669,16,5.520876539273624,5.691654535592572,1.026423981160164,1.0240672397338901,4,5,11.030476570129395,9.295448303222656,12,11
1669,32,4.599693387667481,5.5336048264249955,1.0264107708860686,1.0269524973017328,14,18,11.48508358001709,9.295448303222656,18,14
1669,64,3.7477266433505343,5.296641949750778,1.022033636312403,1.0306011013450034,31,50,11.968586921691895,9.295448303222656,33,14
1669,128,1.8494813493400926,5.256040258930441,1.005705374003508,1.034197909641737,59,109,12.449056625366211,9.295448303222656,69,19
1670,1,10.729761021185068,10.72976102118507,0.9356709936432923,0.9356709936432933,0,0,10.898762702941895,10.898762702941895,1,1
1670,2,8.947104451976555,8.947104451976555,0.978953712522642,0.9789537125226412,0,0,11.19213581085205,10.898762702941895,2,2
1670,3,8.715462972363461,8.715462972363461,0.9831548642346752,0.9831548642346755,0,0,11.19697380065918,10.898762702941895,3,3
1670,4,8.691472944059035,8.715462972363461,0.9830578184226165,0.9831548642346755,1,1,11.648087501525879,10.898762702941895,3,3
1670,8,8.554426737040636,8.575034702441497,0.9911647761191678,0.9917135253647333,3,3,12.202850341796875,10.898762702941895,5,5
1670,16,7.884612470809366,8.167981176118442,1.006319679100411,1.0082966495894832,5,8,13.395757675170898,10.898762702941895,11,8
1670,32,6.5907722281314545,7.532640245131816,1.0232326628129536,1.026365546879614,15,21,14.083239555358887,10.898762702941895,17,11
1670,64,5.233824708906893,7.4616826909815535,1.0122161511076149,1.032115736468222,30,49,14.573029518127441,10.898762702941895,34,15
1670,128,3.3390421541706243,7.089446519267595,1.0121156386102825,1.048121337721158,65,108,15.033574104309082,10.898762702941895,63,20
1671,1,10.332505860550913,10.332505860550908,0.9412246174161741,0.9412246174161755,0,0,10.48597240447998,10.48597240447998,1,1
1671,2,8.548850245163521,8.548850245163523,0.9840763214169207,0.9840763214169223,0,0,11.432923316955566,10.48597240447998,2,2
1671,3,7.969097901267015,7.969097901267017,0.9982553292976792,0.9982553292976803,0,0,11.891695976257324,10.48597240447998,3,3
1671,4,7.969069457871823,7.969069457871822,0.9982943881668113,0.9982943881668118,0,0,12.354509353637695,10.48597240447998,4,4
1671,8,7.621828337470423,7.800517770579489,1.0042711738543522,1.0089589270468244,2,3,14.07166576385498,10.48597240447998,6,5
1671,16,6.637026538331787,7.77152355903356,1.0014377856211487,1.0127295253467221,6,10,14.57905101776123,10.48597240447998,10,6
1671,32,5.52344739345477,7.623282356095648,1.0054891049988617,1.0179792354504253,14,24,15.223847389221191,10.48597240447998,18,8
1671,64,4.489220179451746,7.430258259275531,1.0044173499623654,1.0281944030242527,32,55,16.447818756103516,10.48597240447998,32,9
1671,128,3.1512230205568903,7.386360762310536,1.003532777455661,1.0339750888032868,57,118,17.317222595214844,10.48597240447998,71,10
1672,1,8.678223054083404,8.678223054083405,0.9665967826800268,0.9665967826800284,0,0,8.736522674560547,8.736522674560547,1,1
1672,2,7.357272886942827,7.357272886942827,0.9974117942039861,0.9974117942039877,0,0,9.884134292602539,8.736522674560547,2,2
1672,3,7.242588976995756,7.242588976995754,0.9991784753204114,0.999178475320412,0,0,10.030699729919434,8.736522674560547,3,3
1672,4,7.125228906199106,7.125228906199107,1.0032895095804295,1.0032895095804308,0,0,10.787945747375488,8.736522674560547,4,4
1672,8,6.6318092029108655,6.631809202910863,1.022612560427527,1.0226125604275293,0,0,11.436549186706543,8.736522674560547,8,8
1672,16,6.403914290108346,6.468687144525404,1.026806445935439,1.0278654458546972,5,5,11.804987907409668,8.736522674560547,11,11
1672,32,5.216000835232037,6.136671826898521,1.0333516456629357,1.0397738162115633,13,19,12.349556922912598,8.736522674560547,19,13
1672,64,4.024219288233349,6.028736803851647,1.0273799975567295,1.044700357672768,31,48,12.965875625610352,8.736522674560547,33,16
1672,128,2.4024117810382863,6.020620753421563,1.0049295637967999,1.0459769448561667,61,110,13.719018936157227,8.736522674560547,67,18
1673,1,2.7794074147484626,2.779407414748463,0.9949913349699715,0.9949913349699719,0,0,2.783754825592041,2.783754825592041,1,1
1673,2,2.7583401841827757,2.7583401841827757,0.995775843027747,0.9957758430277476,0,0,4.424932956695557,2.783754825592041,2,2
1673,3,2.752135196257222,2.7521351962572225,0.9959944364482465,0.9959944364482471,0,0,4.523865699768066,2.783754825592041,3,3
1673,4,2.6677526256905453,2.6689115875702054,0.9965048733340827,0.996603695466133,1,1,4.535756587982178,2.783754825592041,3,3
1673,8,2.31072146855255,2.632049384650996,0.9985223091483547,0.9978740280513098,3,4,4.857602119445801,2.783754825592041,5,4
1673,16,1.993844318582492,2.627581582563796,0.9971484875482213,0.9978244427560242,7,11,5.212151050567627,2.783754825592041,9,5
1673,32,1.3806372233093152,2.5510658173647744,1.0002678015478814,0.999851727443217,16,27,5.509946823120117,2.783754825592041,16,5
1673,64,0.6447602116703137,2.505514770368406,0.99989889559083,1.000882140338367,31,57,5.890140056610107,2.783754825592041,33,7
1673,128,0.04414293103131334,2.488580717367079,1.000045538443898,1.0017262324711929,60,120,6.389004707336426,2.783754825592041,68,8
1674,1,3.2488147279307404,3.248814727930737,0.9900992074415561,0.9900992074415582,0,0,3.2633581161499023,3.2633581161499023,1,1
1674,2,2.9193238601535554,2.919323860153555,0.9941140780336543,0.9941140780336563,0,0,3.7703447341918945,3.2633581161499023,2,2
1674,3,2.6218190267601362,2.6218190267601376,0.9969988873480398,0.9969988873480415,0,0,3.8664791584014893,3.2633581161499023,3,3
1674,4,2.5767813096649035,2.576781309664904,0.9969226222257573,0.9969226222257597,0,0,3.95855712890625,3.2633581161499023,4,4
1674,8,2.502944462568383,2.5065077913189144,0.9977296070863503,0.9977869670870188,3,3,4.04823112487793,3.2633581161499023,5,5
1674,16,2.2328612231326077,2.3174023652179803,0.999138854489177,1.0000438669606144,4,6,4.312314987182617,3.2633581161499023,12,10
1674,32,1.5190373350051924,2.198516684822644,1.0007355962260007,1.0011511866830742,16,24,4.680468559265137,3.2633581161499023,16,8
1674,64,0.5582559933521254,2.1120335918706625,1.0007448802454082,1.0027348919518446,31,54,5.076161861419678,3.2633581161499023,33,10
1674,128,0.03527608044565685,1.9864909859231659,0.9999539625984514,1.004716819472007,68,111,5.47614860534668,3.2633581161499023,60,17
1675,1,9.210244333344505,9.21024433334451,0.951518421823297,0.9515184218232985,0,0,9.321857452392578,9.321857452392578,1,1
1675,2,8.168695938012574,8.168695938012574,0.9754764514329213,0.9754764514329219,0,0,9.594924926757812,9.321857452392578,2,2
1675,3,7.419775910162644,7.419775910162645,0.9925997021123716,0.9925997021123718,0,0,9.876208305358887,9.321857452392578,3,3
1675,4,7.045423727005998,7.045423727005996,0.998370996819291,0.9983709968192916,0,0,9.968506813049316,9.321857452392578,4,4
1675,8,6.117446979717453,6.305627465421558,1.0130437652151194,1.0126786546468507,1,1,10.458561897277832,9.321857452392578,7,7
1675,16,5.805563425587941,5.967404376021039,1.0222274431496778,1.0222642241274318,4,6,10.844640731811523,9.321857452392578,12,10
1675,32,4.733500589057357,5.618676729886925,1.0241106537337081,1.0286419902940258,13,17,11.26938533782959,9.321857452392578,19,15
1675,64,3.5605577094754315,5.547656468305432,1.0190178932903369,1.0304765984250268,29,45,12.021846771240234,9.321857452392578,35,19
1675,128,1.9540501908412082,5.471182610798224,1.0028766380276057,1.035586934235713,61,105,12.843969345092773,9.321857452392578,67,23
1676,1,10.427708135002222,10.427708135002222,0.9478343752581153,0.9478343752581156,0,0,10.541500091552734,10.541500091552734,1,1
1676,2,9.157040197371424,9.157040197371424,0.9804039184460456,0.9804039184460456,0,0,11.453872680664062,10.541500091552734,2,2
1676,3,8.567517657139586,8.567517657139584,0.9924955257922492,0.9924955257922488,0,0,11.49758529663086,10.541500091552734,3,3
1676,4,8.47326630365242,8.47326630365242,0.9934155631225792,0.9934155631225783,0,0,11.67020320892334,10.541500091552734,4,4
1676,8,8.072092486174121,8.170336291756549,1.001785562229319,1.0015508242446372,3,3,11.824195861816406,10.541500091552734,5,5
1676,16,7.623335113368069,7.947719669691375,1.0089527878088864,1.0088733555086482,7,7,12.447295188903809,10.541500091552734,9,9
1676,32,6.5862746907147045,7.5681225592961745,1.0269741031996256,1.0247978923227687,10,21,13.150856971740723,10.541500091552734,22,11
1676,64,5.234134562836598,7.185223646424313,1.0255200722426734,1.037249498488348,29,50,13.631454467773438,10.541500091552734,35,14
1676,128,2.8222316176675983,7.094350005619875,1.0091591647924076,1.0399456845825912,60,113,14.093327522277832,10.541500091552734,68,15
1677,1,10.202864347705246,10.20286434770525,0.9328904112105365,0.9328904112105378,0,0,10.39998722076416,10.39998722076416,1,1
1677,2,8.080645613405741,8.080645613405741,0.989759629816926,0.9897596298169278,0,0,11.105100631713867,10.39998722076416,2,2
1677,3,7.815647931595522,7.815647931595523,0.9940299895173652,0.9940299895173668,0,0,11.24950885772705,10.39998722076416,3,3
1677,4,7.284766131815957,7.284766131815958,1.0048572606545894,1.0048572606545907,0,0,11.277384757995605,10.39998722076416,4,4
1677,8,7.0414823274907565,7.047119050951764,1.0095471508434204,1.0098853224794822,1,2,11.61929702758789,10.39998722076416,7,6
1677,16,6.439991424673923,6.709214870226065,1.0216601096437232,1.0188439012162156,7,6,11.90085506439209,10.39998722076416,9,10
1677,32,5.984888948292752,6.527881353594777,1.0255849554661551,1.0252383076558509,12,18,12.369150161743164,10.39998722076416,20,14
1677,64,4.999022723104571,6.391337873596558,1.0260123879110417,1.0322278460393959,31,44,12.936483383178711,10.39998722076416,33,20
1677,128,3.1117054360815577,6.28903262376675,1.007995695905839,1.0407828911712818,70,105,13.623218536376953,10.39998722076416,58,23
1678,1,10.595401590541135,10.59540159054114,0.9339438950413183,0.9339438950413205,0,0,10.779192924499512,10.779192924499512,1,1
1678,2,9.00871692443086,9.008716924430862,0.9705743119338215,0.9705743119338215,0,0,11.057934761047363,10.779192924499512,2,2
1678,3,8.454842614788697,8.454842614788696,0.9851054334888271,0.985105433488827,0,0,11.072813987731934,10.779192924499512,3,3
1678,4,7.921623326040156,7.921623326040157,0.9962217947939375,0.996221794793938,0,0,11.716544151306152,10.779192924499512,4,4
1678,8,7.338592488324427,7.3756160766520305,1.0113819736260121,1.0107308700837223,2,2,12.195274353027344,10.779192924499512,6,6
1678,16,6.626467135362269,7.028500744800921,1.0225448314961523,1.0228040269209857,4,6,12.571895599365234,10.779192924499512,12,10
1678,32,6.164135217975875,6.925658979494407,1.0191163618920098,1.0274183061383426,14,20,13.408061027526855,10.779192924499512,18,12
1678,64,4.996180218064185,6.888968269711628,1.0119727264190819,1.0309428796508713,28,49,13.898140907287598,10.779192924499512,36,15
1678,128,2.9114741026425865,6.662571262531796,1.0085788600930674,1.040567958017724,63,112,14.458141326904297,10.779192924499512,65,16
1679,1,8.601353907834397,8.601353907834401,0.9585332265895894,0.9585332265895908,0,0,8.691540718078613,8.691540718078613,1,1
1679,2,7.011854069725741,7.011854069725742,0.9887369022802661,0.9887369022802677,0,0,9.200860023498535,8.691540718078613,2,2
1679,3,6.786258212551043,6.786258212551043,0.9928559745173933,0.9928559745173938,0,0,9.317853927612305,8.691540718078613,3,3
1679,4,6.243838143417977,6.243838143417976,0.9974389376174196,0.9974389376174206,0,0,9.527554512023926,8.691540718078613,4,4
1679,8,5.559558750486421,5.559558750486421,1.0131654408222242,1.0131654408222237,0,0,10.44322681427002,8.691540718078613,8,8
1679,16,4.809399926911541,5.483135512857108,1.0146156091122212,1.0184896278396132,5,7,11.872512817382812,8.691540718078613,11,9
1679,32,4.024960375771498,5.174230068002623,1.0142370825584968,1.0267449940309947,12,20,12.67602825164795,8.691540718078613,20,12
1679,64,3.1112107176313093,5.10240429187644,1.0090095908576353,1.0307214129841926,30,49,13.428364753723145,8.691540718078613,34,15
1679,128,1.988131863787191,5.0932578980251035,1.0002631837571712,1.0321146255176081,65,109,14.249469757080078,8.691540718078613,63,19
1680,1,7.304839599060598,7.3048395990606,0.973726621551789,0.9737266215517897,0,0,7.347736835479736,7.347736835479736,1,1
1680,2,6.327944119456673,6.327944119456673,0.9883950027395548,0.9883950027395549,0,0,7.682975769042969,7.347736835479736,2,2
1680,3,5.823118948893841,5.82311894889384,0.9965000058285685,0.9965000058285675,0,0,7.8685760498046875,7.347736835479736,3,3
1680,4,5.73755104329234,5.73755104329234,0.9977183239108203,0.9977183239108197,0,0,7.921237468719482,7.347736835479736,4,4
1680,8,4.562861422766515,4.562861422766518,1.0150147333416497,1.0150147333416482,0,0,8.26569652557373,7.347736835479736,8,8
1680,16,3.916079081922622,4.230450873100114,1.0203959622846503,1.020190594840471,5,7,8.766611099243164,7.347736835479736,11,9
1680,32,3.6478122618367497,4.1742424223800105,1.020311408607984,1.0229662697056885,16,21,9.134047508239746,7.347736835479736,16,11
1680,64,2.304327155562564,4.143673420871617,1.0083407454886162,1.0241444114715108,30,48,9.76874828338623,7.347736835479736,34,16
1680,128,1.3171257722860539,4.127973166649555,1.00314926580637,1.0253353506759,62,111,10.411273002624512,7.347736835479736,66,17
1681,1,9.145361313561924,9.14536131356191,0.956167083397383,0.9561670833973847,0,0,9.238618850708008,9.238618850708008,1,1
1681,2,7.789865043039676,7.789865043039676,0.9799255903855192,0.979925590385518,0,0,9.434062957763672,9.238618850708008,2,2
1681,3,7.201309599871091,7.2013095998710925,0.9880611009727152,0.9880611009727142,0,0,9.443620681762695,9.238618850708008,3,3
1681,4,7.039868409896431,7.039868409896431,0.9917749086067601,0.9917749086067589,0,0,9.498424530029297,9.238618850708008,4,4
1681,8,6.852417955058876,6.853288251564907,0.9964449987813679,0.9962584267816372,2,2,9.78383731842041,9.238618850708008,6,6
1681,16,6.693172808755536,6.804366722262722,0.9985116211722866,0.9976024758993636,4,6,10.266777992248535,9.238618850708008,12,10
1681,32,5.292121114347084,6.637949623872816,1.0064612001724145,1.005745284258288,14,18,10.909770965576172,9.238618850708008,18,14
1681,64,4.008169024919037,6.390299173155883,1.0079455616079616,1.0154607293880786,29,52,11.594470024108887,9.238618850708008,35,12
1681,128,2.349365587389618,6.177808475839398,1.005075471523938,1.0258324646257302,63,114,12.306624412536621,9.238618850708008,65,14
1682,1,11.932403114865583,11.932403114865592,0.9166676740294923,0.9166676740294953,0,0,12.181626319885254,12.181626319885254,1,1
1682,2,10.448545581149896,10.4485455811499,0.9633943177715181,0.9633943177715194,0,0,13.2128267288208,12.181626319885254,2,2
1682,3,9.949131316798967,9.949131316798967,0.9808208198124659,0.9808208198124674,0,0,13.786637306213379,12.181626319885254,3,3
1682,4,9.893487911408915,9.893487911408917,0.9838230152412065,0.983823015241208,0,0,13.836304664611816,12.181626319885254,4,4
1682,8,8.73508926871072,8.752361988928355,1.0225869161292436,1.022853367710085,1,1,14.013967514038086,12.181626319885254,7,7
1682,16,7.6487221238907415,7.9009598669012995,1.0446212508949335,1.0435826728499085,2,5,14.532933235168457,12.181626319885254,14,11
1682,32,7.230046685663853,7.729801093333209,1.0496942219921088,1.0497315795287023,12,15,14.873555183410645,12.181626319885254,20,17
1682,64,5.943722197749606,7.697367014132872,1.0418602297872193,1.050523004467911,29,45,15.212532043457031,12.181626319885254,35,19
1682,128,3.9187507445890644,7.600226486303145,1.0249115385100285,1.0565631089495198,65,105,15.61928653717041,12.181626319885254,63,23
1683,1,8.068762504964399,8.068762504964397,0.9648460993684754,0.9648460993684771,0,0,8.136367797851562,8.136367797851562,1,1
1683,2,7.444312488717943,7.444312488717974,0.9769052020490778,0.9769052020490776,0,0,8.204036712646484,8.136367797851562,2,2
1683,3,7.112931788977116,7.112931788977116,0.98494797492785,0.9849479749278501,0,0,9.015823364257812,8.136367797851562,3,3
1683,4,6.483052874511313,6.483052874511313,0.9970836502012954,0.9970836502012953,0,0,9.21317195892334,8.136367797851562,4,4
1683,8,5.085032081299606,5.113374801837834,1.0177367311948515,1.017663663835912,2,2,9.485258102416992,8.136367797851562,6,6
1683,16,4.906231401220315,5.045122180893973,1.0195766770850438,1.0193465496101926,5,8,9.802452087402344,8.136367797851562,11,8
1683,32,4.080662991194356,4.729403317286271,1.0262998402181038,1.0273802895546904,14,20,10.444035530090332,8.136367797851562,18,12
1683,64,3.042012417340271,4.669172751487694,1.0139540796061954,1.0301945494926101,26,49,11.014120101928711,8.136367797851562,38,15
1683,128,2.1770158653390714,4.627269601514093,1.0095822183581966,1.0315879844635756,60,111,11.76093578338623,8.136367797851562,68,17
1684,1,7.204901747639339,7.204901747639339,0.9755509559183754,0.9755509559183755,0,0,7.242799758911133,7.242799758911133,1,1
1684,2,6.106652720480636,6.106652720480633,0.9894837011098574,0.9894837011098551,0,0,8.068405151367188,7.242799758911133,2,2
1684,3,5.4985023077222275,5.498502307722228,1.0036043618529555,1.0036043618529535,0,0,9.07377815246582,7.242799758911133,3,3
1684,4,5.44297009667039,5.44297009667039,1.005142496169194,1.005142496169192,0,0,9.105691909790039,7.242799758911133,4,4
1684,8,5.086128672574533,5.08875126530843,1.0175332283220118,1.0175262676997845,1,1,9.62955093383789,7.242799758911133,7,7
1684,16,4.441748802957042,4.894581549839029,1.024519741389763,1.0228400882546365,4,5,10.420578002929688,7.242799758911133,12,11
1684,32,3.8395594863158755,4.794557617441425,1.0225348890221657,1.0246219871616777,12,19,11.142175674438477,7.242799758911133,20,13
1684,64,2.7283314316541856,4.7337087707587715,1.01115332519338,1.0273432479191906,30,49,11.76821517944336,7.242799758911133,34,15
1684,128,1.72847877074392,4.65309963206209,1.0042266919130638,1.0309819419201696,63,111,12.172042846679688,7.242799758911133,65,17
1685,1,7.066721869897266,7.066721869897266,0.9768496647428483,0.9768496647428484,0,0,7.100658416748047,7.100658416748047,1,1
1685,2,6.22893963608041,6.228939636080408,0.9930167607113434,0.9930167607113425,0,0,7.818110466003418,7.100658416748047,2,2
1685,3,5.652168822895054,5.652168822895055,1.0001131769908018,1.0001131769908005,0,0,7.922295093536377,7.100658416748047,3,3
1685,4,5.2181507842097075,5.218150784209709,1.0069237479613997,1.006923747961397,0,0,8.048230171203613,7.100658416748047,4,4
1685,8,4.47452726010344,4.616229879973703,1.0136858387476377,1.0138796862750132,1,1,8.52234935760498,7.100658416748047,7,7
1685,16,4.207787658139411,4.333060294747805,1.01775097117787,1.0193614931682384,7,6,8.946271896362305,7.100658416748047,9,10
1685,32,3.8388305572633263,4.245154787099967,1.0234896304459435,1.023005923562823,10,14,9.644187927246094,7.100658416748047,22,18
1685,64,2.714970884862122,4.196738717615899,1.0107147277250985,1.0246025160611705,27,48,10.426298141479492,7.100658416748047,37,16
1685,128,1.5303590117234627,4.1831365502161955,1.001585926358102,1.0256865048241866,60,111,11.120067596435547,7.100658416748047,68,17
1686,1,9.340519435642346,9.340519435642348,0.9499821452502946,0.9499821452502961,0,0,9.45909595489502,9.45909595489502,1,1
1686,2,8.27889278902483,8.278892789024832,0.980430166936699,0.9804301669366997,0,0,10.505122184753418,9.45909595489502,2,2
1686,3,7.605923369828432,7.605923369828431,0.998972001546648,0.9989720015466488,0,0,10.690479278564453,9.45909595489502,3,3
1686,4,7.089329623683701,7.089329623683701,1.006634962229444,1.0066349622294442,0,0,10.694319725036621,9.45909595489502,4,4
1686,8,6.7217582525199475,6.726472665037766,1.014792976897008,1.0145732143530979,1,1,11.263388633728027,9.45909595489502,7,7
1686,16,5.885320311335752,6.099788221039765,1.0250534910487556,1.0259368667409512,4,5,12.006686210632324,9.45909595489502,12,11
1686,32,5.281933785698136,5.896979140789027,1.0281164374232725,1.0296996819358175,17,21,12.344704627990723,9.45909595489502,15,11
1686,64,3.9325348050909006,5.839944367573839,1.0172284336264013,1.032638834661182,32,50,13.018501281738281,9.45909595489502,32,14
1686,128,2.124324390058782,5.781737540658508,1.0040789779237347,1.0367382021951936,65,113,13.504104614257812,9.45909595489502,63,15
1687,1,8.084055558268494,8.0840555582685,0.9651810106903874,0.965181010690389,0,0,8.153331756591797,8.153331756591797,1,1
1687,2,6.720246820868812,6.720246820868812,0.9889893089849534,0.9889893089849542,0,0,8.274524688720703,8.153331756591797,2,2
1687,3,5.5984654150104385,5.598465415010439,1.0079539540197773,1.007953954019776,0,0,8.438608169555664,8.153331756591797,3,3
1687,4,5.5412634945002655,5.541263494500266,1.0099842804532688,1.0099842804532673,0,0,8.938182830810547,8.153331756591797,4,4
1687,8,4.896237149383117,4.901423269267283,1.0207291395005136,1.0206046143781862,3,3,9.253741264343262,8.153331756591797,5,5
1687,16,4.276334601850771,4.4883344749889105,1.0251184012202197,1.0263539081047908,5,6,9.716880798339844,8.153331756591797,11,10
1687,32,3.6801206097969725,4.362739366071572,1.0253241995377829,1.029817252004066,11,20,10.43319034576416,8.153331756591797,21,12
1687,64,2.540503160440509,4.362434710598564,1.007909974293546,1.0298712115425803,35,51,11.062421798706055,8.153331756591797,29,13
1687,128,1.3821376349985346,4.352584675106499,1.0026653130924954,1.0318704689224263,66,114,11.736054420471191,8.153331756591797,62,14
1688,1,6.196893683605008,6.196893683605011,0.9773813262809449,0.9773813262809465,0,0,6.23538064956665,6.23538064956665,1,1
1688,2,5.513453311190261,5.51345331119026,0.9873512432407965,0.9873512432407971,0,0,6.296824932098389,6.23538064956665,2,2
1688,3,5.368239675002176,5.368239675002177,0.9887754609409405,0.9887754609409405,0,0,6.346506118774414,6.23538064956665,3,3
1688,4,5.041127583375417,5.041127583375417,0.9938832882526352,0.9938832882526352,0,0,6.444128513336182,6.23538064956665,4,4
1688,8,4.092869653239689,4.142302080212684,1.0058397400062504,1.0058059366027208,1,1,7.084805965423584,6.23538064956665,7,7
1688,16,3.7693814511106827,3.88614514049614,1.0108453048915054,1.011079223565992,2,5,7.401430606842041,6.23538064956665,14,11
1688,32,3.1741246409426003,3.487958268387851,1.0142007950068632,1.0155556448090701,11,19,7.9301886558532715,6.23538064956665,21,13
1688,64,2.312982688871047,3.4669840461761194,1.0074459128762334,1.0162693257166264,27,48,8.500157356262207,6.23538064956665,37,16
1688,128,0.9818717933822046,3.3084660567455333,0.9995064431214411,1.020021255982744,61,110,9.42281436920166,6.23538064956665,67,18
1689,1,9.52651771010027,9.526517710100272,0.9381599683821904,0.9381599683821936,0,0,9.708030700683594,9.708030700683594,1,1
1689,2,8.016207553568131,8.016207553568133,0.9728643199756991,0.972864319975701,0,0,10.158415794372559,9.708030700683594,2,2
1689,3,7.611210978170645,7.611210978170646,0.9845452237110995,0.9845452237111003,0,0,10.4498929977417,9.708030700683594,3,3
1689,4,7.465289796151809,7.465289796151809,0.9888463705327452,0.9888463705327466,0,0,10.486387252807617,9.708030700683594,4,4
1689,8,6.259347498970334,6.352867347907003,1.0141717152246836,1.0132752317254776,1,1,10.686266899108887,9.708030700683594,7,7
1689,16,5.794135277582864,6.005778396456399,1.0172562120206283,1.0181654052136282,4,3,11.176397323608398,9.708030700683594,12,13
1689,32,5.30477833667171,5.908666672374559,1.0228960986503797,1.021109091496598,14,18,11.75253677368164,9.708030700683594,18,14
1689,64,4.3096216522222806,5.480909188573117,1.0281447071969043,1.0370378364473152,26,46,12.198830604553223,9.708030700683594,38,18
1689,128,2.4830072532326968,5.316484942442405,1.0132629499252332,1.0419297873232787,62,108,12.805561065673828,9.708030700683594,66,20
1690,1,8.609219909260228,8.60921990926023,0.9618319816708463,0.9618319816708468,0,0,8.685277938842773,8.685277938842773,1,1
1690,2,7.739004139906187,7.739004139906188,0.9813680734654706,0.9813680734654706,0,0,9.17128849029541,8.685277938842773,2,2
1690,3,6.589861110092785,6.589861110092785,1.0057700134828578,1.0057700134828584,0,0,9.405207633972168,8.685277938842773,3,3
1690,4,6.529020888738188,6.529020888738188,1.0070392548006784,1.0070392548006792,0,0,9.522917747497559,8.685277938842773,4,4
1690,8,6.012302869513304,6.0157389599165025,1.016121617193666,1.015998258630231,1,1,9.884937286376953,8.685277938842773,7,7
1690,16,5.260544631554376,5.4541106296361335,1.0257556727475485,1.024725964252151,6,7,10.2872953414917,8.685277938842773,10,9
1690,32,4.486886493305971,5.3464308217842476,1.0243497483417165,1.027891567332402,12,21,10.734609603881836,8.685277938842773,20,11
1690,64,3.677725266128419,5.124834306509161,1.0253576704987797,1.0360748131654036,28,49,11.321410179138184,8.685277938842773,36,15
1690,128,1.8560608146932667,5.052141649880627,1.005548669110499,1.0379376108015046,66,109,11.859475135803223,8.685277938842773,62,19
1691,1,3.526748121923729,3.5267481219237293,0.9934013814218465,0.9934013814218469,0,0,3.5325870513916016,3.5325870513916016,1,1
1691,2,3.5046528854608527,3.504652885460853,0.9941281826937501,0.9941281826937507,0,0,5.433797836303711,3.5325870513916016,2,2
1691,3,3.491815687483849,3.4918156874838497,0.9948429225212944,0.9948429225212948,0,0,5.888364315032959,3.5325870513916016,3,3
1691,4,3.48417762325832,3.4918156874838497,0.994568536141736,0.9948429225212948,1,1,6.412467956542969,3.5325870513916016,3,3
1691,8,3.34409399208394,3.4226602084592437,0.9973418298252896,0.9978165382344932,4,4,7.709707736968994,3.5325870513916016,4,4
1691,16,2.8188398188564405,3.3646338653340426,0.9966060058280986,0.9995153100240592,7,12,8.204253196716309,3.5325870513916016,9,4
1691,32,2.394579569404742,3.3082822343758305,1.000398635749404,1.002490088789813,13,27,8.840771675109863,3.5325870513916016,19,5
1691,64,1.621342228171958,3.3082822343758305,1.0006747757002705,1.002490088789813,30,59,9.527117729187012,3.5325870513916016,34,5
1691,128,0.8405373449201713,3.3062074278318097,1.0005315468353992,1.0029672759795905,64,123,10.531903266906738,3.5325870513916016,64,5
1692,1,7.614986083236424,7.6149860832364284,0.9556400318614255,0.9556400318614273,0,0,7.726707935333252,7.726707935333252,1,1
1692,2,6.0623980593555515,6.062398059355553,0.9862297541112118,0.9862297541112137,0,0,7.759190082550049,7.726707935333252,2,2
1692,3,6.045209052735332,6.045209052735335,0.9877838070696661,0.9877838070696682,0,0,10.15769100189209,7.726707935333252,3,3
1692,4,5.919647680709938,5.920080365102503,0.9925717977726903,0.9926835438780671,1,1,10.335373878479004,7.726707935333252,3,3
1692,8,5.506725314837109,5.639554759276503,1.00366236421751,1.002844301306884,2,2,11.246099472045898,7.726707935333252,6,6
1692,16,5.126508756808633,5.587951992795194,1.0033108669433073,1.005450660027567,6,9,12.816499710083008,7.726707935333252,10,7
1692,32,4.1763644873923225,5.488211754148112,1.0072884652317882,1.011978879368489,14,21,13.4596586227417,7.726707935333252,18,11
1692,64,3.1059737171643538,5.397127811985653,1.0072037751549954,1.0198146868469504,31,53,14.32711410522461,7.726707935333252,33,11
1692,128,1.951875326541967,5.381995116264166,0.9998537762545714,1.0200654055888188,71,116,15.503238677978516,7.726707935333252,57,12
1693,1,8.085237102617373,8.085237102617379,0.9663107998216827,0.9663107998216849,0,0,8.14793586730957,8.14793586730957,1,1
1693,2,6.6588441509052485,6.6588441509052485,0.9895583301815967,0.9895583301815971,0,0,8.240055084228516,8.14793586730957,2,2
1693,3,5.737545945147856,5.737545945147856,1.0048146888877343,1.0048146888877363,0,0,8.61351203918457,8.14793586730957,3,3
1693,4,5.423104713627344,5.423104713627344,1.0090831319436453,1.0090831319436462,0,0,8.866329193115234,8.14793586730957,4,4
1693,8,4.634124125285523,4.636084619236508,1.0192805247754755,1.019592354806229,1,1,9.335678100585938,8.14793586730957,7,7
1693,16,4.263869715806402,4.342289208696603,1.0228207711122659,1.0245720179896443,5,6,9.804352760314941,8.14793586730957,11,10
1693,32,3.7499298525428735,4.2045688846043845,1.0237942381351712,1.0295044361110575,11,20,10.380395889282227,8.14793586730957,21,12
1693,64,3.0844114047613105,4.201310969542886,1.0121186977328713,1.029797847236047,27,50,10.981162071228027,8.14793586730957,37,14
1693,128,1.7452691583008308,4.172807752820727,1.0061145330005088,1.0321797354576774,60,112,11.78916072845459,8.14793586730957,68,16
1694,1,8.098975847704663,8.098975847704635,0.9639620833373289,0.963962083337331,0,0,8.170769691467285,8.170769691467285,1,1
1694,2,7.113251829563894,7.113251829563897,0.9833892857223352,0.9833892857223367,0,0,8.860501289367676,8.170769691467285,2,2
1694,3,6.665820727941464,6.6658207279414645,0.9915667092312204,0.9915667092312217,0,0,9.131794929504395,8.170769691467285,3,3
1694,4,6.102443583989473,6.102443583989473,0.9967336132584486,0.9967336132584489,0,0,9.150489807128906,8.170769691467285,4,4
1694,8,5.915262656640135,5.91903469821865,1.0029538606257766,1.0028555654375586,1,1,9.565934181213379,8.170769691467285,7,7
1694,16,5.407278430523798,5.471538845224222,1.0117738357896848,1.012706372835916,3,5,10.339415550231934,8.170769691467285,13,11
1694,32,4.5982870275700805,5.348971228446143,1.0128561361887136,1.017536225691987,13,16,10.890202522277832,8.170769691467285,19,16
1694,64,2.9124319064354935,5.263097432649263,1.0035941239667419,1.0215409870978567,35,48,11.34652042388916,8.170769691467285,29,16
1694,128,1.5753869158400648,5.176451456238747,1.0021524250263307,1.0251977772910041,65,107,11.966167449951172,8.170769691467285,63,21
1695,1,7.589789373131149,7.589789373131151,0.9649962596995573,0.9649962596995578,0,0,7.6644415855407715,7.6644415855407715,1,1
1695,2,6.50477072343896,6.50477072343896,0.9827250803266905,0.9827250803266898,0,0,7.764002799987793,7.6644415855407715,2,2
1695,3,5.541208873667326,5.541208873667325,0.9983190799854983,0.998319079985498,0,0,7.788926124572754,7.6644415855407715,3,3
1695,4,5.1537751629861415,5.1537944215634095,1.0025923640256593,1.0025845236004753,1,1,7.912781238555908,7.6644415855407715,3,3
1695,8,4.502802023181749,4.6074095620404245,1.013792206378161,1.0121614226111637,1,1,8.282995223999023,7.6644415855407715,7,7
1695,16,4.248179597298232,4.587275650843639,1.0138043612245564,1.0124138271178191,5,8,8.546720504760742,7.6644415855407715,11,8
1695,32,3.6240588474002107,4.523473362697646,1.0168714441366,1.0148845136127544,12,19,9.09232234954834,7.6644415855407715,20,13
1695,64,2.7516769356650617,4.313487334336624,1.0078411974958146,1.0204255414098549,24,49,9.662543296813965,7.6644415855407715,40,15
1695,128,0.9538874567406116,4.305112330521941,1.000589759652236,1.0210543861366563,64,111,10.19935131072998,7.6644415855407715,64,17
1696,1,10.42332513210997,10.423325132109971,0.9344814513460032,0.9344814513460035,0,0,10.608917236328125,10.608917236328125,1,1
1696,2,9.869282285828238,9.869282285828236,0.9508436412327315,0.950843641232731,0,0,11.873116493225098,10.608917236328125,2,2
1696,3,9.15749641602127,9.157496416021269,0.970870968561093,0.9708709685610926,0,0,11.969054222106934,10.608917236328125,3,3
1696,4,8.307401193886792,8.307401193886793,0.9974097157703319,0.9974097157703321,0,0,12.26030158996582,10.608917236328125,4,4
1696,8,7.142531154254485,7.356824360043306,1.0207213230782215,1.017990783158631,2,2,12.52462387084961,10.608917236328125,6,6
1696,16,6.307806006780075,7.315417777061263,1.031745947907312,1.0220448777890017,4,6,13.265915870666504,10.608917236328125,12,10
1696,32,5.514538919736705,6.584878617392417,1.037830075078833,1.04070606958232,16,21,13.804524421691895,10.608917236328125,16,11
1696,64,4.392559704212356,6.55910782652279,1.0297597577170206,1.042101269151499,28,51,14.214735984802246,10.608917236328125,36,13
1696,128,3.1433598171526085,6.4982367426784675,1.0173834587804316,1.0479985222436934,61,112,14.597893714904785,10.608917236328125,67,16
1697,1,8.232473227829711,8.232473227829713,0.9517715695501932,0.9517715695501936,0,0,8.360414505004883,8.360414505004883,1,1
1697,2,7.689470246745668,7.689470246745668,0.9630000599155402,0.9630000599155405,0,0,8.649133682250977,8.360414505004883,2,2
1697,3,7.354338382695239,7.35433838269524,0.9717662107624527,0.9717662107624533,0,0,8.950713157653809,8.360414505004883,3,3
1697,4,7.266669333267914,7.266669333267913,0.9746822768092234,0.9746822768092225,0,0,8.952058792114258,8.360414505004883,4,4
1697,8,6.033603217474156,6.075857231795192,1.0024290142881727,1.0016346929377606,1,1,9.514869689941406,8.360414505004883,7,7
1697,16,5.3446290319132705,5.814693664539433,1.0099519904665724,1.0078550890206748,6,7,9.939031600952148,8.360414505004883,10,9
1697,32,3.799598145308158,5.814693664539434,1.0076890998109946,1.007855089020675,13,23,10.434133529663086,8.360414505004883,19,9
1697,64,2.602666316130025,5.558717893828103,1.0048829603569334,1.0112895871486551,32,55,11.014345169067383,8.360414505004883,32,9
1697,128,1.538526895768208,5.534020619720418,1.0009842198168477,1.0130312045783216,65,119,11.538416862487793,8.360414505004883,63,9
1698,1,8.977509384367378,8.97750938436738,0.9549304508622447,0.9549304508622468,0,0,9.076679229736328,9.076679229736328,1,1
1698,2,7.773380534557495,7.773380534557493,0.981055659898953,0.9810556598989544,0,0,9.778512954711914,9.076679229736328,2,2
1698,3,7.289848894788812,7.289848894788812,0.9908832488136676,0.9908832488136681,0,0,9.826858520507812,9.076679229736328,3,3
1698,4,6.9549048965438836,6.954904896543883,1.0001281040564998,1.0001281040564993,0,0,10.252522468566895,9.076679229736328,4,4
1698,8,6.120110711518793,6.34247713801298,1.0178468887516354,1.017601742513366,1,1,11.67756462097168,9.076679229736328,7,7
1698,16,5.256681075567482,6.133029627025568,1.010262048615619,1.025500255671937,8,7,12.533658027648926,9.076679229736328,8,9
1698,32,3.9794657346447586,5.86666584079073,1.0035417247762601,1.035383912705151,15,21,13.590007781982422,9.076679229736328,17,11
1698,64,3.472952915247836,5.865078915847116,1.0085749205895274,1.035868072863974,28,51,14.24956226348877,9.076679229736328,36,13
1698,128,2.1948687894501826,5.837625670071136,1.0024897153203414,1.0366638998252233,65,115,15.259523391723633,9.076679229736328,63,13
1699,1,4.754489329826526,4.754489329826528,0.9883531197227581,0.9883531197227599,0,0,4.767617702484131,4.767617702484131,1,1
1699,2,3.99204292691841,3.9920429269184106,0.9983177171124586,0.9983177171124598,0,0,5.718327045440674,4.767617702484131,2,2
1699,3,3.9612595196345106,3.9612595196345106,0.9995374707003183,0.9995374707003193,0,0,6.267114162445068,4.767617702484131,3,3
1699,4,3.740159977912359,3.7401599779123584,1.0026513664929384,1.0026513664929397,0,0,6.464719772338867,4.767617702484131,4,4
1699,8,3.119271284904024,3.238466342123775,1.0084386495875117,1.0089478827995833,2,1,7.0666608810424805,4.767617702484131,6,7
1699,16,2.4133654804779505,2.945675474539881,1.0088686957150224,1.0130201018334373,5,7,7.569781303405762,4.767617702484131,11,9
1699,32,1.9569248082295598,2.804078719754676,1.0060522003852235,1.0158928242948582,14,23,8.342921257019043,4.767617702484131,18,9
1699,64,1.470069278369513,2.7776466693127198,1.003100453661616,1.0174356604668877,30,49,9.251397132873535,4.767617702484131,34,15
1699,128,0.845870903760845,2.7696890131780565,0.9999441483205761,1.0185212843903,62,112,10.107748985290527,4.767617702484131,66,16
1700,1,8.883522466070492,8.883522466070493,0.9529649805617647,0.9529649805617663,0,0,8.991888046264648,8.991888046264648,1,1
1700,2,7.47768575919339,7.477685759193391,0.9861872922035223,0.9861872922035235,0,0,9.422240257263184,8.991888046264648,2,2
1700,3,7.422375914148851,7.422375914148852,0.9876805555480541,0.9876805555480557,0,0,9.907320022583008,8.991888046264648,3,3
1700,4,7.1688432510808875,7.168843251080888,0.9945488414528657,0.9945488414528667,0,0,10.021567344665527,8.991888046264648,4,4
1700,8,6.431066240692765,6.52540717573392,1.0112431367028418,1.0082233739931847,1,1,10.826859474182129,8.991888046264648,7,7
1700,16,6.074322634686375,6.304393804528352,1.0129290881509574,1.018470494299395,6,8,11.934643745422363,8.991888046264648,10,8
1700,32,5.050801732372733,6.14229231319058,1.0241976786526856,1.0293717005215706,13,20,12.767911911010742,8.991888046264648,19,12
1700,64,3.405673588907299,6.10052822529217,1.0145711620583375,1.034994007629348,30,50,13.282472610473633,8.991888046264648,34,14
1700,128,2.0384615963052752,6.002208736912878,1.006198880344773,1.038832430005514,61,111,14.227919578552246,8.991888046264648,67,17
1701,1,5.945519868092029,5.945519868091991,0.9867726218805107,0.9867726218805114,0,0,5.959155559539795,5.959155559539795,1,1
1701,2,5.2460263804666045,5.2460263804666045,0.9946528634359784,0.9946528634359779,0,0,6.150269985198975,5.959155559539795,2,2
1701,3,4.547559233792673,4.547559233792673,1.0011763666408418,1.0011763666408413,0,0,6.2258100509643555,5.959155559539795,3,3
1701,4,4.545473911116985,4.545473911116985,1.0014553153296173,1.0014553153296175,0,0,7.559640407562256,5.959155559539795,4,4
1701,8,4.251773067121782,4.309903309300428,1.0069842209786342,1.0070731809222964,1,1,7.8082380294799805,5.959155559539795,7,7
1701,16,3.802945265791524,3.8726795215718552,1.0149756380259134,1.0156188567371336,4,6,8.47258472442627,5.959155559539795,12,10
1701,32,3.042716896498069,3.6505744964889595,1.008675188027081,1.0196681483324785,15,22,9.233885765075684,5.959155559539795,17,10
1701,64,1.8687524783927159,3.639668564762586,1.005448405910217,1.020247314439267,26,54,9.800063133239746,5.959155559539795,38,10
1701,128,0.9161352793565691,3.6373445147835546,1.002862069992125,1.0207312929954673,65,117,10.410110473632812,5.959155559539795,63,11
1702,1,8.67041718834004,8.670417188340043,0.9558869587086818,0.955886958708683,0,0,8.770440101623535,8.770440101623535,1,1
1702,2,7.226758266958139,7.226758266958139,0.9898812600411366,0.9898812600411361,0,0,9.757346153259277,8.770440101623535,2,2
1702,3,6.344235918274769,6.3442359182747685,1.0063227238616277,1.006322723861627,0,0,9.895795822143555,8.770440101623535,3,3
1702,4,6.309420849972429,6.309420849972428,1.0078587522562132,1.0078587522562135,0,0,10.359732627868652,8.770440101623535,4,4
1702,8,5.788748497455927,6.299465991437651,1.0107022644201318,1.0085452957526644,3,2,11.208198547363281,8.770440101623535,5,6
1702,16,5.575090566193248,6.133352666940838,1.0178437522721524,1.0153147561774873,6,8,11.707670211791992,8.770440101623535,10,8
1702,32,5.20037431029562,6.021494168102464,1.0222150386642321,1.0203952131429654,15,22,11.919114112854004,8.770440101623535,17,10
1702,64,4.071650471969493,5.83979209584431,1.019729732506634,1.0251946856873926,29,50,12.472077369689941,8.770440101623535,35,14
1702,128,1.9653301439914705,5.728307396528078,1.0048603147390136,1.0306067985989835,67,112,13.207378387451172,8.770440101623535,61,16
1703,1,5.595570398156296,5.595570398156297,0.9891227236391257,0.9891227236391262,0,0,5.6054511070251465,5.6054511070251465,1,1
1703,2,5.0976630911421825,5.097663091142183,0.9957205012777341,0.9957205012777337,0,0,6.337482929229736,5.6054511070251465,2,2
1703,3,4.168032450367461,4.168032450367461,1.0064533506464755,1.0064533506464755,0,0,6.465869426727295,5.6054511070251465,3,3
1703,4,4.163858359126918,4.163858359126917,1.0066773872133754,1.0066773872133754,0,0,6.488475322723389,5.6054511070251465,4,4
1703,8,3.982939575388011,4.021228069610271,1.0076374715421739,1.008003612106959,2,3,6.640324115753174,5.6054511070251465,6,5
1703,16,3.4617370789668334,3.762854306005819,1.0135345575803885,1.0128314302898418,5,7,7.3008270263671875,5.6054511070251465,11,9
1703,32,2.864417009828343,3.65635703911566,1.007488339644659,1.0165376894911144,16,21,7.849822044372559,5.6054511070251465,16,11
1703,64,1.7346425976996365,3.6329778217876556,1.0017369616778358,1.018298738869209,30,49,8.553647994995117,5.6054511070251465,34,15
1703,128,0.8586296394992909,3.5917252391623005,1.0002783133167386,1.0204252504244002,65,112,9.344003677368164,5.6054511070251465,63,16
1704,1,2.8664858457717166,2.866485845771717,0.9987483952008311,0.9987483952008319,0,0,2.8667404651641846,2.8667404651641846,1,1
1704,2,2.6871378440647065,2.687137844064706,1.0009667270166753,1.0009667270166764,0,0,3.270667552947998,2.8667404651641846,2,2
1704,3,2.5749553583649627,2.5749553583649623,1.001774558027578,1.0017745580275785,0,0,3.45110821723938,2.8667404651641846,3,3
1704,4,2.5161130441000714,2.5161130441000714,1.0021684350135716,1.0021684350135727,0,0,3.5821590423583984,2.8667404651641846,4,4
1704,8,2.330643723135121,2.3510870346482378,1.00261598715604,1.00270314090831,3,3,3.8605055809020996,2.8667404651641846,5,5
1704,16,1.8673820409848505,2.318865772099498,1.0022283718003488,1.0035635803805674,8,10,4.173869609832764,2.8667404651641846,8,6
1704,32,1.0574471478097631,2.3160046009584314,1.0009704715593628,1.0036514170687638,16,24,4.377240180969238,2.8667404651641846,16,8
1704,64,0.49570269574053033,2.2807862589428365,1.0004661293471009,1.0049395389747109,28,55,4.71455717086792,2.8667404651641846,36,9
1704,128,0.034803211682285375,2.2551297875910374,0.9999929095196998,1.0056545570483277,64,119,5.132797718048096,2.8667404651641846,64,9
1705,1,5.326338767963234,5.326338767963236,0.9894362785816846,0.9894362785816864,0,0,5.335943222045898,5.335943222045898,1,1
1705,2,4.230350047720166,4.230350047720166,1.0002954975379426,1.0002954975379437,0,0,5.6718902587890625,5.335943222045898,2,2
1705,3,3.8533963553839428,3.8533963553839423,1.0037615012405552,1.003761501240556,0,0,5.893944263458252,5.335943222045898,3,3
1705,4,3.762829235084148,3.7628292350841472,1.0045706817938704,1.0045706817938715,0,0,6.004765033721924,5.335943222045898,4,4
1705,8,2.9765418216581034,3.063589533347178,1.0117797297716045,1.0110231414363513,2,2,6.594063758850098,5.335943222045898,6,6
1705,16,2.5556355032469433,3.0203401126751923,1.0099322906249142,1.0121814612877447,5,10,7.270396709442139,5.335943222045898,11,6
1705,32,2.229520941407001,2.9915891573377724,1.0076890182072318,1.0131286341440346,13,24,7.766186714172363,5.335943222045898,19,8
1705,64,1.810780524592611,2.8879846989762754,1.004568568629266,1.0149523684926565,31,55,8.303905487060547,5.335943222045898,33,9
1705,128,0.9333284225635871,2.8837542790880635,1.002319018958435,1.0155369866653816,65,117,9.020429611206055,5.335943222045898,63,11
1706,1,9.562704946914913,9.562704946914918,0.9460587837749017,0.9460587837749034,0,0,9.700742721557617,9.700742721557617,1,1
1706,2,7.505158958460228,7.505158958460229,0.9906595046904123,0.990659504690413,0,0,10.266133308410645,9.700742721557617,2,2
1706,3,7.212748091508853,7.212748091508854,0.9984462477144975,0.9984462477144985,0,0,10.495866775512695,9.700742721557617,3,3
1706,4,7.060659626494344,7.060659626494344,1.0020282774291334,1.0020282774291345,0,0,11.318378448486328,9.700742721557617,4,4
1706,8,6.502185067909377,6.670932600931436,1.0139939761317942,1.0128319507060306,1,1,11.772971153259277,9.700742721557617,7,7
1706,16,6.1097425791140685,6.5735724939387365,1.0141694061036572,1.015691827288158,5,10,12.019771575927734,9.700742721557617,11,6
1706,32,5.366659529348257,6.222394957999639,1.0268036607572584,1.0317836614102134,15,20,12.806851387023926,9.700742721557617,17,12
1706,64,4.329449555675325,6.160355734035457,1.0193898087131505,1.035574285119504,32,50,13.294553756713867,9.700742721557617,32,14
1706,128,2.5879568270592515,6.153201852023262,1.00958151656359,1.0378618591547335,59,111,14.023355484008789,9.700742721557617,69,17
1707,1,3.5165019048959194,3.516501904895919,0.9939312021894361,0.9939312021894359,0,0,3.52152943611145,3.52152943611145,1,1
1707,2,3.0693778273749026,3.0693778273749026,0.9957937154598683,0.9957937154598677,0,0,3.695966958999634,3.52152943611145,2,2
1707,3,2.9356960188539634,2.9356960188539634,0.9975503208387259,0.9975503208387251,0,0,4.06438684463501,3.52152943611145,3,3
1707,4,2.8186813706896916,2.8186813706896916,0.9989390892795995,0.9989390892795988,0,0,4.282395839691162,3.52152943611145,4,4
1707,8,2.523879736980961,2.583280130433531,1.0005811433036953,1.0012233288540981,1,2,4.939056396484375,3.52152943611145,7,6
1707,16,2.1720880813986922,2.43850583115045,1.0009752750080574,1.002740502692627,6,10,5.1277666091918945,3.52152943611145,10,6
1707,32,1.798451774092609,2.3956401436253723,0.9993076367956847,1.0028881655256747,13,26,5.334361553192139,3.52152943611145,19,6
1707,64,1.3151869336900046,2.3956401436253723,0.9995095884030745,1.0028881655256747,30,58,6.042950630187988,3.52152943611145,34,6
1707,128,0.21814883276845803,2.3812213769131323,0.999831047386762,1.0037353770556652,67,119,6.892719745635986,3.52152943611145,61,9
1708,1,8.586086409941602,8.586086409941572,0.9589319794697131,0.9589319794697162,0,0,8.670528411865234,8.670528411865234,1,1
1708,2,6.983260120985425,6.9832601209854275,0.9890404293453279,0.9890404293453297,0,0,9.249404907226562,8.670528411865234,2,2
1708,3,6.2506707388060585,6.250670738806058,1.002714402716363,1.002714402716364,0,0,9.31960678100586,8.670528411865234,3,3
1708,4,6.204261587413085,6.204261587413085,1.00452024283099,1.0045202428309898,0,0,9.504938125610352,8.670528411865234,4,4
1708,8,5.75528005751689,5.763604955809061,1.013143654039708,1.013662212127052,2,2,10.042481422424316,8.670528411865234,6,6
1708,16,5.196251077207994,5.473128351439404,1.0170383341119775,1.0192197504439795,5,8,10.654813766479492,8.670528411865234,11,8
1708,32,4.3633030676748765,5.030740839825676,1.0267926430505152,1.0321503248902395,13,20,11.128212928771973,8.670528411865234,19,12
1708,64,3.5024530943439713,4.884547337763022,1.0210563247277702,1.0373904863365686,32,49,11.781983375549316,8.670528411865234,32,15
1708,128,2.3663997079510155,4.856619382147752,1.006960260290791,1.039163366222533,62,108,12.495305061340332,8.670528411865234,66,20
1709,1,8.733435407107377,8.73343540710738,0.9575840617915532,0.9575840617915546,0,0,8.826862335205078,8.826862335205078,1,1
1709,2,8.067861135432674,8.067861135432675,0.9759663158134916,0.9759663158134926,0,0,8.867270469665527,8.826862335205078,2,2
1709,3,7.3543568812731355,7.3543568812731355,0.9880670551852144,0.9880670551852151,0,0,9.134381294250488,8.826862335205078,3,3
1709,4,7.326209658537417,7.326209658537418,0.9895134838264917,0.9895134838264924,0,0,9.43614387512207,8.826862335205078,4,4
1709,8,6.412511450836575,6.421081043200299,1.0123446535886464,1.0124386296235564,2,2,10.397418022155762,8.826862335205078,6,6
1709,16,5.884559477227253,6.328533980533444,1.016504268791647,1.0151901454715857,3,5,10.634593963623047,8.826862335205078,13,11
1709,32,4.664031309281382,5.5429464052089275,1.0211410281081277,1.0243483213195823,12,21,11.413622856140137,8.826862335205078,20,11
1709,64,3.8193661524929707,5.154057421387763,1.0269344253327541,1.034436257222556,26,51,11.844643592834473,8.826862335205078,38,13
1709,128,2.3277579777176967,5.07428077959721,1.0085017452671625,1.037264364606819,61,108,12.263493537902832,8.826862335205078,67,20
1710,1,5.545416170056511,5.545416170056512,0.9838900498099595,0.9838900498099611,0,0,5.567216396331787,5.567216396331787,1,1
1710,2,5.043261246471374,5.043261246471375,0.9910985047957358,0.9910985047957369,0,0,5.833522319793701,5.567216396331787,2,2
1710,3,3.7217722764486445,3.721772276448644,1.0031000932519565,1.0031000932519571,0,0,5.867751598358154,5.567216396331787,3,3
1710,4,3.2475223157782827,3.2475223157782818,1.0080249172857978,1.0080249172857987,0,0,5.984189987182617,5.567216396331787,4,4
1710,8,2.917425087304333,3.2202328414280337,1.0112597966894894,1.0090353891051012,1,1,6.6019768714904785,5.567216396331787,7,7
1710,16,2.6229202655188484,3.0093240579336094,1.012677159516644,1.012238947500986,5,7,6.94138765335083,5.567216396331787,11,9
1710,32,2.1443929317995742,2.4942119232197033,1.0153214372655421,1.0179648459967858,13,19,7.308086395263672,5.567216396331787,19,13
1710,64,1.7083204126214935,2.484423559598887,1.0117145543421318,1.0186033248981157,31,47,7.834967136383057,5.567216396331787,33,17
1710,128,0.8409176754069122,2.426317078057812,1.0021355210544414,1.0199693301801662,60,112,8.60157585144043,5.567216396331787,68,16
1711,1,7.365308389323942,7.365308389323947,0.9669595576136173,0.9669595576136203,0,0,7.43131685256958,7.43131685256958,1,1
1711,2,6.181259798191194,6.181259798191196,0.9901363815330313,0.9901363815330326,0,0,8.045166015625,7.43131685256958,2,2
1711,3,5.425557423776915,5.425557423776915,1.0017572570778037,1.0017572570778044,0,0,8.576702117919922,7.43131685256958,3,3
1711,4,5.295728305282286,5.295728305282286,1.0019867578559885,1.0019867578559896,0,0,8.688939094543457,7.43131685256958,4,4
1711,8,4.9480845449593875,4.9483750590383675,1.0110055855747937,1.0110447512808562,1,1,9.440642356872559,7.43131685256958,7,7
1711,16,4.307407417338595,4.657570736606542,1.0169654277120705,1.018770845880454,6,7,10.080623626708984,7.43131685256958,10,9
1711,32,3.731958858647177,4.449233380508733,1.0179920307343249,1.0274116395780872,12,19,10.929075241088867,7.43131685256958,20,13
1711,64,2.6648814465051833,4.358682654583034,1.0051414270798418,1.031512775656969,29,50,11.553934097290039,7.43131685256958,35,14
1711,128,1.6133852819359529,4.304249156927913,1.0020238569435505,1.034819981847591,65,111,12.41730785369873,7.43131685256958,63,17
1712,1,10.253676805248181,10.253676805248189,0.9328796796319595,0.932879679631962,0,0,10.441925048828125,10.441925048828125,1,1
1712,2,8.857757539763904,8.857757539763904,0.9689745241962038,0.9689745241962038,0,0,11.114336967468262,10.441925048828125,2,2
1712,3,8.33344159748081,8.333441597480808,0.9811963816280269,0.9811963816280274,0,0,11.181488037109375,10.441925048828125,3,3
1712,4,7.995170928443112,7.995170928443112,0.9923235884646469,0.9923235884646471,0,0,11.998944282531738,10.441925048828125,4,4
1712,8,7.569509002465947,7.584139881884835,1.006003334030535,1.0065833837356066,1,1,13.067225456237793,10.441925048828125,7,7
1712,16,6.934017057260474,7.334214222273675,1.0168041474826697,1.0202095145943022,4,8,13.997737884521484,10.441925048828125,12,8
1712,32,5.200941299860679,6.9897226729449695,1.0176011567586527,1.033120274712694,12,20,14.579739570617676,10.441925048828125,20,12
1712,64,4.130322581926775,6.87714994757532,1.016860185642007,1.0401058334774367,29,49,15.427902221679688,10.441925048828125,35,15
1712,128,2.4919043924734106,6.750148046195493,1.006675412710762,1.0477248631988776,61,111,16.20389747619629,10.441925048828125,67,17
1713,1,9.174542749515759,9.174542749515764,0.954820040583705,0.9548200405837072,0,0,9.271831512451172,9.271831512451172,1,1
1713,2,8.536782084658022,8.536782084658,0.9685774073377196,0.968577407337721,0,0,9.573661804199219,9.271831512451172,2,2
1713,3,7.47206047736878,7.472060477368783,0.9904251173062522,0.9904251173062544,0,0,9.637899398803711,9.271831512451172,3,3
1713,4,7.453009279056487,7.453009279056489,0.9909875731407558,0.9909875731407585,0,0,9.821419715881348,9.271831512451172,4,4
1713,8,7.018734566264427,7.0221454140198745,1.0012993391645126,1.0013678236418542,1,1,9.930362701416016,9.271831512451172,7,7
1713,16,6.029576937218758,6.584895742733778,1.0149232585408667,1.0103883906427509,5,6,10.530084609985352,9.271831512451172,11,10
1713,32,4.756811498306189,5.819014598049049,1.0286615341474086,1.0272718806504169,14,21,11.188962936401367,9.271831512451172,18,11
1713,64,4.064215841925884,5.7273938412064975,1.014752399160665,1.029996141059279,31,53,11.787242889404297,9.271831512451172,33,11
1713,128,2.538684923804029,5.692976097626676,1.0040889459107536,1.0341316785753807,64,114,12.518588066101074,9.271831512451172,64,14
1714,1,6.441024642723421,6.441024642723421,0.9775941049107146,0.9775941049107151,0,0,6.4759907722473145,6.4759907722473145,1,1
1714,2,5.803318307631755,5.803318307631756,0.9870327915672339,0.9870327915672343,0,0,7.703462600708008,6.4759907722473145,2,2
1714,3,5.609331537617993,5.609331537617993,0.9915592684908643,0.991559268490865,0,0,8.504202842712402,6.4759907722473145,3,3
1714,4,5.450490319663057,5.450490319663058,0.9939727221274763,0.9939727221274766,0,0,8.54267406463623,6.4759907722473145,4,4
1714,8,4.896108007285011,4.961503242598281,1.0030777374559707,1.0039415649702872,2,2,9.005427360534668,6.4759907722473145,6,6
1714,16,3.9671947627972326,4.575925981473312,1.0098476184886145,1.0110715624160675,6,11,9.40921401977539,6.4759907722473145,10,5
1714,32,3.5681314090917398,4.5346594024789715,1.0092980033002346,1.0125394419820806,15,24,10.005735397338867,6.4759907722473145,17,8
1714,64,2.7184669409357807,4.449671517925086,1.0094088346976549,1.015776210523744,30,54,10.484847068786621,6.4759907722473145,34,10
1714,128,1.9386555837584938,4.392525498012867,1.004457157109861,1.0189201290664733,63,117,11.11931037902832,6.4759907722473145,65,11
1715,1,2.557653556436609,2.557653556436608,0.9958766395061485,0.995876639506148,0,0,2.560858964920044,2.560858964920044,1,1
1715,2,2.2696695877989512,2.2696695877989512,0.9981165110411443,0.9981165110411436,0,0,2.648106098175049,2.560858964920044,2,2
1715,3,2.1286023210233664,2.1286023210233656,0.998310710417327,0.9983107104173252,0,0,2.751528263092041,2.560858964920044,3,3
1715,4,2.1250340537338435,2.1250340537338435,0.9982251296699228,0.9982251296699212,0,0,2.799436569213867,2.560858964920044,4,4
1715,8,1.4742197070516552,1.518036388554682,1.0022912609949637,1.0017236786785944,3,3,3.0773181915283203,2.560858964920044,5,5
1715,16,1.2440982650277999,1.3305642561157527,1.0027612439580746,1.0024005774965596,5,7,3.483476161956787,2.560858964920044,11,9
1715,32,0.9703424863550865,1.2829802411026516,1.0011368423605436,1.0029373152019623,15,22,3.8050484657287598,2.560858964920044,17,10
1715,64,0.5522100196774535,1.2438879153307612,1.0003215880916265,1.0032266450399523,30,51,4.2178754806518555,2.560858964920044,34,13
1715,128,0.026020579345562435,1.1920024151048718,0.9999923848091312,1.0033001836242836,66,114,4.9199066162109375,2.560858964920044,62,14
1716,1,4.402020430817911,4.402020430817911,0.994287605997539,0.994287605997539,0,0,4.405520915985107,4.405520915985107,1,1
1716,2,3.533606987410683,3.5336069874106837,1.003714000033645,1.0037140000336442,0,0,5.4152350425720215,4.405520915985107,2,2
1716,3,3.1652700499370443,3.165270049937035,1.0079276692816035,1.0079276692816026,0,0,5.4654860496521,4.405520915985107,3,3
1716,4,2.752326236591102,2.752326236591102,1.0091502184294538,1.009150218429454,0,0,5.656360149383545,4.405520915985107,4,4
1716,8,2.5436202384277826,2.717647214595195,1.0092294118100866,1.0095481584346513,2,3,6.116722106933594,4.405520915985107,6,5
1716,16,2.268363853447821,2.665485384020505,1.0081898760333265,1.0106346336733896,5,7,6.467520713806152,4.405520915985107,11,9
1716,32,1.9482406172376652,2.622596267334609,1.0078143317783326,1.0115135149418912,11,22,6.866278648376465,4.405520915985107,21,10
1716,64,1.5788535850163803,2.5421756764467056,1.0048133000546242,1.012875972358251,29,52,7.3183488845825195,4.405520915985107,35,12
1716,128,0.8839286097801501,2.5077093052963457,1.002649235331234,1.0139931412175325,61,114,7.945844650268555,4.405520915985107,67,14
1717,1,11.522087957458202,11.522087957458206,0.9133878779392383,0.9133878779392389,0,0,11.797881126403809,11.797881126403809,1,1
1717,2,10.425275537114565,10.425275537114567,0.9529139240303985,0.9529139240303992,0,0,12.657118797302246,11.797881126403809,2,2
1717,3,9.468536718474658,9.468536718474658,0.9755691297087343,0.9755691297087332,0,0,12.899314880371094,11.797881126403809,3,3
1717,4,9.197775173769129,9.197775173769129,0.9827768135940214,0.9827768135940202,0,0,12.983321189880371,11.797881126403809,4,4
1717,8,8.207599743098912,8.259012467625249,1.0113335311830625,1.0091740488107914,2,3,13.041570663452148,11.797881126403809,6,5
1717,16,7.717209706748552,7.861622120284051,1.0268272714292146,1.0214116708880798,4,6,13.429730415344238,11.797881126403809,12,10
1717,32,7.2422357275207885,7.83220319291754,1.031276435155984,1.0226624958231518,14,20,13.692647933959961,11.797881126403809,18,12
1717,64,6.057557064067393,7.742056434548716,1.0223787863092475,1.0281743250461042,27,50,14.280064582824707,11.797881126403809,37,14
1717,128,3.483111299958733,7.394041731771585,1.0123344458636896,1.0446220942974478,61,110,14.9450044631958,11.797881126403809,67,18
1718,1,11.221279079038483,11.221279079038489,0.9138077273454331,0.9138077273454343,0,0,11.518426895141602,11.518426895141602,1,1
1718,2,9.905135541804633,9.905135541804633,0.9525426161541953,0.9525426161541954,0,0,11.58250904083252,11.518426895141602,2,2
1718,3,8.68049974782805,8.680499747828051,0.9848629747775022,0.984862974777504,0,0,12.261419296264648,11.518426895141602,3,3
1718,4,8.643489228208896,8.643489228208898,0.9872290666596395,0.9872290666596417,0,0,12.739424705505371,11.518426895141602,4,4
1718,8,8.115827277721055,8.124643238108614,1.0021412550892825,1.0025593243753355,2,3,13.299337387084961,11.518426895141602,6,5
1718,16,7.704543009366875,7.955577533974271,1.0098034657547217,1.010338229746031,6,10,13.841365814208984,11.518426895141602,10,6
1718,32,6.520969852206022,7.955577533974271,1.0115244560432823,1.010338229746031,14,26,14.195152282714844,11.518426895141602,18,6
1718,64,4.331689028254701,7.924286081884814,1.0127620962336765,1.0135836384774324,31,55,14.557153701782227,11.518426895141602,33,9
1718,128,3.1213676300718225,7.825040670343257,1.0004327738770082,1.0224576784980157,66,116,14.87989330291748,11.518426895141602,62,12
1719,1,8.219827047879189,8.219827047879189,0.964015179110425,0.9640151791104254,0,0,8.288456916809082,8.288456916809082,1,1
1719,2,6.805534986972972,6.805534986972972,0.9839778504279781,0.9839778504279786,0,0,8.328518867492676,8.288456916809082,2,2
1719,3,6.738440665257827,6.738440665257827,0.9851390586297684,0.9851390586297691,0,0,8.653543472290039,8.288456916809082,3,3
1719,4,6.03610662137372,6.057273575917521,0.9950790755802281,0.9948685598103283,1,1,8.661748886108398,8.288456916809082,3,3
1719,8,5.680747712729916,5.7464899930058735,1.001117497547539,1.000336133142126,2,2,8.885375022888184,8.288456916809082,6,6
1719,16,4.938180250189181,5.102946578955817,1.0105099329283433,1.0089285659064982,6,8,9.60228443145752,8.288456916809082,10,8
1719,32,3.964274519719812,4.548514917218588,1.0157326084592198,1.0217021041532321,13,21,10.087019920349121,8.288456916809082,19,11
1719,64,2.723413909351175,4.327301317423235,1.0133867461153558,1.027475065412418,32,45,10.660137176513672,8.288456916809082,32,19
1719,128,1.4845381886879645,4.297284275641307,1.0036589911805935,1.0292559956294753,57,103,11.409741401672363,8.288456916809082,71,25
1720,1,11.80107258193334,11.801072581933344,0.9128570438891002,0.9128570438891025,0,0,12.087693214416504,12.087693214416504,1,1
1720,2,10.269645820729982,10.269645820729984,0.9641028404943192,0.9641028404943189,0,0,12.93835163116455,12.087693214416504,2,2
1720,3,10.063089274800724,10.063089274800724,0.9701464629154716,0.9701464629154712,0,0,13.373518943786621,12.087693214416504,3,3
1720,4,9.582245420073326,9.582245420073326,0.9826517614373145,0.9826517614373148,0,0,13.448798179626465,12.087693214416504,4,4
1720,8,9.454616849361026,9.473173464375346,0.9883256813184642,0.9883236291106648,2,2,13.996698379516602,12.087693214416504,6,6
1720,16,8.685800144218943,8.961438343784806,1.019571984090977,1.0118619432797906,3,6,14.696493148803711,12.087693214416504,13,10
1720,32,6.905017399386778,8.444492348285603,1.021625449041627,1.0346304628293082,15,21,15.6255521774292,12.087693214416504,17,11
1720,64,4.907697136472454,8.282957881385023,1.0106492591644738,1.0431826295296733,33,51,16.267444610595703,12.087693214416504,31,13
1720,128,3.1801139338440736,8.190215563564609,1.0075840451211007,1.052941054169606,65,113,17.238630294799805,12.087693214416504,63,15
1721,1,7.731446981937334,7.731446981937335,0.9625635536355542,0.9625635536355547,0,0,7.815213203430176,7.815213203430176,1,1
1721,2,7.003267541250681,7.003267541250682,0.9753390187637891,0.9753390187637894,0,0,7.901793479919434,7.815213203430176,2,2
1721,3,6.279584043695426,6.279584043695425,0.9876131630729241,0.9876131630729247,0,0,7.968415260314941,7.815213203430176,3,3
1721,4,6.22348322481825,6.223483224818248,0.988386209728591,0.9883862097285911,0,0,8.039950370788574,7.815213203430176,4,4
1721,8,5.8717050019268395,5.87586294753085,0.9938820185737351,0.9936718652958139,1,1,8.222403526306152,7.815213203430176,7,7
1721,16,4.033656320565045,4.210972719515005,1.0159063502125738,1.0138714313175425,5,6,8.507102966308594,7.815213203430176,11,10
1721,32,3.4299408109760456,4.144321542672392,1.0136236924041926,1.0148860640992838,13,20,8.968809127807617,7.815213203430176,19,12
1721,64,2.4765059334483808,4.033310507110529,1.0102705194690973,1.0172033304118981,30,48,9.318314552307129,7.815213203430176,34,16
1721,128,1.1233073399686637,4.027477218353831,1.0028635704577837,1.0179645417114545,60,108,9.861302375793457,7.815213203430176,68,20
1722,1,8.477829462247945,8.47782946224795,0.9585045119137885,0.9585045119137903,0,0,8.57190227508545,8.57190227508545,1,1
1722,2,7.7409179282464935,7.740917928246495,0.9758119328234371,0.9758119328234385,0,0,10.001688003540039,8.57190227508545,2,2
1722,3,7.652984187490969,7.652984187490969,0.9807783529692814,0.9807783529692811,0,0,10.812126159667969,8.57190227508545,3,3
1722,4,7.379499298466439,7.37949929846644,0.9909914896700006,0.9909914896700015,0,0,11.317845344543457,8.57190227508545,4,4
1722,8,6.438211390585049,6.464512776941255,1.0083090162061954,1.0090954588788803,2,2,11.764961242675781,8.57190227508545,6,6
1722,16,5.801453010046817,6.445326428369326,1.0084417569128272,1.01107183421166,5,7,12.622892379760742,8.57190227508545,11,9
1722,32,5.275842973453758,6.437778589847682,1.0127820721518446,1.012620321344412,14,22,13.491819381713867,8.57190227508545,18,10
1722,64,4.191690752300642,6.099287910716047,1.0145323227433418,1.0272580460197238,26,53,14.57526969909668,8.57190227508545,38,11
1722,128,2.760331952986344,6.052116175747168,1.0064021781107242,1.0339998775332284,68,113,15.512558937072754,8.57190227508545,60,15
1723,1,6.229696625521816,6.22969662552182,0.9817621784731747,0.9817621784731783,0,0,6.253183841705322,6.253183841705322,1,1
1723,2,5.548718554679885,5.548718554679886,0.9920823022913958,0.9920823022913987,0,0,6.991352558135986,6.253183841705322,2,2
1723,3,5.146464622852119,5.146464622852119,0.9995911320441491,0.9995911320441506,0,0,7.5545573234558105,6.253183841705322,3,3
1723,4,4.815387891340038,4.815387891340038,1.0066000424063524,1.0066000424063535,0,0,7.775793552398682,6.253183841705322,4,4
1723,8,3.9510456575162913,3.979958345676473,1.0180592131590869,1.0184313424192277,2,2,8.323785781860352,6.253183841705322,6,6
1723,16,3.635495676310742,3.7123620226236147,1.0230813686665232,1.0240852209364502,3,4,8.586328506469727,6.253183841705322,13,12
1723,32,3.1876004424484763,3.5128854489528565,1.0218018688434416,1.02745428101986,14,17,9.09337329864502,6.253183841705322,18,15
1723,64,2.4632214606455647,3.430544469364805,1.014740606008071,1.030911747010674,32,45,9.937495231628418,6.253183841705322,32,19
1723,128,1.3618042744160703,3.4251397001535544,1.0041820632769745,1.031604981918313,61,107,11.048707962036133,6.253183841705322,67,21
1724,1,7.847372913346814,7.847372913346814,0.9595913522645599,0.9595913522645616,0,0,7.939525604248047,7.939525604248047,1,1
1724,2,7.016691586480521,7.016691586480522,0.9776067171808951,0.9776067171808958,0,0,8.542808532714844,7.939525604248047,2,2
1724,3,6.552765772273788,6.552765772273786,0.9888477893258065,0.9888477893258076,0,0,9.661323547363281,7.939525604248047,3,3
1724,4,5.9397190098645005,5.9397190098645005,0.9999037598343075,0.999903759834308,0,0,9.782499313354492,7.939525604248047,4,4
1724,8,5.426541570868123,5.4822806540943825,1.012319033026933,1.012996061406726,1,1,10.90372085571289,7.939525604248047,7,7
1724,16,5.0533012918143845,5.355472797896974,1.0175548418299232,1.0205829143849015,5,5,11.831597328186035,7.939525604248047,11,11
1724,32,4.029051295279456,5.348074736844628,1.0086969023676544,1.0215104480522323,13,20,12.429353713989258,7.939525604248047,19,12
1724,64,3.158622817973977,5.30955520786097,1.0035203528103636,1.0241911814116493,27,51,13.285922050476074,7.939525604248047,37,13
1724,128,2.2462022071451044,5.302757931521836,1.0047503215731903,1.0251693694918702,62,113,14.30506420135498,7.939525604248047,66,15
1725,1,6.851196528880108,6.85119652888011,0.9777937882931463,0.9777937882931468,0,0,6.884297847747803,6.884297847747803,1,1
1725,2,6.250932637566283,6.250932637566282,0.9853022904302142,0.9853022904302133,0,0,6.9427361488342285,6.884297847747803,2,2
1725,3,5.6883036254459,5.688303625445902,0.9902333811803672,0.9902333811803669,0,0,7.227687835693359,6.884297847747803,3,3
1725,4,5.567328895016469,5.569744369777144,0.9929482353238372,0.9928608805827188,1,1,7.256178855895996,6.884297847747803,3,3
1725,8,5.146077034234119,5.309964895655265,0.9989718423047944,0.9984904459718589,2,3,8.0249605178833,6.884297847747803,6,5
1725,16,4.609259619443017,5.220339940528944,1.0063501305012248,1.0017683490541824,6,9,8.472755432128906,6.884297847747803,10,7
1725,32,3.606162475844939,5.219176523659516,1.003178228682978,1.001944101436494,17,24,8.939937591552734,6.884297847747803,15,8
1725,64,2.5299696979328594,5.043672209464533,1.0034780275093866,1.0055675367615227,31,53,9.78453254699707,6.884297847747803,33,11
1725,128,0.9119304827063646,4.793520279873614,1.0000914136805354,1.0160834792327313,68,116,10.650707244873047,6.884297847747803,60,12
1726,1,7.895889010546999,7.895889010547003,0.9680118801504176,0.9680118801504197,0,0,7.951579570770264,7.951579570770264,1,1
1726,2,5.9334960489199755,5.9334960489199755,1.0012032261398822,1.0012032261398822,0,0,8.552047729492188,7.951579570770264,2,2
1726,3,5.933441313224702,5.9334960489199755,1.0011956755560971,1.0012032261398822,1,1,8.59781265258789,7.951579570770264,2,2
1726,4,5.204547148794041,5.204547165814637,1.0113834095357292,1.0113835486953704,1,1,8.822880744934082,7.951579570770264,3,3
1726,8,4.73787634804862,4.776103429414272,1.0183945289350544,1.0193403525507148,1,1,9.598616600036621,7.951579570770264,7,7
1726,16,4.220760326753212,4.387762115949371,1.025710348243764,1.0275801060084233,4,6,10.283309936523438,7.951579570770264,12,10
1726,32,3.772204640329189,4.243477232921133,1.0260941592116386,1.031504894505205,14,20,10.947693824768066,7.951579570770264,18,12
1726,64,3.067249170785516,4.183420251254804,1.0125774773543146,1.0339381787793274,32,51,11.737238883972168,7.951579570770264,32,13
1726,128,2.1235572518168873,4.160011235453262,1.0044708695664828,1.0353933712278909,61,115,12.372838973999023,7.951579570770264,67,13
1727,1,9.021749354311963,9.021749354311966,0.954736781194168,0.9547367811941693,0,0,9.12315845489502,9.12315845489502,1,1
1727,2,7.819121844008736,7.819121844008737,0.9849391818298687,0.9849391818298691,0,0,10.515326499938965,9.12315845489502,2,2
1727,3,7.501908733794619,7.501908733794619,0.9945183708571306,0.9945183708571307,0,0,11.565028190612793,9.12315845489502,3,3
1727,4,7.002055829575524,7.002055829575523,1.0112609741923713,1.0112609741923726,0,0,11.579604148864746,9.12315845489502,4,4
1727,8,6.347229721931974,6.352953995939393,1.0271303334580677,1.0272212746906175,1,1,12.366388320922852,9.12315845489502,7,7
1727,16,6.103035265466171,6.204989983528021,1.0317281476422615,1.031246367373761,5,7,12.919747352600098,9.12315845489502,11,9
1727,32,5.461226606941506,6.179234228409936,1.0288081653041978,1.0321229307435043,10,20,13.424726486206055,9.12315845489502,22,12
1727,64,3.984959416799066,6.05118423378105,1.0162439397152347,1.0409825565561697,30,50,13.938957214355469,9.12315845489502,34,14
1727,128,2.2250915245612406,6.008266113200005,1.0039022271625877,1.0426548810961305,66,114,14.477617263793945,9.12315845489502,62,14
1728,1,2.1719490021532657,2.1719490021532657,0.9988067732593913,0.998806773259391,0,0,2.172278881072998,2.172278881072998,1,1
1728,2,1.821526140572973,1.8215261405729728,0.9990571015731808,0.9990571015731804,0,0,2.193402051925659,2.172278881072998,2,2
1728,3,1.705976928004036,1.7059769280040362,1.0001758021958724,1.000175802195871,0,0,2.2953431606292725,2.172278881072998,3,3
1728,4,1.3878953587598561,1.3878953587598566,1.0015944452633612,1.0015944452633603,0,0,2.4225144386291504,2.172278881072998,4,4
1728,8,1.2483127120500497,1.275300823828563,1.0027034152954257,1.0027555457203041,1,2,2.724465847015381,2.172278881072998,7,6
1728,16,1.0463766441661557,1.1532764292133864,1.0030967819620171,1.0037595828697004,5,7,2.855503559112549,2.172278881072998,11,9
1728,32,0.7953996567956464,1.1306101847774497,1.0014312802464198,1.0037037494634415,13,20,3.37431263923645,2.172278881072998,19,12
1728,64,0.3234864069843528,1.074261812238334,1.0001020212340548,1.003725089910155,34,51,3.8488378524780273,2.172278881072998,30,13
1728,128,0.012607077274820513,1.0407483536717694,1.0000020425727514,1.0040617141836803,63,114,4.451901435852051,2.172278881072998,65,14
1729,1,4.104733291366946,4.104733291366947,0.9901997779657811,0.9901997779657816,0,0,4.115921497344971,4.115921497344971,1,1
1729,2,3.199130508666363,3.1991305086663626,1.000108468554099,1.0001084685540995,0,0,4.173655033111572,4.115921497344971,2,2
1729,3,2.867741617671587,2.867741617671587,1.0022674082841097,1.00226740828411,0,0,4.248939037322998,4.115921497344971,3,3
1729,4,2.687136061433724,2.687136061433724,1.0031879799764298,1.0031879799764294,0,0,4.297245025634766,4.115921497344971,4,4
1729,8,2.3865100042928518,2.563537306805908,1.0056192228667364,1.0042893169936813,1,2,4.717123031616211,4.115921497344971,7,6
1729,16,2.1563882201182665,2.5284205490710607,1.006063025908826,1.0051249008316343,5,6,4.938379287719727,4.115921497344971,11,10
1729,32,1.7804483592255615,2.4920943450404587,1.0045380359769733,1.006032317984159,12,22,5.392826557159424,4.115921497344971,20,10
1729,64,1.1046922431457504,2.3522847933946145,1.0012914682050917,1.0085534837775683,30,50,5.940342903137207,4.115921497344971,34,14
1729,128,0.26204855443497826,2.3519570332708315,1.0002621205090418,1.0086410230379832,62,113,6.562273979187012,4.115921497344971,66,15
1730,1,9.795939441591326,9.79593944159133,0.9457683449467874,0.9457683449467891,0,0,9.930914878845215,9.930914878845215,1,1
1730,2,7.5496743884218205,7.5496743884218205,0.996643849236186,0.9966438492361875,0,0,10.320590019226074,9.930914878845215,2,2
1730,3,7.345754713790026,7.345754713790026,1.0040029013905298,1.0040029013905305,0,0,10.770323753356934,9.930914878845215,3,3
1730,4,6.477162767348351,6.47716276734835,1.021993254076078,1.0219932540760792,0,0,11.247650146484375,9.930914878845215,4,4
1730,8,6.401081937290674,6.402177264530584,1.0248359308265662,1.024910945476002,2,2,11.8682279586792,9.930914878845215,6,6
1730,16,5.847233305513516,6.197402963329579,1.029174194498048,1.0297596370708197,7,7,12.287296295166016,9.930914878845215,9,9
1730,32,4.890534000126739,6.003219317659026,1.0346931789112523,1.0371716768100285,13,19,12.81076717376709,9.930914878845215,19,13
1730,64,3.4091115295844983,6.0031383647600665,1.01626739885496,1.0372995953808928,34,50,13.412333488464355,9.930914878845215,30,14
1730,128,2.0951811323825122,5.965941699535421,1.0050835629632489,1.0406498801199524,61,114,14.034452438354492,9.930914878845215,67,14
1731,1,10.311059046251012,10.311059046251016,0.926696202152688,0.9266962021526893,0,0,10.536596298217773,10.536596298217773,1,1
1731,2,7.5349876924142745,7.534987692414276,0.9873595353580682,0.9873595353580691,0,0,10.704444885253906,10.536596298217773,2,2
1731,3,6.851051794571294,6.851051794571293,1.0013973543142538,1.0013973543142531,0,0,10.704974174499512,10.536596298217773,3,3
1731,4,6.080339125933648,6.080339125933648,1.0174639822263292,1.0174639822263298,0,0,10.731563568115234,10.536596298217773,4,4
1731,8,5.800054094640993,5.928089352119869,1.020179560959542,1.0194375972261278,2,2,11.16808032989502,10.536596298217773,6,6
1731,16,5.0762230773092165,5.230273425397638,1.03812886634503,1.0376634457305443,6,6,11.600878715515137,10.536596298217773,10,10
1731,32,4.583952972067821,5.063615139905525,1.0434443087339025,1.0441133527337572,13,19,12.364245414733887,10.536596298217773,19,13
1731,64,3.6916520874715464,4.985659077885751,1.0274583768116732,1.0479011223607575,31,50,13.24819278717041,10.536596298217773,33,14
1731,128,2.21791109282517,4.985659077885751,1.0083212775092902,1.0479011223607575,59,114,14.040510177612305,10.536596298217773,69,14
1732,1,10.93535023160999,10.935350231609979,0.9216330037596797,0.9216330037596807,0,0,11.183448791503906,11.183448791503906,1,1
1732,2,9.83292399554011,9.832923995540106,0.943427335527783,0.9434273355277811,0,0,11.279675483703613,11.183448791503906,2,2
1732,3,8.76396410729956,8.763964107299566,0.9689959239781853,0.9689959239781845,0,0,11.3128023147583,11.183448791503906,3,3
1732,4,8.562076512149957,8.562076512149956,0.9734653709514195,0.9734653709514183,0,0,11.38486099243164,11.183448791503906,4,4
1732,8,7.983519473453723,8.053733560345707,0.9886272048934797,0.9867037787392214,3,3,11.859318733215332,11.183448791503906,5,5
1732,16,7.126676164808218,7.550272809749845,1.0082185015993708,1.0044032793090412,7,9,12.420737266540527,11.183448791503906,9,7
1732,32,6.365828589906716,7.187525887635999,1.018262193139258,1.017121502275446,15,22,12.77442741394043,11.183448791503906,17,10
1732,64,4.653170631272294,7.019669598414436,1.012019210252045,1.0258107900865263,30,49,13.232526779174805,11.183448791503906,34,15
1732,128,2.8634338885850186,6.821808928265568,1.0052004896449651,1.032055481577802,64,111,13.706786155700684,11.183448791503906,64,17
1733,1,9.228091310052807,9.22809131005277,0.9406545351884346,0.9406545351884366,0,0,9.392058372497559,9.392058372497559,1,1
1733,2,7.60528283593827,7.605282835938272,0.9814968136586681,0.9814968136586707,0,0,10.428089141845703,9.392058372497559,2,2
1733,3,6.971614862333405,6.971614862333405,0.9984668449955743,0.9984668449955764,0,0,11.136116981506348,9.392058372497559,3,3
1733,4,6.9237144732192615,6.923714473219261,0.9999071407002594,0.9999071407002613,0,0,11.24048900604248,9.392058372497559,4,4
1733,8,6.484811972502456,6.484811972502458,1.017906269331753,1.0179062693317544,0,0,12.225530624389648,9.392058372497559,8,8
1733,16,6.340004401537522,6.42885259779946,1.018180801114825,1.021506066524989,5,4,12.804134368896484,9.392058372497559,11,12
1733,32,5.802557602644513,6.270809568136707,1.016288365681781,1.0282612533747493,16,16,13.648577690124512,9.392058372497559,16,16
1733,64,3.82019404694085,6.1437927589505,1.011050142738287,1.0339022907330402,34,48,14.823223114013672,9.392058372497559,30,16
1733,128,2.728101157342926,5.9970446685633885,1.0047490554795782,1.0418020581844785,61,111,15.94676685333252,9.392058372497559,67,17
1734,1,10.521162593008347,10.521162593008352,0.9352745781464546,0.9352745781464564,0,0,10.697820663452148,10.697820663452148,1,1
1734,2,9.40279888573948,9.402798885739486,0.9649757849931145,0.9649757849931166,0,0,11.782459259033203,10.697820663452148,2,2
1734,3,9.337757248014247,9.337757248014249,0.9684511829458733,0.9684511829458743,0,0,12.082758903503418,10.697820663452148,3,3
1734,4,9.18746875578207,9.187468755782074,0.9727465447578829,0.9727465447578846,0,0,12.11958122253418,10.697820663452148,4,4
1734,8,8.788127629687985,8.798658485142369,0.9875027737834055,0.9872256130445081,1,1,12.805825233459473,10.697820663452148,7,7
1734,16,8.223773692499242,8.640652041950373,0.9970677427490389,0.994675061290817,6,7,13.515490531921387,10.697820663452148,10,9
1734,32,6.334822523860938,8.360659337991953,1.0061232589110563,1.0062757044215471,13,21,13.968985557556152,10.697820663452148,19,11
1734,64,4.740434700686898,7.696754979680393,1.0171901176486198,1.034052122889632,27,53,14.626925468444824,10.697820663452148,37,11
1734,128,2.9065313315550534,7.511173531680124,1.00535664927244,1.0421330927044417,63,114,15.313558578491211,10.697820663452148,65,14
1735,1,7.1568772495288275,7.156877249528826,0.965623436884498,0.9656234368844976,0,0,7.232393741607666,7.232393741607666,1,1
1735,2,6.425435207869528,6.425435207869526,0.9770481341717285,0.9770481341717279,0,0,7.443658351898193,7.232393741607666,2,2
1735,3,6.035769178484968,6.035769178484967,0.9846209499501036,0.9846209499501029,0,0,7.796721458435059,7.232393741607666,3,3
1735,4,5.879056839726158,5.879056839726158,0.9873531928508902,0.9873531928508893,0,0,7.899364948272705,7.232393741607666,4,4
1735,8,5.102090334291599,5.123686848164782,1.0016976826378365,1.000902271541943,1,1,8.132587432861328,7.232393741607666,7,7
1735,16,4.724318973491738,4.9994093477587445,1.0080126414535688,1.0047867559095138,4,6,8.622296333312988,7.232393741607666,12,10
1735,32,4.08545409549669,4.766340720429007,1.0066902232655957,1.008441815221914,14,19,9.140392303466797,7.232393741607666,18,13
1735,64,3.029142247989656,4.568249723197628,1.004573971782174,1.014701930078157,29,49,9.545936584472656,7.232393741607666,35,15
1735,128,1.5341127171901388,4.516458661115769,1.003214033228474,1.01638527619101,63,112,10.059611320495605,7.232393741607666,65,16
1736,1,2.760223903309738,2.760223903309721,0.9964815618695781,0.9964815618695803,0,0,2.7623817920684814,2.7623817920684814,1,1
1736,2,2.1028301475766944,2.1028301475766944,1.0001320683753598,1.0001320683753614,0,0,3.068650960922241,2.7623817920684814,2,2
1736,3,2.0232243614022027,2.0232243614022027,1.0011250465531583,1.00112504655316,0,0,3.163818836212158,2.7623817920684814,3,3
1736,4,1.958005383988413,1.9580053839884124,1.001459337687998,1.0014593376879994,0,0,3.2924647331237793,2.7623817920684814,4,4
1736,8,1.8636509865274646,1.899576207589694,1.0021773088112615,1.0022431610026628,1,1,3.6946372985839844,2.7623817920684814,7,7
1736,16,1.5074336205230288,1.7314214951819569,1.0031875123291054,1.0042620685696162,5,8,3.843808650970459,2.7623817920684814,11,8
1736,32,1.2013454013287843,1.7242772840321894,1.002315416669233,1.0043224740879806,12,22,4.132699966430664,2.7623817920684814,20,10
1736,64,0.39608735632022585,1.6777767453297439,1.0008021976476495,1.0047025051419294,26,53,4.411509037017822,2.7623817920684814,38,11
1736,128,0.017748261934286826,1.651707391375427,1.0000052668044046,1.0052007415666195,62,115,4.851773262023926,2.7623817920684814,66,13
1737,1,13.264193411708474,13.26419341170848,0.8963827842711402,0.8963827842711413,0,0,13.626508712768555,13.626508712768555,1,1
1737,2,11.18570193232632,11.185701932326307,0.9630148874078979,0.9630148874078991,0,0,13.906089782714844,13.626508712768555,2,2
1737,3,10.236543843339403,10.236543843339401,0.9993273281660437,0.999327328166044,0,0,14.573321342468262,13.626508712768555,3,3
1737,4,10.193823255288077,10.193823255288077,1.001672529291843,1.0016725292918425,0,0,14.708622932434082,13.626508712768555,4,4
1737,8,9.878140569823177,10.067864354139976,1.0103783631186145,1.007825369435137,2,2,15.26960563659668,13.626508712768555,6,6
1737,16,9.067897528893559,9.733923334167352,1.0270229314944945,1.0209584016483073,7,8,16.06022071838379,13.626508712768555,9,8
1737,32,7.291813084518339,9.264526357796411,1.043699392228818,1.0407242302941895,13,21,16.444982528686523,13.626508712768555,19,11
1737,64,5.934044875990037,9.09027850819797,1.0405661830520754,1.0514712058155575,33,49,17.019094467163086,13.626508712768555,31,15
1737,128,3.69671043483936,8.746452645006961,1.0181570546193535,1.0662421142780265,63,115,17.645959854125977,13.626508712768555,65,13
1738,1,6.55756083922488,6.557560839224882,0.9805386964652609,0.9805386964652641,0,0,6.583308696746826,6.583308696746826,1,1
1738,2,5.091968672460022,5.091968672460023,0.9986448085778815,0.9986448085778828,0,0,6.828811168670654,6.583308696746826,2,2
1738,3,4.430882892169669,4.430882892169668,1.005228373674584,1.0052283736745853,0,0,7.2033209800720215,6.583308696746826,3,3
1738,4,4.388035240702638,4.388035240702637,1.0055624143131814,1.0055624143131827,0,0,7.351934432983398,6.583308696746826,4,4
1738,8,4.227410111486035,4.227410111486035,1.0100409469144065,1.0100409469144063,0,0,8.095597267150879,6.583308696746826,8,8
1738,16,4.04972922733231,4.092407389342661,1.012747243376456,1.0136640319629857,4,4,8.745387077331543,6.583308696746826,12,12
1738,32,3.3214404093926926,3.937882600190199,1.0122263694154545,1.0178513359614056,13,20,9.486739158630371,6.583308696746826,19,12
1738,64,2.5204344729723687,3.8625118504573432,1.0086759088624406,1.0200309919353434,30,48,10.102394104003906,6.583308696746826,34,16
1738,128,1.46255519264726,3.8602528780974255,1.0030119468500458,1.0203810408712326,64,110,10.879484176635742,6.583308696746826,64,18
1739,1,6.674768129026148,6.6747681290261545,0.971926679432522,0.9719266794325248,0,0,6.727460861206055,6.727460861206055,1,1
1739,2,5.436079134840163,5.4360791348401545,0.9946568459456251,0.9946568459456278,0,0,7.556491851806641,6.727460861206055,2,2
1739,3,4.691754226877795,4.691754226877801,1.0058223745051786,1.0058223745051809,0,0,7.607045650482178,6.727460861206055,3,3
1739,4,4.395204047647158,4.395204047647173,1.0101770213959316,1.0101770213959333,0,0,7.73025369644165,6.727460861206055,4,4
1739,8,3.9950188153462247,4.23435606907442,1.012394106968978,1.0132763704359764,2,2,8.13929557800293,6.727460861206055,6,6
1739,16,3.7368931079594967,4.1573303799859005,1.0143432232083607,1.015261306221575,5,6,8.591767311096191,6.727460861206055,11,10
1739,32,3.0954269276562876,3.774952550151063,1.017037467019997,1.02373739571459,11,20,9.00471019744873,6.727460861206055,21,12
1739,64,2.4501977711000262,3.6710829194706602,1.0115257422035668,1.0272288722072251,28,45,9.614208221435547,6.727460861206055,36,19
1739,128,1.4297021443770888,3.6386113013958616,1.0043985049513064,1.0289657166347657,63,107,10.624954223632812,6.727460861206055,65,21
1740,1,11.316919395270334,11.31691939527034,0.9272214438002467,0.9272214438002484,0,0,11.52099895477295,11.52099895477295,1,1
1740,2,10.625331816721609,10.62533181672161,0.9452476187452568,0.9452476187452568,0,0,11.911113739013672,11.52099895477295,2,2
1740,3,9.65012024178183,9.650120241781828,0.9677051028681314,0.9677051028681304,0,0,11.950318336486816,11.52099895477295,3,3
1740,4,8.494614636567045,8.494614636567043,0.9977320608408987,0.9977320608408987,0,0,11.98769760131836,11.52099895477295,4,4
1740,8,7.818906502667794,7.832817542757056,1.0143067738511884,1.0133838824258778,1,1,12.812102317810059,11.52099895477295,7,7
1740,16,7.202466337985723,7.422964116846189,1.0198329657759544,1.0221430064724013,5,6,13.13720989227295,11.52099895477295,11,10
1740,32,6.121270092946885,6.8828469223819715,1.0339941492201348,1.0359455922678644,15,19,13.56905746459961,11.52099895477295,17,13
1740,64,4.858552505835935,6.635864419565139,1.0275426147446907,1.0425870328109867,29,50,13.9843168258667,11.52099895477295,35,14
1740,128,2.856125842843883,6.467686262148021,1.0114243065341486,1.048136772503868,61,113,14.515871047973633,11.52099895477295,67,15
1741,1,5.137495345172883,5.1374953451728835,0.9872899019761918,0.9872899019761926,0,0,5.152174949645996,5.152174949645996,1,1
1741,2,4.463466988281482,4.463466988281482,0.996570235072225,0.996570235072225,0,0,6.8494553565979,5.152174949645996,2,2
1741,3,4.420585821344095,4.420585821344095,0.9981160940243687,0.9981160940243684,0,0,6.993500232696533,5.152174949645996,3,3
1741,4,4.362293352589788,4.362293352589788,0.9997799460196687,0.9997799460196688,0,0,7.341869354248047,5.152174949645996,4,4
1741,8,3.6986079962695375,3.8443229294705707,1.0088102410108564,1.0096305781059023,3,3,7.60469913482666,5.152174949645996,5,5
1741,16,2.9812799552645552,3.4900324976527344,1.012911507617076,1.0140103814631836,7,8,8.24290657043457,5.152174949645996,9,8
1741,32,2.5710199246197765,3.3757179553864813,1.0120695183179604,1.014965971612087,17,23,8.685988426208496,5.152174949645996,15,9
1741,64,1.8745941182638943,3.3509346072965056,1.0036239642156608,1.0167471270893387,29,52,9.110945701599121,5.152174949645996,35,12
1741,128,0.8614685223937544,3.326832328631992,1.0014175667393332,1.0173883782917459,60,113,9.528910636901855,5.152174949645996,68,15
1742,1,8.046038850639608,8.046038850639608,0.9552639835896523,0.9552639835896525,0,0,8.158391952514648,8.158391952514648,1,1
1742,2,7.752501889070107,7.752501889070105,0.9635674218443326,0.9635674218443322,0,0,8.35401725769043,8.158391952514648,2,2
1742,3,6.585347176709465,6.5853471767094645,0.9827384589752532,0.9827384589752513,0,0,8.391777038574219,8.158391952514648,3,3
1742,4,5.852498098532492,5.855463003723559,0.9941763971148226,0.9939010470108627,1,1,8.810240745544434,8.158391952514648,3,3
1742,8,5.0439724026848065,5.052100632451268,1.0109681425516617,1.0107049693211982,3,3,8.953742027282715,8.158391952514648,5,5
1742,16,4.704292984469828,4.891259533631203,1.012849381366279,1.0124484134390128,4,6,9.355751991271973,8.158391952514648,12,10
1742,32,4.083620753598025,4.709595365781342,1.013209390529709,1.0172303308347035,14,22,9.883111000061035,8.158391952514648,18,10
1742,64,2.593822828812461,4.573138558267323,1.0063735545073667,1.0226981995532483,31,48,10.632335662841797,8.158391952514648,33,16
1742,128,1.5326938024884509,4.448475427036093,1.0019021825991548,1.0288540880732984,57,109,11.347367286682129,8.158391952514648,71,19
1743,1,6.336839050922813,6.336839050922814,0.9750285521304397,0.9750285521304399,0,0,6.381248950958252,6.381248950958252,1,1
1743,2,5.447650592963471,5.44765059296347,0.9880353536411104,0.9880353536411096,0,0,6.766592502593994,6.381248950958252,2,2
1743,3,5.087757348309423,5.087757348309422,0.9943865819951456,0.9943865819951458,0,0,7.138730525970459,6.381248950958252,3,3
1743,4,4.814705362153329,4.815018450432168,0.9994004041251923,0.9993432005099818,1,1,7.422366142272949,6.381248950958252,3,3
1743,8,4.596708608000997,4.599412739621032,1.0031260462653997,1.002937021579281,1,1,7.745632648468018,6.381248950958252,7,7
1743,16,3.9465482130064005,4.061139462930212,1.0106329533688927,1.0103652089770359,6,7,8.179905891418457,6.381248950958252,10,9
1743,32,3.4621269526946774,3.8747341811597185,1.015016624163552,1.0162470791088887,15,20,8.769265174865723,6.381248950958252,17,12
1743,64,2.393131384743708,3.6051711327922797,1.0094696880965714,1.0221894901568558,30,51,9.30916976928711,6.381248950958252,34,13
1743,128,1.2297316396653255,3.5496628117010083,1.0022238275597908,1.0234509231548072,64,111,9.973416328430176,6.381248950958252,64,17
1744,1,7.638861968822081,7.63886196882208,0.9643180914689016,0.9643180914689027,0,0,7.713715076446533,7.713715076446533,1,1
1744,2,6.544271366819752,6.54427136681975,0.981245733636742,0.9812457336367423,0,0,7.843844413757324,7.713715076446533,2,2
1744,3,5.388746591402941,5.388746591402942,1.000509116108321,1.0005091161083204,0,0,8.010696411132812,7.713715076446533,3,3
1744,4,5.127608034675758,5.127608034675758,1.0055364261436754,1.0055364261436763,0,0,8.641874313354492,7.713715076446533,4,4
1744,8,4.639772425581871,4.731945279797846,1.0104586430030293,1.0118710979485832,2,2,9.17377758026123,7.713715076446533,6,6
1744,16,4.389082024490847,4.655332642387018,1.0103222078916532,1.0134518798506957,6,8,9.561012268066406,7.713715076446533,10,8
1744,32,3.8962674696876274,4.463199871321989,1.0164546117186555,1.019302487467539,12,19,10.187681198120117,7.713715076446533,20,13
1744,64,2.7570650504499126,4.423043344966562,1.0039851369392347,1.0206006381427652,31,50,10.835016250610352,7.713715076446533,33,14
1744,128,1.6178973168551658,4.41885123321751,1.0042323298820537,1.0218252873397424,63,112,11.667763710021973,7.713715076446533,65,16
1745,1,5.531399988234801,5.531399988234801,0.9842976166294718,0.9842976166294727,0,0,5.551651954650879,5.551651954650879,1,1
1745,2,4.125066584896506,4.125066584896506,0.9993252245539779,0.9993252245539783,0,0,6.096912860870361,5.551651954650879,2,2
1745,3,3.840943867326617,3.8409438673266165,1.0006450227352488,1.0006450227352472,0,0,6.360461711883545,5.551651954650879,3,3
1745,4,3.62229141934002,3.622291419340021,1.0046929569949297,1.004692956994929,0,0,6.649008750915527,5.551651954650879,4,4
1745,8,3.2154238264366635,3.2369086168481456,1.0104520956001561,1.0110319916118935,1,1,7.086151123046875,5.551651954650879,7,7
1745,16,2.633740445415845,2.979397555756866,1.010777704066596,1.013843961708237,5,6,7.553524017333984,5.551651954650879,11,10
1745,32,2.3491209244756557,2.9665455217769705,1.0093825860312937,1.0143458819447924,14,18,8.073604583740234,5.551651954650879,18,14
1745,64,1.8899552795165586,2.8842831296623848,1.0040885595234672,1.0158915521094665,28,52,8.923225402832031,5.551651954650879,36,12
1745,128,0.8807739397313742,2.8736022725567616,1.00051383980444,1.016009258502213,64,114,9.351862907409668,5.551651954650879,64,14
1746,1,8.266024713100016,8.266024713100016,0.9593827804409479,0.959382780440949,0,0,8.355316162109375,8.355316162109375,1,1
1746,2,7.4578904014491805,7.4578904014491805,0.9784473579566745,0.9784473579566747,0,0,9.095385551452637,8.355316162109375,2,2
1746,3,7.266570418865281,7.266570418865282,0.98591752210771,0.9859175221077094,0,0,9.89787483215332,8.355316162109375,3,3
1746,4,6.3186542027854,6.322870119387011,1.0040870093959655,1.004434651904007,1,1,10.282516479492188,8.355316162109375,3,3
1746,8,6.062325987190795,6.097135226976364,1.0112417593311256,1.0129374524842236,3,3,11.570881843566895,8.355316162109375,5,5
1746,16,5.617977234556618,6.097135226976364,1.0075417514197846,1.0129374524842236,8,11,12.278338432312012,8.355316162109375,8,5
1746,32,4.890200263520263,5.989331578552774,1.0133411533978745,1.019793072603272,12,23,12.927863121032715,8.355316162109375,20,9
1746,64,3.77322512516993,5.5265019905025055,1.00731700235145,1.0292302791830297,31,56,13.653739929199219,8.355316162109375,33,8
1746,128,2.2333611104873348,5.451291037490233,1.0055383561890778,1.0369724550796005,64,114,14.40413761138916,8.355316162109375,64,14
1747,1,10.891376376330813,10.891376376330754,0.930778467149631,0.9307784671496337,0,0,11.090282440185547,11.090282440185547,1,1
1747,2,9.342618982058543,9.342618982058543,0.9668953224551975,0.9668953224551977,0,0,11.5671968460083,11.090282440185547,2,2
1747,3,8.307503944598743,8.307503944598743,0.991078536726772,0.9910785367267716,0,0,11.593417167663574,11.090282440185547,3,3
1747,4,8.282945877198587,8.282945877198589,0.9920890527529013,0.992089052752901,0,0,11.855537414550781,11.090282440185547,4,4
1747,8,7.956080237598041,7.989439140386948,0.9991075603898772,0.9989581228897451,2,2,12.168270111083984,11.090282440185547,6,6
1747,16,6.884080194342,7.056988433597012,1.0273241506777198,1.025005401543001,3,7,12.699814796447754,11.090282440185547,13,9
1747,32,6.002686994945742,6.831992140916628,1.0291162341686315,1.0328998341423405,14,20,13.308887481689453,11.090282440185547,18,12
1747,64,4.81707894181391,6.790097007310027,1.0259561909548145,1.0354423694187271,29,49,13.902833938598633,11.090282440185547,35,15
1747,128,2.633520278614243,6.773410716808362,1.0044901078856592,1.0375413103678306,69,107,14.538528442382812,11.090282440185547,59,21
1748,1,14.421840952572559,14.421840952572559,0.8778876860592015,0.8778876860592024,0,0,14.882059097290039,14.882059097290039,1,1
1748,2,11.486548431796376,11.486548431796376,0.9791999809587922,0.9791999809587923,0,0,15.026299476623535,14.882059097290039,2,2
1748,3,11.177324055490265,11.177324055490264,0.9906986098032862,0.9906986098032861,0,0,15.338651657104492,14.882059097290039,3,3
1748,4,11.115323417157864,11.115323417157867,0.9943996751101956,0.9943996751101947,0,0,15.366991996765137,14.882059097290039,4,4
1748,8,10.775023608795378,10.775023608795378,1.0108866177750424,1.0108866177750424,0,0,15.747936248779297,14.882059097290039,8,8
1748,16,9.46577696198522,9.63020469745016,1.0484063595090427,1.0450400971413445,8,9,16.09402847290039,14.882059097290039,8,7
1748,32,8.111688632662732,8.864039791101407,1.0682485868455662,1.0674101939088383,13,20,16.7369384765625,14.882059097290039,19,12
1748,64,6.3113021170444785,8.778283597674534,1.0447405511901575,1.069904777195465,29,49,17.39897918701172,14.882059097290039,35,15
1748,128,4.133364964114951,8.727255137117595,1.0283090184707007,1.0742771679569685,57,112,18.117589950561523,14.882059097290039,71,16
1749,1,6.573273133963303,6.573273133963286,0.9723589914848878,0.9723589914848896,0,0,6.624557971954346,6.624557971954346,1,1
1749,2,6.442784212460235,6.442784212460238,0.9790654836162573,0.9790654836162587,0,0,10.849515914916992,6.624557971954346,2,2
1749,3,6.411112286438953,6.411112286438954,0.9823961452167883,0.9823961452167899,0,0,11.510907173156738,6.624557971954346,3,3
1749,4,6.393656147427247,6.393656147427249,0.9836645540200609,0.9836645540200615,0,0,11.814496994018555,6.624557971954346,4,4
1749,8,6.027653451183027,6.073739954052936,0.9965653732852795,0.9967440696034247,3,3,12.520021438598633,6.624557971954346,5,5
1749,16,5.382636165077007,6.030459080008999,1.0023516737043558,1.0020967898485675,7,9,13.286124229431152,6.624557971954346,9,7
1749,32,4.7810817877763485,5.95764507505606,1.0037286026516223,1.0073402049627949,15,24,14.060139656066895,6.624557971954346,17,8
1749,64,3.462848656184539,5.8309929705460295,0.9985960279780519,1.0147960808610526,37,52,14.880117416381836,6.624557971954346,27,12
1749,128,2.273535010526719,5.7539310851676655,1.005033056145762,1.01964350323447,62,116,15.775235176086426,6.624557971954346,66,12
1750,1,8.345143766961383,8.345143766961383,0.9647632181918611,0.9647632181918616,0,0,8.412062644958496,8.412062644958496,1,1
1750,2,6.986880940153488,6.986880940153489,0.9925070441683093,0.9925070441683086,0,0,9.14367389678955,8.412062644958496,2,2
1750,3,6.904132916472821,6.904132916472819,0.99487611977692,0.9948761197769193,0,0,9.22931957244873,8.412062644958496,3,3
1750,4,6.378088246297373,6.378088246297373,0.9980540104043334,0.9980540104043328,0,0,9.408269882202148,8.412062644958496,4,4
1750,8,5.517002885789988,5.517002885789988,1.0130610521411219,1.013061052141123,0,0,9.695052146911621,8.412062644958496,8,8
1750,16,5.189755751564684,5.260978173729092,1.0192479726061139,1.0201257050472283,5,5,10.305887222290039,8.412062644958496,11,11
1750,32,4.583922318842055,5.251081414316577,1.017108991326908,1.0208720417547221,11,18,10.822067260742188,8.412062644958496,21,14
1750,64,3.861058925224686,5.163752179374575,1.0131368571864383,1.023093339870051,32,50,11.113333702087402,8.412062644958496,32,14
1750,128,2.4202678778025284,5.142533585266534,1.0044871905915285,1.0249416631952282,64,112,11.422079086303711,8.412062644958496,64,16
1751,1,10.809899691464413,10.809899691464418,0.9370448989666609,0.9370448989666628,0,0,10.972540855407715,10.972540855407715,1,1
1751,2,9.003370976160559,9.00337097616056,0.9767592759766295,0.9767592759766299,0,0,10.986485481262207,10.972540855407715,2,2
1751,3,8.972031366259117,8.972031366259118,0.9769121013424972,0.9769121013424993,0,0,11.075255393981934,10.972540855407715,3,3
1751,4,8.740465894611196,8.740465894611196,0.983123437959171,0.9831234379591733,0,0,11.149940490722656,10.972540855407715,4,4
1751,8,8.223594255614008,8.250877092154711,0.9927491022548716,0.992051978785756,2,3,11.614598274230957,10.972540855407715,6,5
1751,16,6.4647797875032476,7.128994903108135,1.0224936934874205,1.0155725520919636,6,9,11.855376243591309,10.972540855407715,10,7
1751,32,6.04762105618354,7.119606534471889,1.0218182202337152,1.0158482852905157,15,24,12.389878273010254,10.972540855407715,17,8
1751,64,4.382305084340593,6.995292868163288,1.01592478496491,1.020456714340082,28,54,12.989789009094238,10.972540855407715,36,10
1751,128,2.5555584369607045,6.39045671449354,1.0108540285524594,1.0393727807726436,61,115,13.516510009765625,10.972540855407715,67,13
1752,1,6.246814312568945,6.246814312568948,0.9792232787904385,0.9792232787904397,0,0,6.2779998779296875,6.2779998779296875,1,1
1752,2,5.377550278704591,5.377550278704591,0.9925528094899552,0.9925528094899561,0,0,6.771668434143066,6.2779998779296875,2,2
1752,3,5.355110939351142,5.3551109393511425,0.9935712827040393,0.9935712827040404,0,0,8.05586051940918,6.2779998779296875,3,3
1752,4,5.12397553890344,5.12397553890344,0.997644853416228,0.9976448534162281,0,0,8.093924522399902,6.2779998779296875,4,4
1752,8,4.683139717874289,4.7915448169804264,1.0061209995000473,1.0052660338624002,2,2,8.73416519165039,6.2779998779296875,6,6
1752,16,3.8605101721462356,4.328019928584123,1.0181841698792296,1.0161297205119335,7,8,9.362733840942383,6.2779998779296875,9,8
1752,32,3.166624519189336,4.058716453102884,1.0192095003923474,1.0237410892722785,12,19,10.084830284118652,6.2779998779296875,20,13
1752,64,2.4641103456759863,3.8656006586416116,1.0129329252432488,1.028246960434761,33,45,10.62236499786377,6.2779998779296875,31,19
1752,128,1.3943519549242525,3.8076567749914054,1.0030865416424017,1.030429794739171,60,106,11.272093772888184,6.2779998779296875,68,22
1753,1,2.053524013423195,2.0535240134231962,0.996938835040978,0.99693883504098,0,0,2.055734395980835,2.055734395980835,1,1
1753,2,1.9583882433135908,1.9583882433135915,0.9973305519260363,0.9973305519260373,0,0,2.3641560077667236,2.055734395980835,2,2
1753,3,1.4342520339032379,1.434252033903238,0.9998327297350091,0.9998327297350098,0,0,2.386653184890747,2.055734395980835,3,3
1753,4,1.1956020558730645,1.2221403792106493,1.0008614675084475,1.0007010115090702,1,1,2.4612908363342285,2.055734395980835,3,3
1753,8,1.0327966448618195,1.086643108815301,1.0016564456380381,1.001485343629302,2,1,2.834588050842285,2.055734395980835,6,7
1753,16,0.8394265835841651,1.0023405708971571,1.001659411415509,1.0020541147580895,5,8,3.1651570796966553,2.055734395980835,11,8
1753,32,0.6450134549061265,0.9528159441788535,1.0014089116594866,1.0028921974721121,14,19,3.6633460521698,2.055734395980835,18,13
1753,64,0.3090525237129184,0.9058355475623926,1.000365356369757,1.0028643831260622,28,50,4.058091640472412,2.055734395980835,36,14
1753,128,0.01647042084283509,0.8671633915590202,0.999984452410128,1.0032672919997467,60,111,4.657562255859375,2.055734395980835,68,17
1754,1,11.183630535650247,11.183630535650245,0.8988363186711854,0.8988363186711852,0,0,11.607917785644531,11.607917785644531,1,1
1754,2,10.1436753258674,10.143675325867397,0.9278253505419213,0.9278253505419203,0,0,11.775877952575684,11.607917785644531,2,2
1754,3,9.786269594059423,9.786269594059423,0.9418248799436553,0.9418248799436557,0,0,12.171566009521484,11.607917785644531,3,3
1754,4,9.770301022196938,9.77030102219694,0.9425116399991765,0.9425116399991766,0,0,12.274469375610352,11.607917785644531,4,4
1754,8,9.641403109893448,9.76797613171968,0.945271707165563,0.9427783099880488,2,3,12.499007225036621,11.607917785644531,6,5
1754,16,8.958630294163582,9.304539995973073,0.9615161277308821,0.9568725873483768,7,12,12.637605667114258,11.607917785644531,9,4
1754,32,7.917648169216491,8.497611553132652,0.9887960241860074,0.9828659722674864,13,25,12.817498207092285,11.607917785644531,19,7
1754,64,6.458270066037714,8.226320693822329,0.9995872420603842,0.9910412250014107,35,57,12.985787391662598,11.607917785644531,29,7
1754,128,3.808840185114409,7.372932407240439,1.007382061855715,1.0114524261214795,64,119,13.198381423950195,11.607917785644531,64,9
1755,1,8.799631453604736,8.799631453604741,0.9552209038470101,0.955220903847013,0,0,8.90087890625,8.90087890625,1,1
1755,2,6.578689990811089,6.578689990811089,0.994768224151814,0.994768224151815,0,0,9.732150077819824,8.90087890625,2,2
1755,3,6.35448695257221,6.35448695257221,1.000040874939281,1.0000408749392822,0,0,9.927655220031738,8.90087890625,3,3
1755,4,6.20079236315653,6.200792363156529,1.0032947545499442,1.003294754549946,0,0,9.929369926452637,8.90087890625,4,4
1755,8,5.338042866796397,5.346900058893076,1.024789514634258,1.0248961836086372,1,1,10.506463050842285,8.90087890625,7,7
1755,16,4.7933913554524565,5.1360432232116615,1.028017087758763,1.0285101286123883,4,6,11.219315528869629,8.90087890625,12,10
1755,32,4.352879236302325,5.030598459578697,1.0268549905997137,1.0332210172236067,12,17,11.84941577911377,8.90087890625,20,15
1755,64,3.072984058327617,4.955616498791928,1.019912879529215,1.038058916888615,29,46,12.658257484436035,8.90087890625,35,18
1755,128,2.0655539301031323,4.899773933592689,1.0067808041547832,1.0424841483077256,65,108,13.433666229248047,8.90087890625,63,20
1756,1,8.866160798561602,8.866160798561602,0.9475360553111588,0.9475360553111585,0,0,9.003424644470215,9.003424644470215,1,1
1756,2,7.8069705754545025,7.8069705754545025,0.969268596262979,0.9692685962629783,0,0,9.680275917053223,9.003424644470215,2,2
1756,3,7.19416114670204,7.19416114670204,0.9838425622652072,0.9838425622652052,0,0,9.875234603881836,9.003424644470215,3,3
1756,4,6.391101667229858,6.391101667229858,0.9995712404729011,0.9995712404729002,0,0,9.917081832885742,9.003424644470215,4,4
1756,8,6.172724306163336,6.175593282790896,1.004792283003359,1.0048274043031504,1,1,10.068686485290527,9.003424644470215,7,7
1756,16,5.468253033132309,5.506948320881158,1.0197582202995186,1.0193756563626897,6,7,10.570124626159668,9.003424644470215,10,9
1756,32,4.837114414612498,5.42770364404281,1.0180969229859662,1.021962462348722,13,19,10.975817680358887,9.003424644470215,19,13
1756,64,3.761529634004078,5.234429061660511,1.0107282456356392,1.0210195552816361,28,46,11.510102272033691,9.003424644470215,36,18
1756,128,2.237946345082712,5.222118145305298,1.007070551090229,1.0225496285999685,62,108,12.095966339111328,9.003424644470215,66,20
1757,1,6.045881302781525,6.045881302781526,0.9847443756855555,0.9847443756855561,0,0,6.0629425048828125,6.0629425048828125,1,1
1757,2,5.279502068672927,5.279502068672927,0.9923279860347181,0.9923279860347183,0,0,6.176373481750488,6.0629425048828125,2,2
1757,3,4.583558802021992,4.583558802021993,1.0012636334054996,1.0012636334054994,0,0,6.893678188323975,6.0629425048828125,3,3
1757,4,4.069941735487041,4.069941735487041,1.0073440100471815,1.0073440100471813,0,0,7.097753047943115,6.0629425048828125,4,4
1757,8,3.5978614323179614,3.7183584486928085,1.0131263867694602,1.0121822678486754,1,1,7.554553985595703,6.0629425048828125,7,7
1757,16,3.3068330486337247,3.5307488382637224,1.0166449460185731,1.0171237034335643,5,6,8.46072006225586,6.0629425048828125,11,10
1757,32,2.7233171106714047,3.326308006815433,1.011791368560819,1.0217805375332307,14,21,9.562634468078613,6.0629425048828125,18,11
1757,64,2.0625476521333,3.324757874883264,1.0040872261568912,1.0221245484943862,32,51,10.933196067810059,6.0629425048828125,32,13
1757,128,1.1919236381674243,3.3153942590355285,1.0023755542278536,1.0230051941791394,63,115,12.246070861816406,6.0629425048828125,65,13
1758,1,14.083518486305088,14.083518486305094,0.8639489400685101,0.8639489400685116,0,0,14.635664939880371,14.635664939880371,1,1
1758,2,12.518574572383853,12.518574572383857,0.9251942484011546,0.925194248401156,0,0,15.315924644470215,14.635664939880371,2,2
1758,3,12.38382598548536,12.38382598548536,0.9318783657976597,0.9318783657976601,0,0,15.557208061218262,14.635664939880371,3,3
1758,4,11.413570369736702,11.413570369736702,0.9698615703514223,0.9698615703514233,0,0,15.718417167663574,14.635664939880371,4,4
1758,8,11.088721353265003,11.090344822831518,0.9838243823696057,0.9839283200690244,2,2,15.8836030960083,14.635664939880371,6,6
1758,16,10.098958514974381,10.822990690542722,1.0151095951243816,0.997342010192628,4,4,16.572519302368164,14.635664939880371,12,12
1758,32,9.006866847677617,10.371912633149911,1.0203047507037455,1.0214028458760893,14,19,17.079030990600586,14.635664939880371,18,13
1758,64,6.338361458507457,10.030390340278736,1.0301820262247632,1.0420051046281587,31,47,17.608596801757812,14.635664939880371,33,17
1758,128,3.844776004050207,9.855994680312923,1.019525663781391,1.053147909327736,62,110,18.287212371826172,14.635664939880371,66,18
1759,1,8.2614233846284,8.261423384628403,0.9650263924991443,0.9650263924991461,0,0,8.327146530151367,8.327146530151367,1,1
1759,2,6.0906900544020885,6.090690054402088,1.0037341509153785,1.0037341509153794,0,0,9.416116714477539,8.327146530151367,2,2
1759,3,6.055376243960111,6.0553762439601115,1.0051790244504593,1.00517902445046,0,0,10.087639808654785,8.327146530151367,3,3
1759,4,5.932822169089714,5.932822169089714,1.0094313503335002,1.0094313503335006,0,0,10.798543930053711,8.327146530151367,4,4
1759,8,5.450720711772229,5.583505162092636,1.0210698149774682,1.0229054062009104,1,2,12.188213348388672,8.327146530151367,7,6
1759,16,5.227342526975568,5.48235401662748,1.0223750435144063,1.026792160510144,5,7,12.909547805786133,8.327146530151367,11,9
1759,32,4.793847563452863,5.357392699533058,1.0207491839670555,1.030017081408885,15,17,13.265369415283203,8.327146530151367,17,15
1759,64,4.092436598999161,5.249170772732685,1.0217328138063446,1.0342422836442076,29,51,13.65035343170166,8.327146530151367,35,13
1759,128,2.652116307077212,5.12482396170056,1.0144656655402517,1.040160652452123,63,110,13.986747741699219,8.327146530151367,65,18
1760,1,3.096084014640634,3.0960840146406317,0.9959694773194312,0.9959694773194327,0,0,3.098604440689087,3.098604440689087,1,1
1760,2,3.0821402945763,3.082140294576301,0.9962531389098541,0.9962531389098559,0,0,4.4916863441467285,3.098604440689087,2,2
1760,3,2.3811105489258733,2.3862562422808464,1.0025114650893832,1.0025456520885485,1,1,4.565331935882568,3.098604440689087,2,2
1760,4,2.2486978030467757,2.258934104658183,1.0036046023030263,1.0036289036189772,1,1,4.592347145080566,3.098604440689087,3,3
1760,8,2.001028449874827,2.1085227173048566,1.004797901433881,1.0047590708627656,2,2,5.034763813018799,3.098604440689087,6,6
1760,16,1.785761681935019,2.055515735538737,1.004224766940631,1.0050804583515116,7,9,5.264602184295654,3.098604440689087,9,7
1760,32,1.3381179937628376,1.953579685593106,1.003055585025109,1.0064775753178083,13,22,5.661991596221924,3.098604440689087,19,10
1760,64,0.7577364613337889,1.9140766883574578,1.0011248222285665,1.006804039600403,29,53,6.09358549118042,3.098604440689087,35,11
1760,128,0.09768630605535047,1.8734440744309875,1.0000131957093845,1.0073770143004046,60,115,6.592713356018066,3.098604440689087,68,13
1761,1,9.896506459055761,9.896506459055766,0.9455947957147299,0.9455947957147316,0,0,10.032769203186035,10.032769203186035,1,1
1761,2,9.206438556643217,9.206438556643219,0.963931255226675,0.9639312552266757,0,0,10.462425231933594,10.032769203186035,2,2
1761,3,8.529510197912934,8.529510197912936,0.9836479797671531,0.9836479797671533,0,0,10.52104377746582,10.032769203186035,3,3
1761,4,7.742651787919225,7.742651787919225,0.9967362469340776,0.9967362469340784,0,0,10.523809432983398,10.032769203186035,4,4
1761,8,7.164925299771614,7.209951565070287,1.0101031762281991,1.0093416595301619,2,2,11.05415153503418,10.032769203186035,6,6
1761,16,6.464691261187989,6.561197147737345,1.0271499411296237,1.0252941208635242,5,6,11.324281692504883,10.032769203186035,11,10
1761,32,6.003177024999687,6.493738247657805,1.0256290311717666,1.028404786101192,13,18,11.879315376281738,10.032769203186035,19,14
1761,64,4.58247947378365,6.280586880961399,1.0260789828892114,1.0365397424134626,31,48,12.27977466583252,10.032769203186035,33,16
1761,128,2.7830008608485435,6.280197517513008,1.0069575078804887,1.03666818025987,63,111,12.658817291259766,10.032769203186035,65,17
1762,1,8.3371405383965,8.337140538396502,0.9584796554743612,0.9584796554743635,0,0,8.428776741027832,8.428776741027832,1,1
1762,2,7.116114216530439,7.1161142165304385,0.9874722767288235,0.9874722767288242,0,0,9.656761169433594,8.428776741027832,2,2
1762,3,6.271574773204879,6.271574773204879,1.0041921094830835,1.0041921094830846,0,0,9.975242614746094,8.428776741027832,3,3
1762,4,5.716584128728074,5.716584128728072,1.0146247850763093,1.0146247850763102,0,0,10.002270698547363,8.428776741027832,4,4
1762,8,5.511446556521035,5.512173193425887,1.0188211890293652,1.0189097512190874,1,1,10.450919151306152,8.428776741027832,7,7
1762,16,5.332781989407502,5.416937920639952,1.0230350163202169,1.0215898685595595,2,6,10.980064392089844,8.428776741027832,14,10
1762,32,4.355086997953585,5.276808953137315,1.0197327662828413,1.0285425927380338,14,18,11.699751853942871,8.428776741027832,18,14
1762,64,3.2974287952522783,5.252121553979058,1.0043740548118394,1.0297075153181512,29,49,12.526448249816895,8.428776741027832,35,15
1762,128,2.071856405996206,5.240368459586094,1.0012439315939383,1.0311387576030446,65,114,13.545788764953613,8.428776741027832,63,14
1763,1,6.640546519543958,6.640546519543961,0.9789781088995843,0.9789781088995863,0,0,6.671048641204834,6.671048641204834,1,1
1763,2,5.538300528952975,5.538300528952977,0.9903622099768077,0.9903622099768091,0,0,6.909798622131348,6.671048641204834,2,2
1763,3,4.9809362075249055,4.9809362075249055,0.9966202642692814,0.9966202642692821,0,0,7.106453895568848,6.671048641204834,3,3
1763,4,4.578286470971081,4.578286470971081,1.0033521049373308,1.0033521049373308,0,0,7.349640369415283,6.671048641204834,4,4
1763,8,4.009858004219243,4.025434587980542,1.010628746895698,1.0108782683434483,2,2,8.043970108032227,6.671048641204834,6,6
1763,16,3.552240125743515,3.669684996027857,1.016651398188213,1.0178979247108428,4,6,8.717707633972168,6.671048641204834,12,10
1763,32,2.964337259882344,3.466650603475198,1.0149785124333184,1.0222198817969288,13,18,9.252975463867188,6.671048641204834,19,14
1763,64,2.0766588899097056,3.4631422627990256,1.011697822296258,1.022649253645851,34,48,9.966943740844727,6.671048641204834,30,16
1763,128,1.2245407828302257,3.432069329231233,1.0029942757856107,1.0247299987617282,62,111,10.675213813781738,6.671048641204834,66,17
1764,1,8.011063790284751,8.011063790284753,0.9540433263591347,0.9540433263591359,0,0,8.129124641418457,8.129124641418457,1,1
1764,2,6.696896073601548,6.696896073601549,0.9854745143357804,0.9854745143357806,0,0,9.063226699829102,8.129124641418457,2,2
1764,3,5.965201172952599,5.965201172952598,1.0007217218883204,1.0007217218883215,0,0,9.338861465454102,8.129124641418457,3,3
1764,4,5.96404137442052,5.965201172952598,1.000519059900207,1.0007217218883215,1,1,9.67847728729248,8.129124641418457,3,3
1764,8,5.699744507967148,5.769269935466862,1.0077450072839784,1.0082783241926763,2,2,10.108118057250977,8.129124641418457,6,6
1764,16,5.09689108536044,5.556419525544787,1.0113837207829022,1.0135372819082002,7,9,10.589033126831055,8.129124641418457,9,7
1764,32,4.1911124132715125,5.1745513279811215,1.0145398461113928,1.0256436706063248,14,23,11.550334930419922,8.129124641418457,18,9
1764,64,3.4327644737608334,5.15538562100979,1.0107581406698418,1.0273982879560077,27,52,12.162333488464355,8.129124641418457,37,12
1764,128,2.065974971246197,5.0249836606262015,1.004651953356134,1.0332830783541844,59,112,12.913334846496582,8.129124641418457,69,16
1765,1,11.030061465829856,11.030061465829865,0.9148805983937494,0.9148805983937517,0,0,11.319436073303223,11.319436073303223,1,1
1765,2,9.64864555041007,9.648645550410059,0.9542283056727962,0.954228305672798,0,0,11.645147323608398,11.319436073303223,2,2
1765,3,9.269224750540722,9.269224750540726,0.9643665940507072,0.9643665940507083,0,0,11.752676010131836,11.319436073303223,3,3
1765,4,8.773352380986974,8.773352380986976,0.9811652980342995,0.9811652980343009,0,0,11.971888542175293,11.319436073303223,4,4
1765,8,7.666584087467451,7.680127681216329,1.010222382970582,1.009668344508467,2,2,12.104584693908691,11.319436073303223,6,6
1765,16,7.31292784687346,7.4188495513010295,1.0205375882949492,1.0187332502454411,6,8,12.598057746887207,11.319436073303223,10,8
1765,32,5.717617658392146,6.862117226244672,1.03596833937599,1.0337689258260025,11,20,13.34103012084961,11.319436073303223,21,12
1765,64,4.126445881578872,6.63054405099807,1.0308011398610448,1.0464448821708752,29,47,14.022725105285645,11.319436073303223,35,17
1765,128,2.747295515774853,6.614056561565277,1.003982418993529,1.047439720851382,63,108,14.870667457580566,11.319436073303223,65,20
1766,1,3.638325111695716,3.6383251116957167,0.9919930322358056,0.9919930322358065,0,0,3.6467182636260986,3.6467182636260986,1,1
1766,2,3.1482490967106913,3.148249096710692,0.9963435086205625,0.9963435086205634,0,0,3.8086538314819336,3.6467182636260986,2,2
1766,3,3.0945063303696467,3.0945063303696476,0.9969485241085027,0.9969485241085034,0,0,3.822766065597534,3.6467182636260986,3,3
1766,4,3.0882330180173008,3.0882330180173008,0.9969004450689308,0.9969004450689316,0,0,3.8306353092193604,3.6467182636260986,4,4
1766,8,2.8955288539494775,2.911938032162562,0.9994894913766409,0.9989642660352044,2,3,4.065944671630859,3.6467182636260986,6,5
1766,16,2.6448963674012966,2.899867547800003,1.0024189159964911,0.9991487778250967,7,8,4.499701499938965,3.6467182636260986,9,8
1766,32,1.7777393162341804,2.757719577230775,1.0023878779137974,1.0005431557471196,14,24,4.828163146972656,3.6467182636260986,18,8
1766,64,1.0172090716177724,2.68661547164359,0.9996069452198417,1.0011455742450446,31,54,5.204265594482422,3.6467182636260986,33,10
1766,128,0.23801526098887674,2.607224791205473,1.0000097592005575,1.0036419673930574,66,114,5.779928207397461,3.6467182636260986,62,14
1767,1,7.449473508979213,7.449473508979213,0.9619819490404167,0.9619819490404163,0,0,7.536891937255859,7.536891937255859,1,1
1767,2,6.02248208269988,6.022482082699879,0.9908819337647126,0.9908819337647115,0,0,8.055832862854004,7.536891937255859,2,2
1767,3,5.634847807358376,5.634847807358377,1.0013138699184616,1.00131386991846,0,0,8.771862983703613,7.536891937255859,3,3
1767,4,5.492396285812951,5.4923962858129505,1.0044956418038902,1.0044956418038888,0,0,8.796252250671387,7.536891937255859,4,4
1767,8,5.043703675017591,5.043864564574798,1.0142845920461703,1.014272667130673,1,1,9.56268310546875,7.536891937255859,7,7
1767,16,4.682869441796471,4.790453046407903,1.0211671579732449,1.0214783771474538,3,4,10.070876121520996,7.536891937255859,13,12
1767,32,4.017090904478759,4.722869945011733,1.0140989772293065,1.023900863166559,14,17,10.715115547180176,7.536891937255859,18,15
1767,64,3.0738751367333235,4.671621055284418,1.0024924711248484,1.0261304144690757,32,44,11.247432708740234,7.536891937255859,32,20
1767,128,1.9476333241191888,4.628016394393834,1.006494806278432,1.0291336579180759,67,107,11.812780380249023,7.536891937255859,61,21
1768,1,8.012415602277153,8.012415602277155,0.966525188765522,0.9665251887655248,0,0,8.073173522949219,8.073173522949219,1,1
1768,2,6.249513309703815,6.249513309703817,0.9999367740929189,0.9999367740929217,0,0,8.34400749206543,8.073173522949219,2,2
1768,3,5.856201153335449,5.85620115333545,1.0045781580436954,1.0045781580436968,0,0,8.475887298583984,8.073173522949219,3,3
1768,4,5.767853646244456,5.767853646244457,1.0068767836438122,1.0068767836438126,0,0,9.290634155273438,8.073173522949219,4,4
1768,8,5.292685262915022,5.2957306218937354,1.0171840466828468,1.0174187038176994,2,2,10.053351402282715,8.073173522949219,6,6
1768,16,5.067677370932854,5.107099225529761,1.0221904809334716,1.0233712116290803,3,4,10.71965503692627,8.073173522949219,13,12
1768,32,4.307078509936586,4.936844944286959,1.0245925034882708,1.031653331747758,9,19,11.635090827941895,8.073173522949219,23,13
1768,64,3.282189045202991,4.9248045159575025,1.0114829710134117,1.0329589383521884,32,49,12.500533103942871,8.073173522949219,32,15
1768,128,1.673442704823484,4.918277431648,1.0033169480921598,1.0339591954311018,65,111,13.484206199645996,8.073173522949219,63,17
1769,1,10.4405317905832,10.4405317905832,0.9344586566075999,0.9344586566076019,0,0,10.624000549316406,10.624000549316406,1,1
1769,2,9.639346059752489,9.639346059752487,0.9506128475142659,0.9506128475142674,0,0,10.740118026733398,10.624000549316406,2,2
1769,3,8.267689040329145,8.267689040329154,0.9796373556960953,0.9796373556960948,0,0,10.940635681152344,10.624000549316406,3,3
1769,4,7.402177305031418,7.402177305031419,1.0017788270578651,1.0017788270578651,0,0,11.62431812286377,10.624000549316406,4,4
1769,8,7.022796591881483,7.065307596093849,1.0098978742924103,1.0104835192164017,1,2,11.914111137390137,10.624000549316406,7,6
1769,16,6.5249537080340385,6.908898660804832,1.016686809712552,1.015448410441389,6,10,12.2565336227417,10.624000549316406,10,6
1769,32,5.0410344392119155,6.677198678707885,1.0244496346037997,1.0231472518230054,13,22,12.579754829406738,10.624000549316406,19,10
1769,64,4.011845213391596,6.340283939235487,1.0194642296706111,1.0357219444965875,28,49,13.03450870513916,10.624000549316406,36,15
1769,128,2.367340231835907,5.700414451533919,1.013596821167837,1.0561747641046093,60,113,13.687201499938965,10.624000549316406,68,15
1770,1,5.417042357575832,5.417042357575835,0.9823040644726394,0.9823040644726411,0,0,5.443849563598633,5.443849563598633,1,1
1770,2,3.8176883449401946,3.8176883449401937,1.0003377820420916,1.000337782042093,0,0,5.890654563903809,5.443849563598633,2,2
1770,3,3.779658541974749,3.779658541974749,1.0008475711476472,1.000847571147648,0,0,5.991710186004639,5.443849563598633,3,3
1770,4,3.717095061304272,3.779658541974749,1.0007741953111635,1.000847571147648,1,1,6.035478591918945,5.443849563598633,3,3
1770,8,3.5549601772365094,3.563901933305521,1.0038324482593715,1.0038359407468045,2,3,6.792013645172119,5.443849563598633,6,5
1770,16,3.010665797284967,3.3842106493036757,1.0057250335812422,1.0074833151934637,9,9,7.626377582550049,5.443849563598633,7,7
1770,32,2.4005610265027557,3.383932143770928,1.0023059469723437,1.0076090341572264,15,24,8.14954662322998,5.443849563598633,17,8
1770,64,1.8751840112035332,3.375182704528929,1.0015528002986511,1.008572175414927,28,55,8.964890480041504,5.443849563598633,36,9
1770,128,1.125692467548914,3.3695222674876195,0.9994563463414198,1.009016084183184,69,119,9.612578392028809,5.443849563598633,59,9
1771,1,6.819403221631454,6.8194032216314575,0.9684255958655059,0.9684255958655072,0,0,6.885684490203857,6.885684490203857,1,1
1771,2,5.475862071593863,5.475862071593864,0.992124519819647,0.9921245198196473,0,0,8.0968656539917,6.885684490203857,2,2
1771,3,5.403668549864867,5.403668549864867,0.9939486867114411,0.9939486867114404,0,0,8.261645317077637,6.885684490203857,3,3
1771,4,5.180134469674273,5.180134469674273,0.9982280870417977,0.9982280870417974,0,0,8.271934509277344,6.885684490203857,4,4
1771,8,3.994020239355743,4.0106280723713885,1.0133282459957125,1.0137122802674083,1,1,9.196633338928223,6.885684490203857,7,7
1771,16,3.8364085464812505,3.945505721244688,1.0140680012908536,1.0165946977759461,6,7,9.96609878540039,6.885684490203857,10,9
1771,32,3.2188870729213166,3.780929916984642,1.016641454941058,1.0230856997664122,15,17,10.803154945373535,6.885684490203857,17,15
1771,64,2.3043591276831292,3.7511055191781306,1.0069852446255096,1.0257587281438934,28,46,11.670931816101074,6.885684490203857,36,18
1771,128,1.6424664066745316,3.742042795781385,1.0054368178792892,1.0264039003731544,59,109,12.545934677124023,6.885684490203857,69,19
1772,1,10.682999732598638,10.68299973259864,0.9339978527488066,0.9339978527488072,0,0,10.869372367858887,10.869372367858887,1,1
1772,2,10.071206416367977,10.071206416367978,0.9506689130423573,0.9506689130423578,0,0,11.42428207397461,10.869372367858887,2,2
1772,3,9.883605423048957,9.883605423048959,0.9573863058189271,0.9573863058189279,0,0,11.612200736999512,10.869372367858887,3,3
1772,4,8.899977313940719,8.899977313940719,0.9857598145243363,0.985759814524336,0,0,12.417051315307617,10.869372367858887,4,4
1772,8,8.385946790623676,8.385946790623676,1.0064374329076964,1.0064374329076942,0,0,13.212985038757324,10.869372367858887,8,8
1772,16,7.668112648076921,7.927823975663352,1.0183152012620103,1.0205779469996847,5,8,14.07419204711914,10.869372367858887,11,8
1772,32,6.792096393232141,7.870408950480877,1.0218615587862936,1.0238669177359925,17,21,14.71384334564209,10.869372367858887,15,11
1772,64,5.381088832488472,7.629468866365012,1.0319528264688904,1.0375135125698356,30,51,15.561849594116211,10.869372367858887,34,13
1772,128,3.5200453397178664,7.312525726504079,1.0207354630665009,1.058345234701674,57,112,16.56078338623047,10.869372367858887,71,16
1773,1,4.124607767531346,4.124607767531346,0.988650411230423,0.9886504112304249,0,0,4.139507293701172,4.139507293701172,1,1
1773,2,3.9722434851280233,3.9722434851280255,0.9917657340957353,0.9917657340957371,0,0,5.989727973937988,4.139507293701172,2,2
1773,3,3.882918929500773,3.8829189295007747,0.9931117541541532,0.9931117541541549,1,1,6.1103291511535645,4.139507293701172,2,2
1773,4,2.9518346816605128,3.0798144723875636,1.0008861951787063,1.000719775020104,1,2,6.222907543182373,4.139507293701172,3,2
1773,8,2.7639438147619977,2.9606762718152724,1.0039322641536723,1.003296972136794,2,4,6.973842144012451,4.139507293701172,6,4
1773,16,2.564898624861788,2.9557679709506997,1.0043681668524336,1.0037491492182242,6,11,7.27371883392334,4.139507293701172,10,5
1773,32,2.033372901551171,2.867079092794238,1.0004221157161053,1.0064871898284542,16,26,8.069241523742676,4.139507293701172,16,6
1773,64,1.4938799138337455,2.8486321925500984,0.999045776184533,1.0068723268094293,29,58,8.622474670410156,4.139507293701172,35,6
1773,128,0.4708511611075125,2.787999820478467,1.0007935362036218,1.009539233243907,54,120,9.278276443481445,4.139507293701172,74,8
1774,1,11.791079216265004,11.791079216265008,0.9201256258402428,0.9201256258402439,0,0,12.023468971252441,12.023468971252441,1,1
1774,2,9.993701435959446,9.993701435959446,0.9715891438798857,0.971589143879886,0,0,12.104392051696777,12.023468971252441,2,2
1774,3,9.190834202466256,9.190834202466254,0.9870665246113817,0.9870665246113814,0,0,12.119266510009766,12.023468971252441,3,3
1774,4,8.655884866451597,8.655884866451599,0.9973193926002251,0.997319392600224,0,0,12.12097454071045,12.023468971252441,4,4
1774,8,7.016438679374281,7.038155132453924,1.0241409757729003,1.0238072253576924,1,1,12.543073654174805,12.023468971252441,7,7
1774,16,6.645943934444948,6.7995641616801255,1.0317098518266092,1.0312245194797598,5,5,12.659710884094238,12.023468971252441,11,11
1774,32,6.124834523279175,6.575046200078261,1.0399162161171576,1.0379238298901317,13,18,13.040011405944824,12.023468971252441,19,14
1774,64,5.069889287901863,6.420774918274907,1.0379600641362143,1.042749408890652,32,49,13.463173866271973,12.023468971252441,32,15
1774,128,3.077000194903784,6.395916537426444,1.01589058962412,1.0443495688036797,48,110,13.944074630737305,12.023468971252441,80,18
1775,1,7.283386664852596,7.283386664852594,0.9672270612133868,0.9672270612133859,0,0,7.347348213195801,7.347348213195801,1,1
1775,2,6.543942363777773,6.54394236377777,0.9809262510912127,0.9809262510912111,0,0,8.427141189575195,7.347348213195801,2,2
1775,3,6.475344259831627,6.475344259831627,0.9838221980658037,0.9838221980658027,0,0,9.58391284942627,7.347348213195801,3,3
1775,4,5.938228754287264,5.939232050307207,0.9942114339209929,0.9943535193106166,1,1,9.67678451538086,7.347348213195801,3,3
1775,8,5.480344539888132,5.487682780752786,1.0041666867622596,1.0047573970257861,1,2,10.446036338806152,7.347348213195801,7,6
1775,16,4.885740670109156,5.245003017934513,1.0157717911358266,1.0134520928518724,6,9,11.220911026000977,7.347348213195801,10,7
1775,32,4.191211427772706,5.144959244942246,1.017315062129877,1.0173519616077944,12,24,11.974254608154297,7.347348213195801,20,8
1775,64,3.1622141728798328,5.140817562121461,1.007646090984343,1.0181056437101674,30,53,12.692569732666016,7.347348213195801,34,11
1775,128,1.889143800970095,5.115774540362901,0.9986088976183001,1.0206285029553828,66,117,13.639892578125,7.347348213195801,62,11
1776,1,6.012310857708223,6.012310857708225,0.9791410359676448,0.9791410359676458,0,0,6.046370983123779,6.046370983123779,1,1
1776,2,4.406715543398695,4.406715543398695,0.9962312301445861,0.9962312301445865,0,0,6.084405422210693,6.046370983123779,2,2
1776,3,3.780887788004994,3.7808877880049945,1.0034829204733133,1.0034829204733138,0,0,6.1018171310424805,6.046370983123779,3,3
1776,4,3.6535151592861754,3.6535151592861754,1.0031694224866388,1.003169422486639,0,0,6.106566905975342,6.046370983123779,4,4
1776,8,3.2537231847946253,3.253723184794623,1.007107123997004,1.007107123997005,0,0,6.571976184844971,6.046370983123779,8,8
1776,16,3.0708146953575444,3.1287964066370293,1.0082928203187922,1.009397075498052,4,7,7.536365032196045,6.046370983123779,12,9
1776,32,2.4011734904605655,3.115639488240708,1.0060827815649511,1.0104608707636475,13,20,8.107501983642578,6.046370983123779,19,12
1776,64,1.7020522145536388,3.1054874512032162,1.0025756644728718,1.0113227158765858,30,48,8.973552703857422,6.046370983123779,34,16
1776,128,0.7821030302688047,3.056021807822472,1.0005271203846684,1.0142861497749478,64,113,9.8390531539917,6.046370983123779,64,15
1777,1,7.095834301094439,7.095834301094447,0.9688687500562132,0.9688687500562161,0,0,7.155737400054932,7.155737400054932,1,1
1777,2,6.142608041498714,6.142608041498715,0.986818653247101,0.9868186532471026,0,0,7.788145542144775,7.155737400054932,2,2
1777,3,5.774236691789873,5.7742366917898735,0.9920555262222667,0.9920555262222684,0,0,7.844447612762451,7.155737400054932,3,3
1777,4,5.694698613170124,5.694698613170126,0.9953542078062216,0.9953542078062236,0,0,8.529098510742188,7.155737400054932,4,4
1777,8,5.077391472866062,5.077483487882401,1.0112104605614989,1.011229061517724,1,1,8.815299034118652,7.155737400054932,7,7
1777,16,4.587193217535254,4.701909827980614,1.0170285902964251,1.018441028544968,5,5,9.462858200073242,7.155737400054932,11,11
1777,32,4.131588010922557,4.484515491206834,1.0205087125125112,1.0236803327439752,13,16,10.094531059265137,7.155737400054932,19,16
1777,64,2.8717218013583463,4.394182669974423,1.0083139598493387,1.0283405162293962,27,46,10.80335807800293,7.155737400054932,37,18
1777,128,1.7474693701782722,4.244421802460651,0.9999342079745367,1.0298695093444037,61,113,11.891249656677246,7.155737400054932,67,15
1778,1,8.30006971721448,8.300069717214484,0.9636541119515096,0.963654111951511,0,0,8.37148380279541,8.37148380279541,1,1
1778,2,6.6242469169322895,6.6242469169322895,1.001058191173402,1.001058191173403,0,0,9.274462699890137,8.37148380279541,2,2
1778,3,5.985620130934005,5.985620130934004,1.009450638121032,1.0094506381210333,0,0,9.373431205749512,8.37148380279541,3,3
1778,4,5.907101351730691,5.985620130934003,1.0107021101016505,1.0094506381210333,1,1,9.379112243652344,8.37148380279541,3,3
1778,8,5.722843314195204,5.772000343092205,1.0151915571881007,1.0152086399079814,3,3,10.142242431640625,8.37148380279541,5,5
1778,16,5.172107224522678,5.588421527931591,1.022991769017726,1.0204932850285262,6,7,10.592353820800781,8.37148380279541,10,9
1778,32,4.3010498756867515,5.208521461429332,1.0278399468029251,1.0290216404850525,15,22,11.222545623779297,8.37148380279541,17,10
1778,64,2.769268700743343,5.018081553606522,1.0136484825847978,1.034121547350551,27,52,11.971778869628906,8.37148380279541,37,12
1778,128,1.7282145727827996,5.017131884310302,1.0050568218384324,1.0344195675612664,63,115,12.499961853027344,8.37148380279541,65,13
1779,1,9.938891995587992,9.938891995587994,0.9421397320955374,0.9421397320955381,0,0,10.089447975158691,10.089447975158691,1,1
1779,2,9.315018119124762,9.315018119124762,0.9576536361438135,0.9576536361438128,0,0,10.149596214294434,10.089447975158691,2,2
1779,3,7.433421809530517,7.433421809530517,0.9932654574331434,0.9932654574331456,0,0,10.298015594482422,10.089447975158691,3,3
1779,4,7.188356702537067,7.188356702537067,0.9985024622343042,0.9985024622343048,0,0,10.49333667755127,10.089447975158691,4,4
1779,8,6.858724532405804,6.858724532405804,1.0093714559405527,1.009371455940553,0,0,11.508907318115234,10.089447975158691,8,8
1779,16,6.122069526806948,6.299506870482022,1.0269693915701104,1.0253529460016788,4,6,11.816285133361816,10.089447975158691,12,10
1779,32,5.2875435774758275,6.198655608687328,1.0248179920211131,1.0278732459245745,16,21,12.266666412353516,10.089447975158691,16,11
1779,64,4.383828671638601,6.093913738419621,1.0250978564113336,1.0342346439846142,31,48,12.848907470703125,10.089447975158691,33,16
1779,128,2.4906028633795545,5.962876889615851,1.0054186490789245,1.03903022577218,65,109,13.54171085357666,10.089447975158691,63,19
1780,1,2.1111033142535445,2.111103314253545,0.9987152305133663,0.998715230513367,0,0,2.1114790439605713,2.1114790439605713,1,1
1780,2,1.7880224167186416,1.7880224167186416,1.0007652906580304,1.0007652906580304,0,0,2.3472094535827637,2.1114790439605713,2,2
1780,3,1.56349109121601,1.5634910912160103,1.0018491817483652,1.0018491817483652,0,0,2.5801780223846436,2.1114790439605713,3,3
1780,4,1.46754586734774,1.46754586734774,1.0020085354443906,1.0020085354443908,0,0,2.626494884490967,2.1114790439605713,4,4
1780,8,1.2277101807525868,1.2294594433496566,1.0027330541886557,1.0027379705262724,2,2,2.7965872287750244,2.1114790439605713,6,6
1780,16,0.9990627080956304,1.0912569007292718,1.0017439264520376,1.0025703783250193,5,7,3.015953779220581,2.1114790439605713,11,9
1780,32,0.7268996885578612,1.055638607498579,1.0013872420836853,1.0031172685731515,13,21,3.4846715927124023,2.1114790439605713,19,11
1780,64,0.3590408839334296,1.0501676868924414,0.9999233853769225,1.003307778538038,35,51,3.983067035675049,2.1114790439605713,29,13
1780,128,0.02154768968132995,1.0500095132713032,1.0000042333508588,1.003367868679747,62,114,4.749791145324707,2.1114790439605713,66,14
1781,1,10.357864518399987,10.357864518399989,0.9346543146864537,0.9346543146864547,0,0,10.540550231933594,10.540550231933594,1,1
1781,2,9.100456450092558,9.100456450092558,0.9696556551912264,0.9696556551912261,0,0,11.2049560546875,10.540550231933594,2,2
1781,3,8.821515078070258,8.821515078070258,0.9786419570750317,0.9786419570750318,0,0,11.289937973022461,10.540550231933594,3,3
1781,4,8.386748075390226,8.386748075390225,0.9895123490183775,0.9895123490183768,0,0,11.413809776306152,10.540550231933594,4,4
1781,8,7.984938408411999,7.993084633155295,0.996493930136237,0.9961716744866882,1,2,11.837915420532227,10.540550231933594,7,6
1781,16,6.692150781687982,7.227099588222029,1.0184085760352306,1.0130200715738487,5,9,12.499225616455078,10.540550231933594,11,7
1781,32,5.537104904298371,7.1860587384036565,1.0155646491879506,1.0150048320541654,13,22,13.063617706298828,10.540550231933594,19,10
1781,64,3.894297901547859,7.142577324878,1.0108228448325134,1.0200522242377046,30,50,13.551238059997559,10.540550231933594,34,14
1781,128,2.0497032066972802,6.679472203890878,1.0030443164825262,1.0358958552191955,53,111,14.074566841125488,10.540550231933594,75,17
1782,1,14.853077144568223,14.853077144568228,0.8306771341894332,0.8306771341894345,0,0,15.70416259765625,15.70416259765625,1,1
1782,2,14.099055541325782,14.099055541325779,0.8644939745685779,0.8644939745685771,0,0,16.124210357666016,15.70416259765625,2,2
1782,3,12.154255363652915,12.154255363652918,0.9492390556908286,0.9492390556908288,0,0,16.291484832763672,15.70416259765625,3,3
1782,4,12.12073382069505,12.12073382069505,0.950557038324282,0.9505570383242834,0,0,16.408422470092773,15.70416259765625,4,4
1782,8,11.850353744735042,11.92560978533064,0.9614124240523441,0.9592839030947875,1,1,16.91254234313965,15.70416259765625,7,7
1782,16,10.474577905229971,10.721373492597337,1.0156661208103166,1.0096071300090013,5,7,17.18699836730957,15.70416259765625,11,9
1782,32,9.217426974120682,10.289038435661803,1.037073079706094,1.0278191273056043,15,20,17.468034744262695,15.70416259765625,17,12
1782,64,6.807028876820048,10.17591987045255,1.035853021588124,1.0358796080237371,29,51,17.89362907409668,15.70416259765625,35,13
1782,128,4.580225946486892,10.023525289841578,1.0268433041205445,1.042751149258646,63,113,18.246150970458984,15.70416259765625,65,15
1783,1,7.077169280379558,7.077169280379561,0.9660331580980399,0.9660331580980415,0,0,7.151764392852783,7.151764392852783,1,1
1783,2,5.9409112407181155,5.94091124071809,0.9874275686181316,0.987427568618134,0,0,7.961886405944824,7.151764392852783,2,2
1783,3,5.2833000048062715,5.2833000048062715,0.9993205887911949,0.9993205887911959,0,0,8.305931091308594,7.151764392852783,3,3
1783,4,4.928395183639769,4.928395183639769,1.003466455970869,1.0034664559708693,0,0,8.59270191192627,7.151764392852783,4,4
1783,8,4.59115752858734,4.701486161427914,1.0100305117674,1.010442484456907,2,2,9.705049514770508,7.151764392852783,6,6
1783,16,4.034655242262847,4.428783316383396,1.0142504153246288,1.0152923520586568,5,10,10.287201881408691,7.151764392852783,11,6
1783,32,3.6563147101483087,4.22887204869494,1.0196677552886293,1.0214400156948136,14,20,10.684954643249512,7.151764392852783,18,12
1783,64,2.374730501887926,4.222551624790218,1.0108652868309949,1.0216671976744656,26,50,11.400603294372559,7.151764392852783,38,14
1783,128,1.4416658788048675,4.213907839774506,1.005410334208073,1.0230740080705858,64,114,12.074923515319824,7.151764392852783,64,14
1784,1,4.252002273375319,4.252002273375319,0.9827713079350159,0.9827713079350159,0,0,4.284976482391357,4.284976482391357,1,1
1784,2,3.2215159252008343,3.2215159252008343,0.9977772892774149,0.9977772892774154,0,0,5.087639808654785,4.284976482391357,2,2
1784,3,2.4934654635722953,2.4934654635722953,1.0030024545515368,1.0030024545515361,0,0,5.2568206787109375,4.284976482391357,3,3
1784,4,2.4658484715930427,2.465848471593043,1.0038151104340867,1.0038151104340858,0,0,5.356832027435303,4.284976482391357,4,4
1784,8,2.2845486799933337,2.347872679735695,1.0047134116209828,1.0053238375276108,2,3,5.721621513366699,4.284976482391357,6,5
1784,16,2.0774182265292978,2.2548138837993057,1.0044609683267325,1.0065179616845583,6,8,6.252997398376465,4.284976482391357,10,8
1784,32,1.7605620629996532,2.2256530414505376,1.0060188883035346,1.0073549678003868,12,22,6.681004524230957,4.284976482391357,20,10
1784,64,1.1791936508320788,2.203139473491075,1.001570352072853,1.0079655870836473,31,53,7.339313507080078,4.284976482391357,33,11
1784,128,0.5261341632428566,2.1582243221519084,1.000450440000354,1.0106083455611112,61,112,7.953110218048096,4.284976482391357,67,16
1785,1,3.799799568637561,3.799799568637561,0.9935596634363214,0.9935596634363232,0,0,3.8050122261047363,3.8050122261047363,1,1
1785,2,3.362733773837262,3.3627337738372622,0.9978986379079611,0.9978986379079628,0,0,4.4022040367126465,3.8050122261047363,2,2
1785,3,3.2258618243118313,3.2258618243118318,0.9997763359029144,0.9997763359029159,0,0,5.113826751708984,3.8050122261047363,3,3
1785,4,3.0694805597526105,3.06948055975261,1.001705925514153,1.0017059255141534,0,0,5.1673455238342285,3.8050122261047363,4,4
1785,8,2.8227761040208823,2.884139937137148,1.0057872917734627,1.0049968869114008,1,1,6.029601573944092,3.8050122261047363,7,7
1785,16,2.3686313804361796,2.6961993606046337,1.0062397321110756,1.0084290222501058,6,7,6.797475337982178,3.8050122261047363,10,9
1785,32,1.8199542559778152,2.681679213950337,1.0033804679774827,1.0094429634838904,15,20,7.35001802444458,3.8050122261047363,17,12
1785,64,1.1128013725493178,2.6497821372643027,1.0013181893792606,1.010417677677342,28,51,8.36037540435791,3.8050122261047363,36,13
1785,128,0.43891589863228175,2.638747955598638,1.0000760014765633,1.0113692786922277,61,114,9.477082252502441,3.8050122261047363,67,14
1786,1,7.474346843157678,7.4743468431576785,0.9740486982344758,0.9740486982344765,0,0,7.514761924743652,7.514761924743652,1,1
1786,2,5.9716170320282,5.9716170320282,0.9905915959309424,0.9905915959309421,0,0,7.568918228149414,7.514761924743652,2,2
1786,3,5.816538272616217,5.816538272616215,0.9918642011382429,0.9918642011382419,0,0,7.594175815582275,7.514761924743652,3,3
1786,4,5.641593817078783,5.641593817078783,0.9955436197577723,0.9955436197577727,0,0,7.849339008331299,7.514761924743652,4,4
1786,8,4.824249809649927,4.824249809649927,1.0103296905167733,1.0103296905167738,0,0,8.601484298706055,7.514761924743652,8,8
1786,16,4.365417218204839,4.548334795412721,1.0160635725293072,1.015756567644967,5,6,8.882244110107422,7.514761924743652,11,10
1786,32,3.5559988623545022,4.136649792331233,1.0229208123228821,1.0244424447153058,13,19,9.44226360321045,7.514761924743652,19,13
1786,64,2.516670550423599,4.097676733421387,1.0113159321362422,1.0259597468009825,29,46,10.002106666564941,7.514761924743652,35,18
1786,128,1.311752970236156,4.025721369794669,1.004676127330678,1.0288990262740207,60,110,10.696819305419922,7.514761924743652,68,18
1787,1,6.828310119517305,6.828310119517306,0.9733056233954871,0.9733056233954881,0,0,6.874852180480957,6.874852180480957,1,1
1787,2,6.369937654282877,6.369937654282878,0.98256827395234,0.9825682739523403,0,0,7.620002269744873,6.874852180480957,2,2
1787,3,5.233844108229402,5.233844108229401,1.0012344003173386,1.0012344003173381,0,0,7.685070991516113,6.874852180480957,3,3
1787,4,5.051387956902503,5.051387956902503,1.003402889626539,1.0034028896265383,0,0,7.711811065673828,6.874852180480957,4,4
1787,8,3.8668976226747604,3.8773818440148324,1.0129033784260841,1.012929509467685,1,1,8.439194679260254,6.874852180480957,7,7
1787,16,3.4018508472889963,3.5843420118793423,1.018010013993511,1.0198896492809384,3,5,9.068680763244629,6.874852180480957,13,11
1787,32,3.1493760625512928,3.5651730600489233,1.0183170811444455,1.0209776845883962,11,19,9.659141540527344,6.874852180480957,21,13
1787,64,2.3799505350908934,3.5318182514047565,1.0096321430865094,1.0225392277987417,30,50,10.226883888244629,6.874852180480957,34,14
1787,128,1.5719320780659722,3.5305991460070643,1.0025969664936472,1.0228841095313053,60,113,10.905723571777344,6.874852180480957,68,15
1788,1,6.00285014226444,6.002850142264429,0.981953127869286,0.9819531278692886,0,0,6.027400016784668,6.027400016784668,1,1
1788,2,4.812164624380221,4.812164624380222,0.9971952141963842,0.9971952141963858,0,0,6.312328338623047,6.027400016784668,2,2
1788,3,4.576101908216876,4.576101908216877,0.9989062874472945,0.9989062874472945,0,0,6.372672080993652,6.027400016784668,3,3
1788,4,4.303010981202789,4.303010981202788,1.0018845434008918,1.0018845434008936,0,0,6.802778720855713,6.027400016784668,4,4
1788,8,3.6882037294048717,3.7205679729236945,1.009664137660159,1.0098264607476197,2,3,7.3987717628479,6.027400016784668,6,5
1788,16,3.1309353810469847,3.572172571923818,1.0082875147944055,1.0117290392386482,7,9,7.9944000244140625,6.027400016784668,9,7
1788,32,2.717550682923905,3.5429061819065684,1.0109004886835522,1.0134407603591198,16,23,8.44803524017334,6.027400016784668,16,9
1788,64,1.986365129855989,3.5065810422993886,1.0066628630732721,1.0147799457703301,26,53,8.99624252319336,6.027400016784668,38,11
1788,128,0.8941810873118474,3.4955316438844815,1.0010707211648957,1.0157196616089186,59,115,9.497293472290039,6.027400016784668,69,13
1789,1,8.882699664116661,8.882699664116663,0.954136024226675,0.9541360242266753,0,0,8.991466522216797,8.991466522216797,1,1
1789,2,7.2790642222124475,7.279064222212448,0.9870520971953507,0.987052097195351,0,0,9.429570198059082,8.991466522216797,2,2
1789,3,7.073722802183567,7.073722802183567,0.9913210090588246,0.991321009058825,0,0,9.8040132522583,8.991466522216797,3,3
1789,4,6.695952030929901,6.6959520309299005,1.0015789962497663,1.001578996249766,0,0,10.024864196777344,8.991466522216797,4,4
1789,8,6.195144504859633,6.20941655064758,1.0143688015195655,1.0143716798922822,1,1,10.473525047302246,8.991466522216797,7,7
1789,16,5.880488137710091,6.131954276616309,1.0176764130072193,1.0177036092964906,4,6,10.909158706665039,8.991466522216797,12,10
1789,32,4.9483551276363835,5.755624710327575,1.0276128112634668,1.0269354377399555,14,22,11.38811206817627,8.991466522216797,18,10
1789,64,3.3714496383289263,5.458327290699258,1.0195924135453454,1.0354117960453644,29,51,12.023444175720215,8.991466522216797,35,13
1789,128,1.7100394778064687,5.42234976377809,1.0052724202572518,1.0366493286127016,64,112,12.768830299377441,8.991466522216797,64,16
1790,1,15.275353885268007,15.275353885268013,0.854372354470082,0.8543723544700832,0,0,15.891793251037598,15.891793251037598,1,1
1790,2,14.726686021074544,14.726686021074547,0.8764319529096289,0.8764319529096287,0,0,16.214981079101562,15.891793251037598,2,2
1790,3,14.417745087232479,14.41774508723248,0.8895423987125977,0.8895423987125981,0,0,16.25473976135254,15.891793251037598,3,3
1790,4,14.000157308604264,14.000157308604264,0.9054341420306021,0.9054341420306011,0,0,16.436777114868164,15.891793251037598,4,4
1790,8,11.876591137081014,11.932032000041506,0.9889110762490523,0.9869695793659731,2,3,16.96379280090332,15.891793251037598,6,5
1790,16,11.022454023557525,11.26663066340842,1.015200148186634,1.01346946331302,5,10,17.5699405670166,15.891793251037598,11,6
1790,32,9.770185568851737,11.094153993030448,1.015824943051886,1.0226724723116576,14,24,18.150310516357422,15.891793251037598,18,8
1790,64,8.439502073647933,10.565420617471606,1.0360847991500024,1.04760429860438,31,51,18.604284286499023,15.891793251037598,33,13
1790,128,5.988884381926623,10.523761576346477,1.0290455245493808,1.0521417042553676,62,113,19.065143585205078,15.891793251037598,66,15
1791,1,2.7349443605888393,2.734944360588831,0.9966386938170535,0.9966386938170557,0,0,2.7369394302368164,2.7369394302368164,1,1
1791,2,2.1286511998646085,2.1286511998646085,1.0001277546940797,1.000127754694081,0,0,3.2225520610809326,2.7369394302368164,2,2
1791,3,1.9499701020870917,1.9499701020870912,1.001418518741207,1.0014185187412084,0,0,3.5082669258117676,2.7369394302368164,3,3
1791,4,1.9490514457252004,1.9499701020870912,1.00135615225107,1.0014185187412084,1,1,3.5696723461151123,2.7369394302368164,3,3
1791,8,1.6272391453786905,1.6323354409772661,1.0027120588020777,1.0028174260464513,1,2,3.861881732940674,2.7369394302368164,7,6
1791,16,1.4486843033187395,1.5116154577250678,1.0038330728493792,1.00402671613116,5,7,4.261184215545654,2.7369394302368164,11,9
1791,32,1.11789168111313,1.5051372589199148,1.003783214235348,1.0042493243004527,9,20,4.5359368324279785,2.7369394302368164,23,12
1791,64,0.6339821948243962,1.4210234994329853,1.001785028661209,1.0052242470094377,30,49,4.922577381134033,2.7369394302368164,34,15
1791,128,0.054498716779124275,1.4170401221248021,0.9999827640458461,1.0053947309089786,67,111,5.2480597496032715,2.7369394302368164,61,17
1792,1,7.724102141353542,7.724102141353545,0.9650204888089954,0.9650204888089969,0,0,7.795938491821289,7.795938491821289,1,1
1792,2,5.820802598586399,5.820802598586399,0.9962881735947314,0.9962881735947327,0,0,8.249100685119629,7.795938491821289,2,2
1792,3,5.664810439295833,5.664810439295834,0.998933982379576,0.9989339823795772,0,0,8.413110733032227,7.795938491821289,3,3
1792,4,5.10524347991059,5.105243479910596,1.007073686688976,1.0070736866889767,0,0,8.492809295654297,7.795938491821289,4,4
1792,8,4.2112298190885165,4.227701222531208,1.0196260534217123,1.0194649324066876,1,1,8.930512428283691,7.795938491821289,7,7
1792,16,3.8805506446678644,4.195449704434503,1.0192764714961622,1.019936929597332,5,8,9.994810104370117,7.795938491821289,11,8
1792,32,3.198852573281984,4.031855784939862,1.0168100977779455,1.0237084792290232,17,22,10.438283920288086,7.795938491821289,15,10
1792,64,2.476937047702381,3.986033208550806,1.0098676723247253,1.0267651265191722,30,51,10.923043251037598,7.795938491821289,34,13
1792,128,1.3185131948663504,3.9831877019353574,1.0041049377114803,1.0272494520881477,56,113,11.548005104064941,7.795938491821289,72,15
1793,1,9.23455030953883,9.23455030953883,0.9480021063042184,0.9480021063042195,0,0,9.363581657409668,9.363581657409668,1,1
1793,2,7.32531215416909,7.32531215416909,0.9913366341823755,0.9913366341823764,0,0,10.119220733642578,9.363581657409668,2,2
1793,3,6.652450880800616,6.652450880800617,1.00681949865323,1.0068194986532304,0,0,10.140345573425293,9.363581657409668,3,3
1793,4,6.190583151053535,6.190583151053535,1.018122916031507,1.018122916031507,0,0,10.631205558776855,9.363581657409668,4,4
1793,8,5.842176482957598,5.875604019395407,1.025542856255891,1.0255310143083955,2,2,11.143150329589844,9.363581657409668,6,6
1793,16,5.292705739977948,5.332419922446674,1.0384091001517108,1.0388357867482405,2,3,11.652846336364746,9.363581657409668,14,13
1793,32,4.748734756359205,5.286223774069746,1.037365527287901,1.0430580855041913,11,15,12.213566780090332,9.363581657409668,21,17
1793,64,3.5243642461692084,5.247977170945476,1.0167520590746395,1.0457700636664922,27,43,13.6363525390625,9.363581657409668,37,21
1793,128,1.8980499916976028,5.211031788238957,1.0045163742260856,1.0485025902608138,60,107,14.76745319366455,9.363581657409668,68,21
1794,1,8.814925387046747,8.81492538704672,0.9531647411048997,0.9531647411049012,0,0,8.923972129821777,8.923972129821777,1,1
1794,2,7.383858497462255,7.383858497462255,0.9860444034755644,0.9860444034755657,0,0,9.065630912780762,8.923972129821777,2,2
1794,3,6.72758767972211,6.72758767972211,0.9989744805961691,0.9989744805961696,0,0,9.468682289123535,8.923972129821777,3,3
1794,4,6.684269861120052,6.684269861120053,1.0006316646350166,1.0006316646350168,0,0,9.592923164367676,8.923972129821777,4,4
1794,8,6.0251053921859175,6.452320217589523,1.0095312974857413,1.0069420888825216,2,2,10.404991149902344,8.923972129821777,6,6
1794,16,5.395606818554214,6.116614991944657,1.0182372929520709,1.0191514230188847,6,7,11.19334602355957,8.923972129821777,10,9
1794,32,4.381323071067858,5.722888844408606,1.020137798410881,1.0304505257678755,12,21,11.799856185913086,8.923972129821777,20,11
1794,64,3.4364389251707115,5.541152245546273,1.0073898165000925,1.0351268561678881,34,51,12.512680053710938,8.923972129821777,30,13
1794,128,1.801117276429624,5.119488616305543,0.9980596842558098,1.0419547907333842,62,111,13.45708179473877,8.923972129821777,66,17
1795,1,7.304879286876078,7.3048792868760835,0.9685867298756805,0.9685867298756825,0,0,7.365152359008789,7.365152359008789,1,1
1795,2,5.846040363363405,5.846040363363404,0.9950768988783107,0.9950768988783121,0,0,8.205886840820312,7.365152359008789,2,2
1795,3,5.028670724771016,5.028670724771014,1.0100301781609926,1.010030178160994,0,0,8.498900413513184,7.365152359008789,3,3
1795,4,4.934372401273925,4.934372401273923,1.0104626160260644,1.0104626160260657,0,0,8.59924602508545,7.365152359008789,4,4
1795,8,4.514171554626381,4.514171554626379,1.0210908298369479,1.0210908298369485,0,0,9.203039169311523,7.365152359008789,8,8
1795,16,4.287588057512692,4.439656631127151,1.024703319336202,1.023782695744957,5,5,9.86329174041748,7.365152359008789,11,11
1795,32,3.41594139056062,4.334399022535588,1.0239650895478092,1.0291386304526113,11,17,10.966412544250488,7.365152359008789,21,15
1795,64,3.013324793441961,4.220822957808386,1.0134465738979195,1.034067154675642,32,44,11.748876571655273,7.365152359008789,32,20
1795,128,1.7424748415343683,4.178951457116724,1.0035511478234507,1.035610899623795,65,107,12.640222549438477,7.365152359008789,63,21
1796,1,7.976431573568423,7.976431573568425,0.9641161598232867,0.9641161598232889,0,0,8.046210289001465,8.046210289001465,1,1
1796,2,7.125203515539357,7.125203515539358,0.9847968013068885,0.9847968013068897,0,0,9.661917686462402,8.046210289001465,2,2
1796,3,7.092903154494227,7.092903154494227,0.987470336305086,0.9874703363050868,0,0,10.172660827636719,8.046210289001465,3,3
1796,4,6.7620223046242725,6.762201653753971,0.9937594776649188,0.9938966561699171,1,1,10.454492568969727,8.046210289001465,3,3
1796,8,5.562204617608785,5.646561738585423,1.0138532703752725,1.0183407023142101,1,2,11.179508209228516,8.046210289001465,7,6
1796,16,5.278473089684346,5.577138898036818,1.0168847883295526,1.0226340591976129,5,7,11.763775825500488,8.046210289001465,11,9
1796,32,4.400411834326037,5.568967882508413,1.0132011923455608,1.023715179961517,16,21,12.502690315246582,8.046210289001465,16,11
1796,64,3.3568981840338927,5.37974646577546,1.014731530784562,1.0351827604738486,29,52,13.43278694152832,8.046210289001465,35,12
1796,128,1.8527516910774051,5.227103168955936,1.005019663603742,1.0370235480132841,58,115,14.169342994689941,8.046210289001465,70,13
1797,1,8.521492560072831,8.521492560072836,0.9536449264067073,0.9536449264067087,0,0,8.633106231689453,8.633106231689453,1,1
1797,2,7.4077142011978285,7.407714201197829,0.9790606044216233,0.9790606044216243,0,0,9.067574501037598,8.633106231689453,2,2
1797,3,6.787148794367096,6.787148794367096,0.991506489864098,0.991506489864098,0,0,9.22991943359375,8.633106231689453,3,3
1797,4,6.498215479406562,6.498215479406562,0.9980054762431146,0.9980054762431141,0,0,9.232695579528809,8.633106231689453,4,4
1797,8,5.801288474586783,5.855615734453881,1.0093200921944319,1.0084753786874108,1,1,9.696393966674805,8.633106231689453,7,7
1797,16,5.066886564524476,5.1731855161945495,1.0229912158035608,1.021990261249426,5,6,10.238279342651367,8.633106231689453,11,10
1797,32,4.060031658931937,5.103249808413303,1.0206129570741242,1.0240532528670439,9,20,11.007379531860352,8.633106231689453,23,12
1797,64,2.916857785920504,5.0185804191284635,1.0084702566322328,1.0286511779597314,28,49,11.84252643585205,8.633106231689453,36,15
1797,128,1.8752248714010162,4.918607698290483,1.0038758776182723,1.0333682594521796,64,109,12.616620063781738,8.633106231689453,64,19
1798,1,7.650910199295588,7.650910199295589,0.9681346512081179,0.9681346512081183,0,0,7.710208415985107,7.710208415985107,1,1
1798,2,5.932057503402894,5.932057503402894,0.9929937575530956,0.992993757553096,0,0,8.58756160736084,7.710208415985107,2,2
1798,3,5.766700326339371,5.76670032633937,0.9951780550886289,0.9951780550886293,0,0,8.605170249938965,7.710208415985107,3,3
1798,4,5.546532520609195,5.546532520609197,1.0004487407048248,1.0004487407048246,0,0,9.048934936523438,7.710208415985107,4,4
1798,8,5.262573155431545,5.321134292668544,1.0084672758396813,1.0086505029932293,1,1,9.645837783813477,7.710208415985107,7,7
1798,16,4.79544298846916,5.08247502395553,1.0143714560712813,1.0164991313857206,4,6,10.362433433532715,7.710208415985107,12,10
1798,32,3.840717103869052,4.758347447936637,1.020491758772515,1.02356479954662,12,19,11.545308113098145,7.710208415985107,20,13
1798,64,3.028252863274775,4.758311608558293,1.008957775300531,1.0236387277140495,27,50,12.145623207092285,7.710208415985107,37,14
1798,128,1.7756778289180402,4.6046299102136565,1.005576780284128,1.0307756748206072,66,113,12.994758605957031,7.710208415985107,62,15
1799,1,4.399429161216577,4.399429161216579,0.9890731260545235,0.9890731260545248,0,0,4.412114143371582,4.412114143371582,1,1
1799,2,3.1052307964806527,3.105230796480652,1.0023492576705473,1.0023492576705486,0,0,5.099820613861084,4.412114143371582,2,2
1799,3,2.91898698035309,2.918986980353094,1.0036289938263112,1.0036289938263123,0,0,5.291858196258545,4.412114143371582,3,3
1799,4,2.7131946991992275,2.7131946991992266,1.006164850566153,1.0061648505661533,0,0,5.4534831047058105,4.412114143371582,4,4
1799,8,2.322668181693052,2.4439406300105677,1.0092550777733327,1.0097402503086514,1,1,5.801031589508057,4.412114143371582,7,7
1799,16,2.1589571076068736,2.358675468673399,1.0100256774453682,1.0113346900337532,5,7,6.3449811935424805,4.412114143371582,11,9
1799,32,1.8403771455295115,2.339374418076016,1.0059445551087123,1.0119022706819876,15,22,7.006527900695801,4.412114143371582,17,10
1799,64,1.325654674116651,2.3332964249265165,1.0030151713324729,1.012472366017821,25,52,7.542984962463379,4.412114143371582,39,12
1799,128,0.5964588294749283,2.329089261263371,0.9996239371479753,1.0127354806753028,65,115,8.39642333984375,4.412114143371582,63,13
1800,1,11.266092908599227,11.26609290859923,0.9436838578813374,0.9436838578813398,0,0,11.391563415527344,11.391563415527344,1,1
1800,2,9.820951124323967,9.820951124323967,0.9826183534697572,0.9826183534697592,0,0,11.898056983947754,11.391563415527344,2,2
1800,3,9.73292047986595,9.73292047986595,0.9851505071079404,0.9851505071079419,0,0,12.03010368347168,11.391563415527344,3,3
1800,4,8.906931771489333,8.906931771489335,1.0075020371551995,1.0075020371552006,0,0,12.526166915893555,11.391563415527344,4,4
1800,8,7.827651776287799,8.060152458404827,1.031445678028844,1.0350065524258318,1,1,13.591784477233887,11.391563415527344,7,7
1800,16,7.098728109302998,7.825162155785384,1.038333034479317,1.0461325363769842,5,4,14.620474815368652,11.391563415527344,11,12
1800,32,6.268222670375843,7.228182770476266,1.053216503453116,1.0682689909128533,10,15,15.151833534240723,11.391563415527344,22,17
1800,64,4.939757940967563,7.128286765076923,1.0458959889083288,1.0745189584670178,26,43,15.722736358642578,11.391563415527344,38,21
1800,128,3.106183234873818,6.970964911204793,1.0224844674505842,1.0811786562089258,65,104,16.336606979370117,11.391563415527344,63,24
1801,1,12.558978308831477,12.558978308831483,0.9043607188777808,0.9043607188777838,0,0,12.870691299438477,12.870691299438477,1,1
1801,2,8.783135084538566,8.783135084538566,1.008900062667016,1.0089000626670177,0,0,13.037338256835938,12.870691299438477,2,2
1801,3,8.578038916805035,8.578038916805035,1.012147825935444,1.0121478259354448,0,0,13.104223251342773,12.870691299438477,3,3
1801,4,8.558887831542666,8.558887831542691,1.0128773048446136,1.0128773048446147,0,0,13.168024063110352,12.870691299438477,4,4
1801,8,8.442209325629749,8.451816813487685,1.0188641630984445,1.0181820350531758,2,2,14.599686622619629,12.870691299438477,6,6
1801,16,7.755602486645419,8.123836804348272,1.0366541135547034,1.0350949478984477,4,8,15.397820472717285,12.870691299438477,12,8
1801,32,6.343487473625713,8.013753387058076,1.0276197557876459,1.0403331417950281,12,21,16.251827239990234,12.870691299438477,20,11
1801,64,5.345417483190556,8.007499943517258,1.0179606246290278,1.0421215220517066,29,51,17.554716110229492,12.870691299438477,35,13
1801,128,3.066606316916215,7.983421271236067,1.010493269657898,1.047569569845527,58,115,18.730693817138672,12.870691299438477,70,13
1802,1,8.54045663164873,8.540456631648713,0.968864819643787,0.96886481964379,0,0,8.590720176696777,8.590720176696777,1,1
1802,2,6.066463761202117,6.066463761202115,1.0066750700806446,1.006675070080648,0,0,8.883731842041016,8.590720176696777,2,2
1802,3,5.999823189175649,5.999823189175648,1.0082513249616392,1.0082513249616425,0,0,9.611434936523438,8.590720176696777,3,3
1802,4,5.710607910036916,5.710607910036916,1.013037941966148,1.0130379419661506,0,0,10.1790771484375,8.590720176696777,4,4
1802,8,4.943037158061115,4.943037158061116,1.0307395203662875,1.0307395203662895,0,0,11.157495498657227,8.590720176696777,8,8
1802,16,4.697811551339113,4.810622046449786,1.0345660720658614,1.035717847210757,4,5,11.992055892944336,8.590720176696777,12,11
1802,32,3.906065292564651,4.769386666178333,1.0235502225915365,1.0370982685636712,12,19,12.55109977722168,8.590720176696777,20,13
1802,64,2.957014330341003,4.746621094613558,1.0154254995361676,1.0385986018186435,31,50,13.207795143127441,8.590720176696777,33,14
1802,128,1.8527585413945171,4.6997300799616095,1.005687640348067,1.0424133992868323,63,114,14.060521125793457,8.590720176696777,65,14
1803,1,7.3548091016961825,7.354809101696187,0.9726198360620117,0.9726198360620142,0,0,7.400484085083008,7.400484085083008,1,1
1803,2,6.121640683099043,6.121640683099045,0.9909023815115716,0.9909023815115733,0,0,8.056190490722656,7.400484085083008,2,2
1803,3,5.745411017285277,5.745411017285277,0.9977209751374665,0.9977209751374676,0,0,8.35158920288086,7.400484085083008,3,3
1803,4,5.473065292761464,5.473065292761464,1.003187157534382,1.0031871575343834,0,0,8.744996070861816,7.400484085083008,4,4
1803,8,4.849425511347496,4.850155676396355,1.0162569455658899,1.0162565397139494,1,1,8.98850154876709,7.400484085083008,7,7
1803,16,4.403562744160814,4.705352467949271,1.0183366566107686,1.0205902071542872,5,6,9.890408515930176,7.400484085083008,11,10
1803,32,3.7306700386502527,4.610221739370391,1.012361215496856,1.0243616797137594,14,20,10.603484153747559,7.400484085083008,18,12
1803,64,2.998695699068172,4.53211271907305,1.0053974169868432,1.0290227152272209,31,49,11.131470680236816,7.400484085083008,33,15
1803,128,1.6027427137327557,4.436776347775782,1.0029160318563317,1.0317912039187573,61,110,11.885866165161133,7.400484085083008,67,18
1804,1,9.344027069720894,9.344027069720896,0.9566114268129396,0.9566114268129412,0,0,9.431004524230957,9.431004524230957,1,1
1804,2,7.293882922873485,7.293882922873485,0.9880463760426054,0.9880463760426057,0,0,9.732030868530273,9.431004524230957,2,2
1804,3,7.107073049709616,7.107073049709616,0.990740370790799,0.9907403707907984,0,0,9.749726295471191,9.431004524230957,3,3
1804,4,7.101126447453045,7.101126447453045,0.9909514787564303,0.9909514787564303,0,0,9.817521095275879,9.431004524230957,4,4
1804,8,6.4494319741447415,6.468127492194792,1.0052237372986945,1.0049460069504015,1,2,10.184995651245117,9.431004524230957,7,6
1804,16,6.19816916839899,6.3496451308491135,1.0101079333178573,1.0089997347851185,6,7,10.641478538513184,9.431004524230957,10,9
1804,32,4.784532510954167,5.95807768941411,1.021551351230705,1.0197916078538816,15,17,11.22330093383789,9.431004524230957,17,15
1804,64,3.6707826117596776,5.751432305332277,1.0229168318936939,1.027688311326734,29,46,11.833842277526855,9.431004524230957,35,18
1804,128,2.039787241772631,5.37078611590684,1.0096800715058118,1.0434753354231923,63,108,12.519277572631836,9.431004524230957,65,20
1805,1,7.893750268860859,7.8937502688608365,0.959425627694396,0.9594256276943981,0,0,7.988778591156006,7.988778591156006,1,1
1805,2,7.139630178675078,7.13963017867508,0.9742886014809264,0.9742886014809284,0,0,8.371123313903809,7.988778591156006,2,2
1805,3,7.028316370530783,7.028316370530786,0.9781269191315879,0.9781269191315902,0,0,8.455358505249023,7.988778591156006,3,3
1805,4,6.715825260138721,6.715825260138723,0.9847682882302787,0.9847682882302803,0,0,8.504589080810547,7.988778591156006,4,4
1805,8,6.299748175183691,6.316027610304689,0.9933112911726192,0.9919024393536251,1,1,8.939752578735352,7.988778591156006,7,7
1805,16,5.13573818520544,5.44661965976588,1.012234620003706,1.0113537434834292,4,6,9.752824783325195,7.988778591156006,12,10
1805,32,3.958853679329582,5.3004636239658565,1.0088136574355606,1.0160280120158358,16,20,10.2251615524292,7.988778591156006,16,12
1805,64,2.5796423133212723,5.057871753235565,1.007252200571943,1.0226946008290865,31,52,11.092930793762207,7.988778591156006,33,12
1805,128,1.4643375623912973,5.057871753235566,1.0036957481981759,1.0226946008290863,61,116,11.860269546508789,7.988778591156006,67,12
1806,1,4.11250006894345,4.112500068943453,0.9880488896716693,0.9880488896716716,0,0,4.128889560699463,4.128889560699463,1,1
1806,2,2.873999847312987,2.873999847312988,0.9980404001295375,0.9980404001295399,0,0,4.710699558258057,4.128889560699463,2,2
1806,3,2.8674502719814563,2.8674502719814576,0.9983222431214661,0.9983222431214679,0,0,5.985621929168701,4.128889560699463,3,3
1806,4,2.6444440549193238,2.6549348757405427,1.0012178080117633,1.001304693145068,1,1,6.016941547393799,4.128889560699463,3,3
1806,8,2.4244649036289427,2.505570624489163,1.0024879353005876,1.0036334920945142,3,3,6.408041000366211,4.128889560699463,5,5
1806,16,2.1588894312490994,2.40137267346384,1.0043376300272508,1.0065729612736032,7,7,7.282166957855225,4.128889560699463,9,9
1806,32,1.8013660956661999,2.2769276679795247,1.0061321287175193,1.0099659298695722,14,22,8.080337524414062,4.128889560699463,18,10
1806,64,1.3115851199875563,2.215615389662497,1.0038548095910755,1.0117515702638922,29,49,8.760340690612793,4.128889560699463,35,15
1806,128,0.7921625639317009,2.187486823994428,1.0017607877689108,1.0129508979128552,62,111,9.472064018249512,4.128889560699463,66,17
1807,1,7.981231698635765,7.981231698635773,0.954275231961441,0.9542752319614437,0,0,8.096832275390625,8.096832275390625,1,1
1807,2,6.980894944989774,6.9808949449897755,0.9796798670799329,0.9796798670799345,0,0,9.719266891479492,8.096832275390625,2,2
1807,3,5.941647475731638,5.941647475731638,0.9989775736770774,0.998977573677078,0,0,9.79169750213623,8.096832275390625,3,3
1807,4,5.847499497582634,5.8474994975826355,1.0035721183104445,1.0035721183104453,0,0,9.928045272827148,8.096832275390625,4,4
1807,8,5.727762706835512,5.7447491043053125,1.010053346614314,1.010123166694967,1,1,11.010093688964844,8.096832275390625,7,7
1807,16,5.38173098107708,5.6500489970133865,1.0097011523587598,1.0150334369424556,7,7,11.953544616699219,8.096832275390625,9,9
1807,32,4.591824564175034,5.521303263792786,1.0145507728520242,1.0219887910564673,12,22,12.57289981842041,8.096832275390625,20,10
1807,64,3.516148692830275,5.444444704427023,1.0176406653401586,1.029271872599973,30,52,13.320188522338867,8.096832275390625,34,12
1807,128,2.204430463700397,5.382512346075663,1.0042045751994917,1.0321017196640372,56,115,14.170967102050781,8.096832275390625,72,13
1808,1,9.918234696210648,9.91823469621065,0.9302210243964089,0.9302210243964091,0,0,10.141685485839844,10.141685485839844,1,1
1808,2,8.05990057263641,8.05990057263641,0.9746260179187066,0.9746260179187068,0,0,10.231579780578613,10.141685485839844,2,2
1808,3,7.726533306619435,7.726533306619434,0.9841235242927795,0.9841235242927786,0,0,10.423129081726074,10.141685485839844,3,3
1808,4,7.620734972379065,7.726533306619434,0.9822802213904813,0.9841235242927786,1,1,11.244213104248047,10.141685485839844,3,3
1808,8,6.897006122583308,7.057856641778968,1.0042410486253188,1.004691893909978,2,4,12.43212890625,10.141685485839844,6,4
1808,16,6.439201380947302,6.869455120896804,1.0136874640423525,1.014932115049873,6,8,12.879928588867188,10.141685485839844,10,8
1808,32,5.322765642662672,6.499213497432472,1.0184985074790367,1.0295572626214482,12,24,13.874250411987305,10.141685485839844,20,8
1808,64,4.066232545907322,6.261788535851755,1.0117147641592052,1.0406465492939372,29,54,15.008400917053223,10.141685485839844,35,10
1808,128,2.6050751234429734,6.14101614618746,1.0046527654887956,1.0471288428169394,67,115,16.300769805908203,10.141685485839844,61,13
1809,1,5.60392885570401,5.60392885570401,0.9836753440252372,0.9836753440252375,0,0,5.626185894012451,5.626185894012451,1,1
1809,2,4.156437252700442,4.156437252700441,0.9983949001855676,0.9983949001855672,0,0,5.831284999847412,5.626185894012451,2,2
1809,3,3.8239494517694754,3.8239494517694754,1.003903085834086,1.003903085834086,0,0,6.587153911590576,5.626185894012451,3,3
1809,4,3.3914141195385157,3.391414119538516,1.0072486492176247,1.0072486492176247,0,0,6.62387752532959,5.626185894012451,4,4
1809,8,3.1940740550540507,3.2549781750785556,1.0085967862769616,1.008185366605265,2,2,6.858755588531494,5.626185894012451,6,6
1809,16,2.9798145419443003,3.20711212912745,1.0080902959438782,1.0094904190637428,6,9,7.346145153045654,5.626185894012451,10,7
1809,32,2.530700706526804,3.0106626451929213,1.0065954421857441,1.0141859251928884,13,21,7.7036638259887695,5.626185894012451,19,11
1809,64,1.6369952099597738,3.006696162605249,1.002000708152409,1.0145706318763994,31,51,8.370024681091309,5.626185894012451,33,13
1809,128,0.7552719475158708,2.968541814138731,1.001305629750474,1.017178824649147,64,111,8.967047691345215,5.626185894012451,64,17
1810,1,9.552031874002246,9.55203187400225,0.9581177691725175,0.9581177691725201,0,0,9.629790306091309,9.629790306091309,1,1
1810,2,7.2015100300093575,7.201510030009357,1.0033877960909177,1.0033877960909199,0,0,9.855660438537598,9.629790306091309,2,2
1810,3,6.531552342289349,6.531552342289348,1.0160268129386063,1.0160268129386085,0,0,10.482502937316895,9.629790306091309,3,3
1810,4,6.041454777637873,6.041454777637871,1.025640561379623,1.0256405613796247,0,0,11.026686668395996,9.629790306091309,4,4
1810,8,5.541366789325512,5.575973150342246,1.0330992869608995,1.0346292355400895,2,2,11.776700973510742,9.629790306091309,6,6
1810,16,5.113187503857466,5.480676112779929,1.0368138873460908,1.0383891004072687,5,6,12.225074768066406,9.629790306091309,11,10
1810,32,4.797975783271033,5.424206453467442,1.0398192210400787,1.0426156179318207,13,19,12.898399353027344,9.629790306091309,19,13
1810,64,3.942508806264957,5.373959488261682,1.02650579797644,1.0456097011671117,30,48,13.677454948425293,9.629790306091309,34,16
1810,128,2.4381443691895877,5.365407452519094,1.0046224583117795,1.0474522557669097,63,110,14.560381889343262,9.629790306091309,65,18
1811,1,9.611061338305863,9.611061338305866,0.9448621368032498,0.9448621368032514,0,0,9.750150680541992,9.750150680541992,1,1
1811,2,8.646900885386703,8.646900885386705,0.9682134666059248,0.9682134666059263,0,0,9.957419395446777,9.750150680541992,2,2
1811,3,8.397254192083174,8.397254192083176,0.9749238455237725,0.9749238455237732,0,0,10.203131675720215,9.750150680541992,3,3
1811,4,7.122770563193639,7.124790192019772,1.0050717260991386,1.0050443516569574,1,1,10.639780044555664,9.750150680541992,3,3
1811,8,6.245320340340805,6.28940702471116,1.028328118103527,1.0292154210058435,1,1,12.322590827941895,9.750150680541992,7,7
1811,16,5.940163201756478,6.134447994998965,1.0354388263679528,1.0349468281381498,4,5,12.475349426269531,9.750150680541992,12,11
1811,32,5.410320969912852,6.003352993823504,1.0309371831506273,1.0387350030992222,12,19,13.344751358032227,9.750150680541992,20,13
1811,64,4.2126187888918105,5.830627202827455,1.0260711875264825,1.0497700524654776,28,48,14.315382957458496,9.750150680541992,36,16
1811,128,2.5662153086124624,5.797347961121364,1.0088476154501032,1.0522479208507507,61,110,15.079460144042969,9.750150680541992,67,18
1812,1,6.0823778199708265,6.0823778199708265,0.9814538100610176,0.9814538100610178,0,0,6.107693672180176,6.107693672180176,1,1
1812,2,5.278831340900555,5.278831340900555,0.9920939464675496,0.9920939464675493,0,0,6.161558151245117,6.107693672180176,2,2
1812,3,4.779719472338716,4.779719472338716,0.9984619473338939,0.9984619473338933,0,0,6.461287975311279,6.107693672180176,3,3
1812,4,4.279854123428116,4.279854123428116,1.0029266023409988,1.0029266023409993,0,0,6.877701282501221,6.107693672180176,4,4
1812,8,3.9767286681093585,4.016453522308327,1.0069132359983848,1.007085598834708,2,2,7.839231491088867,6.107693672180176,6,6
1812,16,3.4198921436387617,3.6081265068552244,1.0153702507147542,1.0152301025609365,6,7,8.287934303283691,6.107693672180176,10,9
1812,32,2.9478409874248457,3.5256868471569094,1.010742069044377,1.0172622060306364,11,19,8.803513526916504,6.107693672180176,21,13
1812,64,2.2286313698460134,3.4886162735550084,1.0045626211285699,1.0184334606124104,37,49,9.436614990234375,6.107693672180176,27,15
1812,128,1.113590287955886,3.455850706063003,1.0013730086626083,1.0193447869710885,66,111,10.250127792358398,6.107693672180176,62,17
1813,1,11.944596883628613,11.944596883628616,0.9084298457798804,0.9084298457798821,0,0,12.235993385314941,12.235993385314941,1,1
1813,2,10.583185336815863,10.583185336815864,0.9545841820196803,0.9545841820196812,0,0,14.110306739807129,12.235993385314941,2,2
1813,3,9.708836464340818,9.70883646434082,0.9805306983967115,0.9805306983967129,0,0,14.231925010681152,12.235993385314941,3,3
1813,4,9.597575638749468,9.59757563874947,0.9834972531139148,0.9834972531139158,0,0,14.536226272583008,12.235993385314941,4,4
1813,8,9.388529008619464,9.444236743934134,0.9940686252266613,0.9915230327129465,1,1,14.649726867675781,12.235993385314941,7,7
1813,16,8.817547104019827,9.055428653698415,1.0110640485707132,1.0048359665333697,6,7,15.235608100891113,12.235993385314941,10,9
1813,32,7.721035595398842,8.28698246919582,1.0410490326608162,1.0391573075933647,13,20,15.65280532836914,12.235993385314941,19,12
1813,64,6.014867256777821,8.225473656011548,1.0383682610524103,1.0449939094061818,28,47,16.107711791992188,12.235993385314941,36,17
1813,128,4.013270187247766,8.13015816612554,1.0203290568114791,1.0496415795911573,60,109,16.660390853881836,12.235993385314941,68,19
1814,1,9.367115205113697,9.367115205113697,0.9467162795042816,0.9467162795042814,0,0,9.50546646118164,9.50546646118164,1,1
1814,2,7.7779045847680415,7.777904584768041,0.9810480934720922,0.9810480934720912,0,0,9.513846397399902,9.50546646118164,2,2
1814,3,7.446700841010605,7.446700841010605,0.9880458121635375,0.9880458121635375,0,0,9.598273277282715,9.50546646118164,3,3
1814,4,7.444052920350771,7.444052920350771,0.9880499109212362,0.9880499109212363,0,0,10.082927703857422,9.50546646118164,4,4
1814,8,6.792790647249511,7.005474899014085,0.9992932227551667,0.9951065534676731,1,3,10.38300609588623,9.50546646118164,7,5
1814,16,5.839531081582578,6.50015538648847,1.0171766808116736,1.0076357738465331,6,9,10.87816333770752,9.50546646118164,10,7
1814,32,4.060561153496902,6.4084571444648475,1.018009397540874,1.0094814747761713,14,24,11.284714698791504,9.50546646118164,18,8
1814,64,3.163434925120272,6.208478395479668,1.0100792775990335,1.0161834744708396,32,52,11.876677513122559,9.50546646118164,32,12
1814,128,1.791709023841098,6.122809690849896,1.0021270628718897,1.0232686964685676,67,112,12.528685569763184,9.50546646118164,61,16
1815,1,6.01342777022488,6.01342777022488,0.980508063731105,0.9805080637311067,0,0,6.041844844818115,6.041844844818115,1,1
1815,2,4.864607555210818,4.864607555210819,0.9959649509882713,0.9959649509882722,0,0,6.466416835784912,6.041844844818115,2,2
1815,3,3.9071865472972074,3.907186547297206,1.0085281659306955,1.008528165930697,0,0,7.246514797210693,6.041844844818115,3,3
1815,4,3.9025824761243553,3.902582476124354,1.0088537014905279,1.0088537014905297,0,0,7.4821319580078125,6.041844844818115,4,4
1815,8,3.5633148815666864,3.5808470196404776,1.0149462896422354,1.014640078158856,1,1,8.071623802185059,6.041844844818115,7,7
1815,16,3.32617436966241,3.409588128110604,1.019258210138779,1.017979401975794,3,5,8.673807144165039,6.041844844818115,13,11
1815,32,3.0221201484663065,3.409588128110604,1.0138233314727594,1.017979401975794,13,21,9.363168716430664,6.041844844818115,19,11
1815,64,2.5434308415896383,3.3906089280058658,1.0097924693911502,1.0195097984338028,26,50,10.049217224121094,6.041844844818115,38,14
1815,128,1.6095154927668005,3.3906004912383856,1.0036847624782033,1.0195277114758068,61,113,10.894540786743164,6.041844844818115,67,15
1816,1,6.414586709917972,6.414586709917977,0.976297336492201,0.9762973364922031,0,0,6.454511642456055,6.454511642456055,1,1
1816,2,5.915282447323157,5.915282447323157,0.9847639216867656,0.9847639216867667,0,0,6.624634265899658,6.454511642456055,2,2
1816,3,5.664749211726812,5.664749211726812,0.9890704735827707,0.9890704735827722,0,0,7.221611499786377,6.454511642456055,3,3
1816,4,5.3832091456261155,5.383209145626108,0.9934869977807943,0.9934869977807949,0,0,7.64588737487793,6.454511642456055,4,4
1816,8,4.500783491735242,4.66136025244665,1.0075537718676915,1.0087090509607322,1,1,8.111335754394531,6.454511642456055,7,7
1816,16,4.163893694423401,4.342618068203178,1.0113226098641726,1.0128935505956802,6,6,8.744306564331055,6.454511642456055,10,10
1816,32,3.4837048079703314,4.253600805993511,1.011556164922823,1.0158571215142698,12,20,9.261837005615234,6.454511642456055,20,12
1816,64,2.114866260568644,4.122315697353076,1.0038464514666046,1.0191305464204152,32,49,9.698132514953613,6.454511642456055,32,15
1816,128,1.155107059431737,4.099156097330981,1.0004395252457345,1.020851178058128,63,108,10.247901916503906,6.454511642456055,65,20
1817,1,7.475848778477261,7.4758487784772685,0.9577423453537657,0.957742345353768,0,0,7.582184791564941,7.582184791564941,1,1
1817,2,6.395029250442432,6.395029250442434,0.9753199279091307,0.9753199279091318,0,0,7.740267753601074,7.582184791564941,2,2
1817,3,5.775766971707634,5.775766971707635,0.989274179149553,0.9892741791495543,0,0,8.103706359863281,7.582184791564941,3,3
1817,4,5.040061648507483,5.040061648507482,1.002065613712829,1.00206561371283,0,0,9.221847534179688,7.582184791564941,4,4
1817,8,4.637142417082936,4.924312092416309,1.0056349938301903,1.0066514627433099,2,2,10.550065994262695,7.582184791564941,6,6
1817,16,4.4402084520434455,4.889797754624749,1.0057395613808922,1.0072420169931628,7,9,11.069157600402832,7.582184791564941,9,7
1817,32,3.8280455035975214,4.682740082765591,1.0133562813610524,1.0143513238606632,14,24,11.972208976745605,7.582184791564941,18,8
1817,64,2.6357616374827595,4.624220376702108,1.0039672156442978,1.0191769091059966,32,52,12.681838989257812,7.582184791564941,32,12
1817,128,1.723581897148193,4.593829884673913,1.0039689227633246,1.0228640307559995,67,115,13.978349685668945,7.582184791564941,61,13
1818,1,7.995776616739464,7.9957766167394695,0.9641240349282212,0.9641240349282242,0,0,8.067937850952148,8.067937850952148,1,1
1818,2,6.358375429563398,6.3583754295634005,0.9929475629528666,0.9929475629528686,0,0,8.160582542419434,8.067937850952148,2,2
1818,3,5.267793769240464,5.2677937692404635,1.0094974640701182,1.00949746407012,0,0,8.30945110321045,8.067937850952148,3,3
1818,4,5.055020427544151,5.05502042754415,1.0122527196125903,1.0122527196125923,0,0,8.52259349822998,8.067937850952148,4,4
1818,8,4.4218793358946415,4.421879335894643,1.0193510719180416,1.0193510719180412,0,0,9.280436515808105,8.067937850952148,8,8
1818,16,4.189791352508744,4.304995766881311,1.0224557366679088,1.0222940938972462,5,6,9.626506805419922,8.067937850952148,11,10
1818,32,3.4162005278548593,4.18413619872409,1.0190427320797617,1.0248756265442145,16,20,9.942286491394043,8.067937850952148,16,12
1818,64,2.7779715965998326,4.1589751393027,1.0150173354226655,1.02596820586681,31,45,10.729863166809082,8.067937850952148,33,19
1818,128,1.4804713835096344,4.1522276623459735,1.0028545034548346,1.0268435284831874,68,108,11.47990894317627,8.067937850952148,60,20
1819,1,10.48715016924217,10.487150169242122,0.9421763643699383,0.9421763643699408,0,0,10.62615966796875,10.62615966796875,1,1
1819,2,9.3399158310143,9.339915831014304,0.9661175704815628,0.9661175704815641,0,0,10.822066307067871,10.62615966796875,2,2
1819,3,8.19429731151157,8.194297311511571,0.9914879834140731,0.9914879834140731,0,0,10.881950378417969,10.62615966796875,3,3
1819,4,8.177882311720712,8.177882311720714,0.9922445263425164,0.9922445263425174,0,0,11.1444091796875,10.62615966796875,4,4
1819,8,7.0609458298069026,7.060945829806901,1.0147789589282272,1.0147789589282294,0,0,11.516526222229004,10.62615966796875,8,8
1819,16,6.353532348943724,6.557969536003569,1.0299282951504403,1.0281911244603101,3,3,11.953866958618164,10.62615966796875,13,13
1819,32,5.068910283944467,6.330752326425344,1.031146336400155,1.0330712748698687,13,17,12.597825050354004,10.62615966796875,19,15
1819,64,3.635480227642479,5.785460050248194,1.023932624288963,1.048959230395268,28,46,13.151259422302246,10.62615966796875,36,18
1819,128,2.056665552086026,5.754833640091947,1.0083292567452355,1.0507992859081672,63,110,13.84902572631836,10.62615966796875,65,18
1820,1,2.951108839498792,2.9511088394987937,0.9965801736554117,0.9965801736554128,0,0,2.953001022338867,2.953001022338867,1,1
1820,2,2.675794184231566,2.6757941842315662,0.9984306654587353,0.9984306654587358,0,0,3.1181907653808594,2.953001022338867,2,2
1820,3,2.4367281760624366,2.4367281760624366,1.0006999960623726,1.0006999960623728,0,0,3.1625139713287354,2.953001022338867,3,3
1820,4,2.332514252754193,2.332514252754193,1.0009307666258451,1.0009307666258456,0,0,3.1765570640563965,2.953001022338867,4,4
1820,8,1.983155601736378,1.9900896160987833,1.0027007782299946,1.0026005154640794,2,2,3.359231948852539,2.953001022338867,6,6
1820,16,1.6142192339533425,1.6667994835350375,1.0047267515333704,1.0044910381920205,5,8,3.6084320545196533,2.953001022338867,11,8
1820,32,1.3065472088714367,1.6131953071349359,1.00288259735702,1.004786505302342,16,21,4.0042338371276855,2.953001022338867,16,11
1820,64,0.8491070133378875,1.589019345544465,1.002359206734528,1.0053829626194866,30,52,4.412667274475098,2.953001022338867,34,12
1820,128,0.17731655519793027,1.5693469486575697,0.9998743878884102,1.006307619108857,64,111,5.042974948883057,2.953001022338867,64,17
1821,1,8.197169303813473,8.197169303813473,0.9586283263131979,0.9586283263131977,0,0,8.291342735290527,8.291342735290527,1,1
1821,2,6.444880210185078,6.444880210185079,0.9881094246307363,0.9881094246307365,0,0,8.338781356811523,8.291342735290527,2,2
1821,3,6.271764037645803,6.271764037645803,0.9922841825246772,0.9922841825246773,0,0,8.445741653442383,8.291342735290527,3,3
1821,4,5.767919380455321,5.767919380455321,1.000551534356678,1.0005515343566775,0,0,8.654916763305664,8.291342735290527,4,4
1821,8,5.493778461618416,5.501275916383106,1.0072073576168272,1.0070769312597296,1,1,9.037199020385742,8.291342735290527,7,7
1821,16,4.4727600368515095,4.647552938022173,1.025282156250451,1.0231807056442968,7,8,9.480384826660156,8.291342735290527,9,8
1821,32,3.8542672036031442,4.548871738427246,1.0247387532121,1.025618557977929,12,19,9.952618598937988,8.291342735290527,20,13
1821,64,2.8038902056576704,4.327341076063922,1.0122284825729717,1.0275182904713427,28,52,10.75806713104248,8.291342735290527,36,12
1821,128,1.3391282141321954,4.314060134923339,1.0015607797422983,1.0288774872199629,61,114,11.46500015258789,8.291342735290527,67,14
1822,1,10.215541116037931,10.215541116037933,0.9434924537230563,0.9434924537230585,0,0,10.356244087219238,10.356244087219238,1,1
1822,2,9.629479279817659,9.629479279817662,0.9619117568839328,0.9619117568839339,0,0,11.251006126403809,10.356244087219238,2,2
1822,3,8.674269715519593,8.674269715519596,0.9821537721834965,0.9821537721834985,0,0,11.30737018585205,10.356244087219238,3,3
1822,4,8.617454836703361,8.61745483670336,0.9831276864318037,0.9831276864318053,0,0,11.432849884033203,10.356244087219238,4,4
1822,8,7.526273859801049,7.5294117305914385,1.0062281922852543,1.0068191150957397,1,2,11.902962684631348,10.356244087219238,7,6
1822,16,7.129233553110619,7.374082435202809,1.0081565394261807,1.0118036638707526,6,9,12.41016674041748,10.356244087219238,10,7
1822,32,5.995648474065558,7.057336384267207,1.013370694755198,1.0222773332962947,11,22,13.100866317749023,10.356244087219238,21,10
1822,64,4.157878849490614,6.614025273055484,1.0123977860859437,1.0358396233766385,30,52,13.661185264587402,10.356244087219238,34,12
1822,128,2.370617180030925,6.443529438942704,1.0051910156106514,1.0429629520748747,58,114,14.305890083312988,10.356244087219238,70,14
1823,1,8.089602273966946,8.089602273966948,0.9624397764607976,0.9624397764607986,0,0,8.167680740356445,8.167680740356445,1,1
1823,2,7.0146829989179125,7.014682998917913,0.9751864224427573,0.9751864224427584,0,0,9.27248764038086,8.167680740356445,2,2
1823,3,6.613577860548729,6.613577860548731,0.9846351506676132,0.9846351506676145,0,0,9.723664283752441,8.167680740356445,3,3
1823,4,6.396959222620433,6.396959222620434,0.989999060729331,0.9899990607293317,0,0,9.810396194458008,8.167680740356445,4,4
1823,8,5.930590023404675,5.930590023404675,1.00270674636032,1.0027067463603219,0,0,10.515514373779297,8.167680740356445,8,8
1823,16,5.564005890603062,5.728546420917874,1.0085190735195422,1.0107309129370439,4,7,10.732732772827148,8.167680740356445,12,9
1823,32,4.50489900043158,5.72659937302809,1.0105194230725918,1.0107996793219514,13,23,11.173702239990234,8.167680740356445,19,9
1823,64,3.4516082540086437,5.601251348364941,1.01236844972225,1.0143460102126505,33,51,11.474084854125977,8.167680740356445,31,13
1823,128,2.055835816825302,5.410677533244128,1.0061413432336843,1.0228242061499047,62,110,11.834460258483887,8.167680740356445,66,18
1824,1,8.783721352757803,8.783721352757805,0.9612909604945655,0.9612909604945665,0,0,8.858894348144531,8.858894348144531,1,1
1824,2,7.411838420854181,7.411838420854182,0.986649802982039,0.9866498029820396,0,0,8.8867826461792,8.858894348144531,2,2
1824,3,6.686367516015078,6.6863675160150775,1.000378816612809,1.0003788166128098,0,0,8.901684761047363,8.858894348144531,3,3
1824,4,5.892397811764838,5.892397811764833,1.0096837639485587,1.009683763948558,0,0,8.917387008666992,8.858894348144531,4,4
1824,8,4.9715208873069345,4.976272606575735,1.022873310065086,1.0227617687907278,1,1,9.572574615478516,8.858894348144531,7,7
1824,16,4.535513974541001,4.679210236842064,1.0260646700384568,1.0260936460899752,4,6,10.133295059204102,8.858894348144531,12,10
1824,32,3.8163416995223876,4.242399438053579,1.0329994873592083,1.0379608544236356,11,18,10.996220588684082,8.858894348144531,21,14
1824,64,2.5262328361694184,4.242399438053579,1.0077295832595154,1.0379608544236356,30,50,12.028005599975586,8.858894348144531,34,14
1824,128,1.7230564802312733,4.242213344994209,1.00048616599821,1.0380370213303185,61,113,13.101356506347656,8.858894348144531,67,15
1825,1,6.597827915338473,6.597827915338473,0.9818098273149718,0.9818098273149716,0,0,6.620964050292969,6.620964050292969,1,1
1825,2,5.128484005061337,5.128484005061337,0.9972137747255831,0.9972137747255836,0,0,6.7171430587768555,6.620964050292969,2,2
1825,3,4.333189161237283,4.333189161237283,1.006920274545803,1.006920274545803,0,0,7.105504035949707,6.620964050292969,3,3
1825,4,4.333055653707116,4.333055653707116,1.0069540076698043,1.006954007669804,0,0,7.161211967468262,6.620964050292969,4,4
1825,8,3.593312429031945,3.631047332332361,1.0145496598042307,1.0145806647277404,3,3,7.711453914642334,6.620964050292969,5,5
1825,16,3.23825445802765,3.4527351705426903,1.0173016321897814,1.0178422650076286,6,7,8.192743301391602,6.620964050292969,10,9
1825,32,2.6868725689435022,3.3346217444377544,1.012080992509309,1.0206197623494269,15,21,9.258230209350586,6.620964050292969,17,11
1825,64,2.025805634410652,3.3103683703974824,1.0066941941093686,1.021078936785537,25,51,9.900216102600098,6.620964050292969,39,13
1825,128,1.0957268945494667,3.2995849728788564,1.0016696879341285,1.0213196369083202,64,114,10.792521476745605,6.620964050292969,64,14
1826,1,7.741003601068087,7.741003601068088,0.9601668427838852,0.9601668427838878,0,0,7.830090522766113,7.830090522766113,1,1
1826,2,7.1066404130474705,7.106640413047467,0.9734537572959975,0.9734537572959988,0,0,7.973948955535889,7.830090522766113,2,2
1826,3,6.715757282262763,6.715757282262765,0.9808109739547617,0.980810973954763,0,0,8.218711853027344,7.830090522766113,3,3
1826,4,6.239312297208545,6.239312297208545,0.9917348137091135,0.9917348137091135,0,0,9.126693725585938,7.830090522766113,4,4
1826,8,5.693189064862668,5.751805180159841,1.001642184736458,1.0023112967362091,2,2,9.579132080078125,7.830090522766113,6,6
1826,16,4.700297625461812,4.945497652793784,1.011547061662383,1.0137208264488338,5,8,10.072857856750488,7.830090522766113,11,8
1826,32,3.95639062517897,4.788662264013101,1.0145792642360987,1.0205916875904535,14,19,10.62929916381836,7.830090522766113,18,13
1826,64,3.273074871770831,4.681841211625758,1.015471301389169,1.0249676783925035,31,46,11.451753616333008,7.830090522766113,33,18
1826,128,2.0978072039322733,4.599428359028706,1.0051796071152581,1.0294550370298412,65,109,12.318746566772461,7.830090522766113,63,19
1827,1,9.52681963599936,9.526819635999367,0.9466605062590092,0.9466605062590125,0,0,9.658407211303711,9.658407211303711,1,1
1827,2,8.629795878411997,8.629795878411999,0.9708781998202036,0.9708781998202056,0,0,10.380619049072266,9.658407211303711,2,2
1827,3,7.8102614044043355,7.810261404404338,0.9878235428093862,0.9878235428093887,0,0,10.549952507019043,9.658407211303711,3,3
1827,4,7.354082118986469,7.354082118986467,1.000101194894524,1.0001011948945255,0,0,10.774700164794922,9.658407211303711,4,4
1827,8,6.385994862909744,6.386002095790225,1.0200788850783218,1.0200841467440231,1,1,11.589256286621094,9.658407211303711,7,7
1827,16,5.983014677976539,6.296296153176984,1.0230823082538734,1.023541620102126,4,7,12.131013870239258,9.658407211303711,12,9
1827,32,5.267307357479303,6.183962785890595,1.0201263648983414,1.0280627975736738,16,19,12.773826599121094,9.658407211303711,16,13
1827,64,4.073322551008717,6.077827816683969,1.0136888851258732,1.0319621089989202,32,47,13.496854782104492,9.658407211303711,32,17
1827,128,2.3994459603632134,6.073758138548316,1.0032320326177637,1.0326495005098808,58,110,14.192580223083496,9.658407211303711,70,18
1828,1,11.369280873502015,11.369280873502019,0.9259217318281491,0.9259217318281507,0,0,11.587596893310547,11.587596893310547,1,1
1828,2,10.919259797073208,10.91925979707321,0.9394660903024155,0.9394660903024163,0,0,11.806056022644043,11.587596893310547,2,2
1828,3,9.964027950204484,9.964027950204487,0.9709673231609126,0.9709673231609137,0,0,12.26671314239502,11.587596893310547,3,3
1828,4,9.58954910585969,9.5896050244748,0.9798726211749675,0.9798641503960026,1,1,12.285548210144043,11.587596893310547,3,3
1828,8,8.404343619283473,8.409393940415047,1.0065302576511632,1.0064179690445607,2,2,12.681748390197754,11.587596893310547,6,6
1828,16,7.341663368939437,7.686358148428743,1.0290770221268437,1.0278250138055887,6,5,13.428991317749023,11.587596893310547,10,11
1828,32,6.505117028205867,7.575458543412637,1.0303167555926493,1.032476294352871,13,16,14.090580940246582,11.587596893310547,19,16
1828,64,4.351848681014865,7.361866544039335,1.0251537791286278,1.0439649508596183,28,51,14.621623992919922,11.587596893310547,36,13
1828,128,2.853387532204028,7.110939156111747,1.0173340437902798,1.0544285683322945,63,111,15.13565731048584,11.587596893310547,65,17
1829,1,2.9531326278040386,2.9531326278040386,0.9937375675172003,0.9937375675172003,0,0,2.959548234939575,2.959548234939575,1,1
1829,2,2.490232679153661,2.4902326791536606,0.9979055194831994,0.9979055194831987,0,0,3.5638959407806396,2.959548234939575,2,2
1829,3,2.286745470776357,2.2867454707763564,0.9991697169650056,0.9991697169650045,0,0,3.654649257659912,2.959548234939575,3,3
1829,4,2.2638880845365743,2.2638880845365743,0.999255103577452,0.9992551035774513,0,0,3.6650867462158203,2.959548234939575,4,4
1829,8,2.2358214180424993,2.255389999851721,0.9992710503903344,0.9994463139687516,2,2,3.82810115814209,2.959548234939575,6,6
1829,16,1.6598676790345763,1.9580027424098232,1.00110117344682,1.0017091825960565,8,9,4.368071556091309,2.959548234939575,8,7
1829,32,1.2445332491874517,1.8552193154698007,1.0014627927822781,1.003050864027652,15,23,4.682210445404053,2.959548234939575,17,9
1829,64,0.6687564515932305,1.8463952615784704,0.999999126112165,1.0034660031367195,31,52,5.133737087249756,2.959548234939575,33,12
1829,128,0.029182818336731652,1.8403803231120999,1.0000447913147976,1.0035737409350527,57,115,5.6302080154418945,2.959548234939575,71,13
1830,1,2.4172892977787717,2.4172892977787717,0.997807632142854,0.9978076321428542,0,0,2.4182558059692383,2.4182558059692383,1,1
1830,2,1.734213243165737,1.734213243165737,1.0005105847305122,1.0005105847305125,0,0,2.5625715255737305,2.4182558059692383,2,2
1830,3,1.7208337551264357,1.7208337551264357,1.0005620878159749,1.0005620878159749,0,0,2.7364487648010254,2.4182558059692383,3,3
1830,4,1.608576751367512,1.6085767513675122,1.0009999395814089,1.0009999395814086,0,0,2.8125827312469482,2.4182558059692383,4,4
1830,8,1.4583235990294134,1.4583235990294137,1.001955943296097,1.0019559432960958,1,1,2.9039664268493652,2.4182558059692383,7,7
1830,16,1.0220891878352174,1.1953029696485298,1.0021942716098526,1.0024944052091729,5,6,3.109464645385742,2.4182558059692383,11,10
1830,32,0.761193193381686,1.1629841451078369,1.0017268748661867,1.003231639807276,14,21,3.412968397140503,2.4182558059692383,18,11
1830,64,0.38383981525829153,1.1431045106279758,1.0002499549766402,1.0034791735329032,30,49,3.9792802333831787,2.4182558059692383,34,15
1830,128,0.02739082261697612,1.1038467497882962,1.0000115357616537,1.004200570938655,66,112,4.5404205322265625,2.4182558059692383,62,16
1831,1,8.215430955610408,8.215430955610413,0.9558925155427711,0.9558925155427749,0,0,8.320229530334473,8.320229530334473,1,1
1831,2,6.7666353140148425,6.766635314014842,0.983060207450399,0.9830602074504008,0,0,8.597309112548828,8.320229530334473,2,2
1831,3,6.034710614791597,6.034710614791598,0.9970144710340796,0.9970144710340809,0,0,8.606260299682617,8.320229530334473,3,3
1831,4,5.764253348883359,5.764253348883358,1.0024167387961809,1.0024167387961826,0,0,8.678736686706543,8.320229530334473,4,4
1831,8,4.774691091501411,4.774710219819006,1.0187502534907638,1.0187661600532745,1,1,9.476607322692871,8.320229530334473,7,7
1831,16,4.384592235088771,4.4994344790389125,1.0220115462773318,1.0240674330489612,4,6,10.204659461975098,8.320229530334473,12,10
1831,32,3.7482710829116708,4.252678735606063,1.0225532428270645,1.0301326779045938,12,15,10.775322914123535,8.320229530334473,20,17
1831,64,2.7676501842256163,4.2311890474011635,1.009447055261334,1.0316513391847817,31,46,11.38739013671875,8.320229530334473,33,18
1831,128,1.7270851254589743,4.208777178960747,1.0057985233763307,1.0330188332215644,53,109,12.051727294921875,8.320229530334473,75,19
1832,1,8.184300767836248,8.18430076783625,0.963553511511187,0.9635535115111876,0,0,8.25850772857666,8.25850772857666,1,1
1832,2,7.23778218188537,7.23778218188537,0.9858428307715141,0.9858428307715148,0,0,9.232463836669922,8.25850772857666,2,2
1832,3,6.697015625276269,6.6970156252762685,0.9925379821012537,0.9925379821012528,0,0,9.276581764221191,8.25850772857666,3,3
1832,4,6.279932230527659,6.279932230527659,1.0015250318456856,1.001525031845686,0,0,9.623580932617188,8.25850772857666,4,4
1832,8,5.97484587226005,6.10176907581974,1.0067601031294418,1.00627183025407,2,3,10.154187202453613,8.25850772857666,6,5
1832,16,4.912851202864278,5.222465299113843,1.0262886015092725,1.0247633623538057,6,8,10.58139419555664,8.25850772857666,10,8
1832,32,4.322737603819812,5.15361082952353,1.0235394724655513,1.0275069073074636,15,23,11.333444595336914,8.25850772857666,17,9
1832,64,2.757630464340356,5.046492629212324,1.013096625739894,1.0325493513439212,31,51,12.090627670288086,8.25850772857666,33,13
1832,128,1.7872535635097546,5.034977115602449,1.0013583859693087,1.0340885650379292,61,114,12.809142112731934,8.25850772857666,67,14
1833,1,8.24489362315591,8.244893623155907,0.9639606535681109,0.9639606535681119,0,0,8.314970016479492,8.314970016479492,1,1
1833,2,7.53564226725123,7.535642267251231,0.9799502795273867,0.9799502795273869,0,0,9.444581985473633,8.314970016479492,2,2
1833,3,6.544562703775485,6.544562703775486,0.999471153012494,0.9994711530124939,0,0,9.590068817138672,8.314970016479492,3,3
1833,4,6.505923156629181,6.505923156629181,1.0000396881379683,1.000039688137969,0,0,10.049306869506836,8.314970016479492,4,4
1833,8,6.311356107901312,6.311452233662446,1.0076559574232993,1.0076449069282203,1,1,10.564393997192383,8.314970016479492,7,7
1833,16,5.481761435691316,5.7425152038470975,1.0207775972290989,1.0200707224795262,6,9,10.988198280334473,8.314970016479492,10,7
1833,32,4.4466619358902575,5.705390901275783,1.0170073629980902,1.0224802293744502,16,21,11.381627082824707,8.314970016479492,16,11
1833,64,3.577568047957124,5.378427898361491,1.0128228675508746,1.0340154826120933,30,53,11.990106582641602,8.314970016479492,34,11
1833,128,2.0419681836662424,4.897815975997724,1.0097611804495785,1.0459509290921336,67,111,12.547061920166016,8.314970016479492,61,17
1834,1,2.4003351125397545,2.400335112539756,0.9962813011170313,0.9962813011170325,0,0,2.40307879447937,2.40307879447937,1,1
1834,2,2.2189962108129104,2.218996210812911,0.9974707344712253,0.9974707344712253,0,0,2.965130567550659,2.40307879447937,2,2
1834,3,2.097746395154182,2.0977463951541826,0.9982677277637442,0.9982677277637444,0,0,3.193671703338623,2.40307879447937,3,3
1834,4,1.720654891058227,1.7244931883802965,1.0001785249041188,1.0001567063218217,1,1,3.3555870056152344,2.40307879447937,3,3
1834,8,1.6029079707323286,1.6878435473045128,1.0007723171423133,1.0005482562297425,2,2,3.719611644744873,2.40307879447937,6,6
1834,16,1.4864629438998918,1.631671916686531,1.0011257342429076,1.0011560152562122,5,6,3.8718149662017822,2.40307879447937,11,10
1834,32,1.2290909561155123,1.512977337358953,1.0029775080689909,1.002418907163162,14,20,4.25740909576416,2.40307879447937,18,12
1834,64,0.6266132332970451,1.452112687601486,1.0008847121982882,1.0033404157543826,28,48,4.643575191497803,2.40307879447937,36,16
1834,128,0.045270472287875965,1.3147768852820814,0.9999836406631865,1.005336928753208,62,113,5.209590435028076,2.40307879447937,66,15
1835,1,2.7252670377247448,2.7252670377247448,1.0005348210838498,1.0005348210838512,0,0,2.7253477573394775,2.7253477573394775,1,1
1835,2,2.5166662377823905,2.51666623778239,1.0022922924519968,1.002292292451998,0,0,2.745786666870117,2.7253477573394775,2,2
1835,3,2.0838900213262628,2.0884408500840497,1.0052584853966962,1.0051169682044832,1,1,2.8517818450927734,2.7253477573394775,2,2
1835,4,2.074455979301161,2.076034142489743,1.0055031038234303,1.0054491579838951,1,1,2.8704426288604736,2.7253477573394775,3,3
1835,8,1.9510873041725032,2.0008598290879074,1.004467517020383,1.005375637360118,2,2,3.3006367683410645,2.7253477573394775,6,6
1835,16,1.7229429176093798,1.93801114369719,1.0032619989225706,1.0057638058135951,6,10,3.742252826690674,2.7253477573394775,10,6
1835,32,1.2510210961087316,1.8795956425525089,1.0003802321297255,1.0059536558005122,15,27,4.245195388793945,2.7253477573394775,17,5
1835,64,0.33419838753421977,1.8656805983333953,1.0001560070579751,1.006583052830377,32,57,4.943142890930176,2.7253477573394775,32,7
1835,128,0.01762800412697828,1.8648896232820236,0.9999977441111554,1.006786571788063,61,120,5.767728805541992,2.7253477573394775,67,8
1836,1,2.9225040319459903,2.9225040319459903,0.9954488933006246,0.9954488933006244,0,0,2.9258906841278076,2.9258906841278076,1,1
1836,2,2.37844036962269,2.3784403696226937,0.996555718342852,0.9965557183428504,0,0,3.216073989868164,2.9258906841278076,2,2
1836,3,2.3742449886805566,2.3742449886805557,0.9967421026953248,0.9967421026953232,0,0,3.323796510696411,2.9258906841278076,3,3
1836,4,2.3503006673709628,2.350331941802751,0.9968965078040746,0.9969087223390722,1,1,3.352735757827759,2.9258906841278076,3,3
1836,8,1.991585286857746,2.1682656403057314,0.9990385677042699,0.9980497830814575,3,3,3.654407024383545,2.9258906841278076,5,5
1836,16,1.736705790988992,2.05317561576631,1.000824944975411,0.9996358294381101,6,9,3.796848773956299,2.9258906841278076,10,7
1836,32,1.3370403035928702,2.0020740025159,1.001900469809036,0.999921056747953,14,19,4.046574115753174,2.9258906841278076,18,13
1836,64,0.6885952192569278,1.872724334694908,1.0007908411070028,1.0012611940741931,31,54,4.275456428527832,2.9258906841278076,33,10
1836,128,0.036012217053778696,1.7551381510185369,1.000005347953437,1.0035880395777164,63,116,4.726362228393555,2.9258906841278076,65,12
1837,1,7.483029817930558,7.483029817930527,0.9651758970474899,0.9651758970474924,0,0,7.5576491355896,7.5576491355896,1,1
1837,2,5.5003346676480005,5.500334667648002,0.9983452130205626,0.9983452130205651,0,0,7.710590362548828,7.5576491355896,2,2
1837,3,5.183075696483036,5.183075696483036,1.0018418143601708,1.0018418143601733,0,0,7.8483171463012695,7.5576491355896,3,3
1837,4,5.091267256557528,5.091267256557528,1.0036127316027816,1.0036127316027839,0,0,7.970866680145264,7.5576491355896,4,4
1837,8,4.2586066209964395,4.264188701025381,1.0128998325002356,1.012907245483435,1,1,8.513569831848145,7.5576491355896,7,7
1837,16,4.033667941792083,4.218922523652788,1.0167306856818499,1.0156000399415623,4,4,9.152134895324707,7.5576491355896,12,12
1837,32,3.4161437322806614,4.1839204134336825,1.0115145575492472,1.0177396476760934,14,18,9.522863388061523,7.5576491355896,18,14
1837,64,2.4865328665565496,4.093654332771785,1.0118175863521337,1.0218709682296299,29,50,10.384060859680176,7.5576491355896,35,14
1837,128,1.4254469948757182,4.023644615189495,1.0022733286138217,1.0238669153457791,64,113,11.227865219116211,7.5576491355896,64,15
1838,1,5.671285101923749,5.67128510192375,0.9844268645402364,0.9844268645402381,0,0,5.691481113433838,5.691481113433838,1,1
1838,2,5.0561936672637895,5.0561936672637895,0.9923565057351057,0.9923565057351065,0,0,5.878395080566406,5.691481113433838,2,2
1838,3,5.052731218144977,5.052731218144978,0.9923709281998562,0.9923709281998568,0,0,5.920025825500488,5.691481113433838,3,3
1838,4,5.0203298062782915,5.027240232415568,0.9924478064423214,0.9924376971323284,1,1,6.058520793914795,5.691481113433838,3,3
1838,8,4.932980588938374,4.967757924492881,0.9935941176679731,0.9932244031527928,3,4,6.307061195373535,5.691481113433838,5,4
1838,16,4.623558800268023,4.927138387018136,0.9933811152301212,0.9944726783327239,6,10,6.563283443450928,5.691481113433838,10,6
1838,32,2.6618084347051973,4.4221665155512335,1.0033674678309856,1.0023053198481398,12,26,6.782721519470215,5.691481113433838,20,6
1838,64,1.7501814927145907,4.395658972582959,0.9986532328469665,1.002945928870366,31,57,7.241248607635498,5.691481113433838,33,7
1838,128,0.8195529233415905,4.395658972582959,0.9988654763348741,1.002945928870366,67,121,7.853030204772949,5.691481113433838,61,7
1839,1,8.852935765808708,8.852935765808711,0.9588888494781213,0.9588888494781237,0,0,8.937314987182617,8.937314987182617,1,1
1839,2,7.449638093390286,7.449638093390288,0.9819771010755731,0.9819771010755751,0,0,9.239561080932617,8.937314987182617,2,2
1839,3,6.67918832222064,6.67918832222064,0.9959646311208741,0.9959646311208754,0,0,9.594324111938477,8.937314987182617,3,3
1839,4,6.633223634135646,6.633223634135647,0.9965788271448819,0.9965788271448829,0,0,9.626568794250488,8.937314987182617,4,4
1839,8,5.510623468143906,5.538961595801653,1.0161482223196703,1.0153996233460723,1,1,10.16493034362793,8.937314987182617,7,7
1839,16,5.122344650184907,5.280440377455432,1.0233030241332381,1.0212276102571125,5,5,10.721213340759277,8.937314987182617,11,11
1839,32,4.370987413839161,4.9335908058643865,1.0229283891552186,1.0325810581972086,15,20,11.483264923095703,8.937314987182617,17,12
1839,64,2.911185801102635,4.76328684700422,1.016978130781842,1.0383692363829544,29,51,12.365547180175781,8.937314987182617,35,13
1839,128,1.7210241723702353,4.689804059431133,1.006143860609939,1.0430239424170353,65,112,13.0670747756958,8.937314987182617,63,16
1840,1,9.37188726115302,9.37188726115302,0.9490261291196417,0.9490261291196425,0,0,9.492746353149414,9.492746353149414,1,1
1840,2,8.117113286304326,8.117113286304326,0.9825284105884949,0.9825284105884948,0,0,10.009725570678711,9.492746353149414,2,2
1840,3,7.6965826474965615,7.69658264749656,0.9904701491927242,0.9904701491927231,0,0,10.038128852844238,9.492746353149414,3,3
1840,4,7.538926880205764,7.538926880205765,0.9927956331611817,0.9927956331611806,0,0,10.073100090026855,9.492746353149414,4,4
1840,8,6.858670711714353,6.883660993687274,1.009976352762913,1.0093169036155027,3,3,11.417335510253906,9.492746353149414,5,5
1840,16,6.4165326570396415,6.647668904399824,1.0202234817670948,1.0180926907109877,7,8,12.06442928314209,9.492746353149414,9,8
1840,32,5.341515464700705,6.464664974622438,1.019930547381846,1.026622998792471,14,20,12.713903427124023,9.492746353149414,18,12
1840,64,3.8576783592618358,6.358815192596254,1.0141597877975106,1.0347490544970634,31,50,13.562325477600098,9.492746353149414,33,14
1840,128,2.355281029689532,6.323369938909761,1.0074962704937234,1.0373788137029694,60,112,14.361567497253418,9.492746353149414,68,16
1841,1,10.043399745177261,10.043399745177268,0.9410230641825338,0.9410230641825373,0,0,10.19523811340332,10.19523811340332,1,1
1841,2,8.643036773632447,8.64303677363245,0.9782741233586904,0.9782741233586929,0,0,10.786872863769531,10.19523811340332,2,2
1841,3,8.056295092075867,8.056295092075867,0.9933031222484634,0.9933031222484658,0,0,10.879562377929688,10.19523811340332,3,3
1841,4,7.820277377439378,7.820277377439379,0.9977656945754437,0.9977656945754476,0,0,10.922479629516602,10.19523811340332,4,4
1841,8,7.188193257104581,7.202484045543254,1.0194727135394377,1.0185919682762372,2,2,12.621871948242188,10.19523811340332,6,6
1841,16,6.2692927581172455,6.874657785294993,1.0276265575666907,1.0270302671235911,6,7,12.990517616271973,10.19523811340332,10,9
1841,32,5.757712355827327,6.733727373595695,1.0284606425095943,1.036933975840586,14,20,13.4169921875,10.19523811340332,18,12
1841,64,4.4246047460563105,6.682281871533422,1.0083323938739652,1.0407694982494275,31,50,14.46572208404541,10.19523811340332,33,14
1841,128,3.107816358101345,6.419757332413538,1.0051521595311386,1.054422471148626,66,108,15.3998441696167,10.19523811340332,62,20
1842,1,7.979513336018466,7.97951333601847,0.96045716597818,0.9604571659781814,0,0,8.0656099319458,8.0656099319458,1,1
1842,2,6.8578109450000255,6.857810945000026,0.9833117496243968,0.9833117496243973,0,0,8.104737281799316,8.0656099319458,2,2
1842,3,6.4668377480934325,6.4668377480934325,0.9928023206488263,0.9928023206488268,0,0,9.295744895935059,8.0656099319458,3,3
1842,4,6.4578949674938295,6.457894967493829,0.9931299358785943,0.9931299358785943,0,0,10.036417961120605,8.0656099319458,4,4
1842,8,5.45555069487172,5.550773788347597,1.0146224810361433,1.0132575294145654,3,3,10.945209503173828,8.0656099319458,5,5
1842,16,5.250044418084665,5.447950818450098,1.016939374930721,1.0172394401575584,6,9,11.76560115814209,8.0656099319458,10,7
1842,32,4.4653390083591376,5.30780842552256,1.0221111550127402,1.0255593561099945,14,20,12.42165470123291,8.0656099319458,18,12
1842,64,3.195629538357813,5.13192942280957,1.010927940889769,1.0339390379361721,31,49,13.008882522583008,8.0656099319458,33,15
1842,128,2.01733387658096,5.0847874314161015,0.999523329956074,1.0372960181514057,68,111,13.652589797973633,8.0656099319458,60,17
1843,1,10.572878582407307,10.57287858240731,0.9442909899712658,0.9442909899712679,0,0,10.702320098876953,10.702320098876953,1,1
1843,2,10.019265609861726,10.01926560986173,0.9610547052653275,0.9610547052653294,0,0,11.615498542785645,10.702320098876953,2,2
1843,3,9.969072432232627,9.969072432232633,0.9645301484026175,0.9645301484026193,0,0,11.841022491455078,10.702320098876953,3,3
1843,4,9.951554616767323,9.951554616767323,0.9651961896933382,0.9651961896933393,0,0,12.270377159118652,10.702320098876953,4,4
1843,8,9.323465161815431,9.524259383344594,0.9738143997952062,0.9750229758749007,3,4,12.668412208557129,10.702320098876953,5,4
1843,16,7.05320773454071,7.861350963600357,1.0276498408247274,1.0238614408583873,7,8,13.016804695129395,10.702320098876953,9,8
1843,32,5.81376845134863,6.988476300771133,1.0347094665702168,1.0415178301806551,13,18,13.657524108886719,10.702320098876953,19,14
1843,64,4.3456090134546415,6.820062389838289,1.0164246586430528,1.0511560035491472,31,49,14.332706451416016,10.702320098876953,33,15
1843,128,2.6717032730542445,6.7382476588573805,1.0071386755156388,1.053646620348411,60,108,14.891701698303223,10.702320098876953,68,20
1844,1,2.9829512840770986,2.9829512840770986,0.9960243494874252,0.9960243494874256,0,0,2.9854893684387207,2.9854893684387207,1,1
1844,2,2.3523523982016266,2.352352398201626,0.9984237008356085,0.9984237008356076,0,0,3.0867669582366943,2.9854893684387207,2,2
1844,3,2.178647759328662,2.1786477593286624,0.9994201421268034,0.9994201421268031,0,0,3.2426486015319824,2.9854893684387207,3,3
1844,4,2.1786463323192597,2.1786477593286624,0.9994204702438193,0.9994201421268031,1,1,3.4942383766174316,2.9854893684387207,3,3
1844,8,2.0391888428224116,2.0806432178500516,1.0003308350525133,0.999955903618529,2,3,3.615501880645752,2.9854893684387207,6,5
1844,16,1.8297890956316132,2.063381106701835,1.001281569930233,1.000292163566025,6,9,3.8566439151763916,2.9854893684387207,10,7
1844,32,1.5255168645077322,1.9520074191850165,1.001174133625315,1.0010352305827888,17,23,4.260196685791016,2.9854893684387207,15,9
1844,64,0.7244880681178901,1.685422335943723,1.0016411193887143,1.0042474957710563,34,46,4.579875946044922,2.9854893684387207,30,18
1844,128,0.08026615394147868,1.6026137917671974,1.0000343675422214,1.0055955807737638,65,113,5.050400733947754,2.9854893684387207,63,15
1845,1,9.031088719474118,9.03108871947412,0.9503430006446306,0.9503430006446316,0,0,9.15146255493164,9.15146255493164,1,1
1845,2,7.614854729153699,7.614854729153699,0.9788471430464862,0.9788471430464859,0,0,9.169918060302734,9.15146255493164,2,2
1845,3,7.449697719608694,7.449697719608695,0.980457926018565,0.9804579260185655,0,0,9.64727783203125,9.15146255493164,3,3
1845,4,7.408047588984701,7.408047588984701,0.9817545825649414,0.9817545825649411,0,0,9.706597328186035,9.15146255493164,4,4
1845,8,7.1721090520432895,7.1721090520432895,0.9883452325982738,0.9883452325982733,0,0,10.121145248413086,9.15146255493164,8,8
1845,16,6.2687881978920705,6.451784261018373,1.0105355854976346,1.0065760152614982,6,6,10.722341537475586,9.15146255493164,10,10
1845,32,5.040616542026898,5.978531189587242,1.0151575620246094,1.0204635372498425,15,20,11.530935287475586,9.15146255493164,17,12
1845,64,3.8847832336453987,5.726349500827855,1.0083999767730933,1.0307680195122428,27,50,12.201020240783691,9.15146255493164,37,14
1845,128,2.3452096042614152,5.723278749000748,1.0034710250435155,1.0316037852480036,60,112,12.905045509338379,9.15146255493164,68,16
1846,1,8.384111093422804,8.384111093422806,0.9608976043479944,0.9608976043479966,0,0,8.46575927734375,8.46575927734375,1,1
1846,2,6.68408358967726,6.684083589677262,0.9913239725179589,0.9913239725179601,0,0,8.81242561340332,8.46575927734375,2,2
1846,3,6.289839557162762,6.289839557162762,1.0005480456865876,1.0005480456865896,0,0,9.098673820495605,8.46575927734375,3,3
1846,4,6.220977508004532,6.220977508004532,1.0027100755307958,1.0027100755307972,0,0,9.696502685546875,8.46575927734375,4,4
1846,8,5.432183815587265,5.432183815587263,1.01492513005826,1.0149251300582613,0,0,10.098736763000488,8.46575927734375,8,8
1846,16,5.002406848078026,5.211586014305401,1.0210655106751718,1.020218447051606,2,2,10.545707702636719,8.46575927734375,14,14
1846,32,4.235059906408008,4.9670995181908015,1.0331777433601081,1.025742950700578,12,19,10.93737506866455,8.46575927734375,20,13
1846,64,3.2922411067252106,4.81413929817277,1.0242176146277722,1.0319846090919205,29,49,11.502113342285156,8.46575927734375,35,15
1846,128,1.967941325019731,4.602705050045908,1.0076090430395412,1.03963104116214,68,107,12.138422966003418,8.46575927734375,60,21
1847,1,8.724736570272727,8.724736570272723,0.9477071261405555,0.9477071261405571,0,0,8.859938621520996,8.859938621520996,1,1
1847,2,7.8674844596553175,7.867484459655319,0.9781434104893667,0.9781434104893673,0,0,11.32099437713623,8.859938621520996,2,2
1847,3,7.865053771878939,7.865053771878941,0.978650317120586,0.9786503171205867,0,0,11.643481254577637,8.859938621520996,3,3
1847,4,7.4460050029570395,7.4460050029570395,0.996963831002216,0.9969638310022155,0,0,12.02107048034668,8.859938621520996,4,4
1847,8,7.337890811921136,7.3892270829650055,0.9992691464110379,1.0010383059375105,2,2,12.800389289855957,8.859938621520996,6,6
1847,16,6.692372806062692,7.118558002072769,1.008452980673351,1.01194562818362,7,7,13.333675384521484,8.859938621520996,9,9
1847,32,5.559824988432166,6.854245384647207,1.0125819577055004,1.0254284576650474,13,19,14.314229011535645,8.859938621520996,19,13
1847,64,4.238259642081766,6.331513819994787,1.0151919737840935,1.037550440098345,29,52,15.109174728393555,8.859938621520996,35,12
1847,128,2.5069459203132856,6.265451427342581,1.0016860344734915,1.0443622561452832,66,115,15.77863883972168,8.859938621520996,62,13
1848,1,4.744062847469146,4.744062847469147,0.9859374925033003,0.9859374925033012,0,0,4.7631916999816895,4.7631916999816895,1,1
1848,2,3.8596951557352868,3.859695155735287,0.9955825669788314,0.9955825669788321,0,0,5.200705051422119,4.7631916999816895,2,2
1848,3,3.6685962360507913,3.6685962360507918,0.9987613259553206,0.9987613259553216,0,0,5.344138145446777,4.7631916999816895,3,3
1848,4,3.567614732754468,3.5676147327544676,0.9999084948321892,0.9999084948321901,0,0,5.504149436950684,4.7631916999816895,4,4
1848,8,3.4002479394936267,3.4002479394936262,1.0018981953016428,1.001898195301644,0,0,6.2422194480896,4.7631916999816895,8,8
1848,16,3.251455279206143,3.369409622694449,1.004019890928745,1.003537884511958,5,5,6.940542697906494,4.7631916999816895,11,11
1848,32,2.6703277366546985,3.2540581766645538,1.0048416000178324,1.0071998407607066,13,21,7.38187313079834,4.7631916999816895,19,11
1848,64,1.8839430535490829,3.243808291874879,1.0033995415516321,1.0080152846711294,26,51,8.06416130065918,4.7631916999816895,38,13
1848,128,0.9275640082439931,3.1539204060565025,1.0015178276665222,1.0117793524234924,60,115,8.915352821350098,4.7631916999816895,68,13
1849,1,8.217130023926165,8.217130023926165,0.9699344158257229,0.9699344158257229,0,0,8.2660493850708,8.2660493850708,1,1
1849,2,5.677057621362361,5.677057621362362,1.005961520877693,1.0059615208776922,0,0,8.431480407714844,8.2660493850708,2,2
1849,3,5.541618377131651,5.541618377131651,1.00834317106204,1.0083431710620399,0,0,8.553396224975586,8.2660493850708,3,3
1849,4,5.21684680799372,5.216846807993721,1.0146335021956863,1.0146335021956854,0,0,8.932577133178711,8.2660493850708,4,4
1849,8,4.889598656262621,4.889598656262622,1.01917764956564,1.0191776495656393,0,0,9.41590690612793,8.2660493850708,8,8
1849,16,4.026142484149924,4.390456519509733,1.0242999663492802,1.0246169445031597,4,7,10.068571090698242,8.2660493850708,12,9
1849,32,3.6439293172596803,4.369283191368424,1.0223375552901153,1.0262959755500598,12,20,10.561039924621582,8.2660493850708,20,12
1849,64,3.0278074880335257,4.35550645677741,1.0146466284089608,1.026833090253462,32,51,11.187496185302734,8.2660493850708,32,13
1849,128,1.9355787530574449,4.187326309710658,1.009267407581652,1.033480952514201,57,112,11.700970649719238,8.2660493850708,71,16
1850,1,9.200290726506656,9.200290726506656,0.9546952906439223,0.9546952906439224,0,0,9.299102783203125,9.299102783203125,1,1
1850,2,8.148675073811608,8.148675073811608,0.9738971538330643,0.9738971538330637,0,0,10.575688362121582,9.299102783203125,2,2
1850,3,7.493350963416403,7.493350963416404,0.990936411579338,0.9909364115793381,0,0,11.287873268127441,9.299102783203125,3,3
1850,4,7.110297263173461,7.11029726317346,1.0009177659607782,1.0009177659607784,0,0,11.336822509765625,9.299102783203125,4,4
1850,8,6.670811789495449,6.680348035075513,1.008338477690227,1.0085063228401956,1,2,11.484886169433594,9.299102783203125,7,6
1850,16,5.384898641870644,5.682606001402462,1.0249270368657761,1.0226727919553902,7,9,11.820330619812012,9.299102783203125,9,7
1850,32,4.622985648879302,5.670712941694007,1.0256407173145679,1.0233114529704899,12,21,12.167008399963379,9.299102783203125,20,11
1850,64,3.574477476187758,5.426848545995561,1.014423210497441,1.0323643452935316,28,52,12.381759643554688,9.299102783203125,36,12
1850,128,2.109812543103722,5.336515196008195,1.0082187209551468,1.0353351638521366,63,116,12.728306770324707,9.299102783203125,65,12
1851,1,5.131883473840854,5.131883473840856,0.987373330929753,0.9873733309297544,0,0,5.146240711212158,5.146240711212158,1,1
1851,2,4.117253584190207,4.117253584190207,0.9969366671257288,0.9969366671257291,0,0,5.372457981109619,5.146240711212158,2,2
1851,3,3.9299393422715663,3.9299393422715667,0.999605717987121,0.999605717987121,0,0,5.620546817779541,5.146240711212158,3,3
1851,4,3.854792389978538,3.8547923899785386,1.0014271978831848,1.001427197883186,0,0,5.778040885925293,5.146240711212158,4,4
1851,8,3.589304583430219,3.6776755839444815,1.0028032061069878,1.0049448885624834,1,1,6.859367847442627,5.146240711212158,7,7
1851,16,2.9038592333210778,3.141154481221412,1.0099557711240004,1.0111688919616744,5,5,7.167410850524902,5.146240711212158,11,11
1851,32,2.1798350766283354,3.0719772333238287,1.0085391384707745,1.0128017070128235,11,17,7.856333255767822,5.146240711212158,21,15
1851,64,1.5696997596130458,3.0538245017018757,1.0057755286434167,1.014350588613119,30,48,8.581385612487793,5.146240711212158,34,16
1851,128,0.6753732968085656,2.9834393370707537,1.000656569529644,1.0159088699026664,56,114,9.269017219543457,5.146240711212158,72,14
1852,1,7.557798126767297,7.557798126767299,0.9751141407949907,0.9751141407949916,0,0,7.594874382019043,7.594874382019043,1,1
1852,2,7.24051014357174,7.240510143571739,0.9799405420552181,0.9799405420552179,0,0,8.484807014465332,7.594874382019043,2,2
1852,3,6.650564196579489,6.650564196579489,0.9906789634111525,0.9906789634111522,0,0,8.49133014678955,7.594874382019043,3,3
1852,4,6.021096112237776,6.021096112237776,1.0016725578081886,1.0016725578081886,0,0,8.666170120239258,7.594874382019043,4,4
1852,8,5.4212400616486445,5.436613566559038,1.009070930681835,1.0090786687562883,1,1,8.980888366699219,7.594874382019043,7,7
1852,16,4.967530701451856,5.235275469589087,1.0150084940678812,1.0138647983664413,3,7,9.515552520751953,7.594874382019043,13,9
1852,32,4.287251109338709,4.897999312704603,1.0215078375810955,1.0216555943218277,9,19,10.027775764465332,7.594874382019043,23,13
1852,64,2.9504183788407383,4.794178214480342,1.0103883109292675,1.0241014795351038,29,49,10.57618522644043,7.594874382019043,35,15
1852,128,1.4148161642328305,4.731227622420161,1.0020140430198752,1.0268340364519033,58,113,11.261356353759766,7.594874382019043,70,15
1853,1,8.973963256385169,8.97396325638517,0.9622771926575816,0.9622771926575824,0,0,9.04492473602295,9.04492473602295,1,1
1853,2,8.095467684406346,8.095467684406348,0.9785524937722714,0.978552493772273,0,0,9.201903343200684,9.04492473602295,2,2
1853,3,7.499045494254003,7.499045494254003,0.9875450117263866,0.9875450117263862,0,0,9.286458015441895,9.04492473602295,3,3
1853,4,6.850881253742479,6.850881253742479,1.0003087921654095,1.0003087921654101,0,0,9.763481140136719,9.04492473602295,4,4
1853,8,6.095786120019593,6.105769690436867,1.0141648198445399,1.0143825632663503,3,3,10.209136962890625,9.04492473602295,5,5
1853,16,5.548414129412783,6.103299767341196,1.0127514162319222,1.0145036823403506,4,10,10.830251693725586,9.04492473602295,12,6
1853,32,4.738651901104211,5.757947317957069,1.0144950113888813,1.027232043380822,12,21,11.895167350769043,9.04492473602295,20,11
1853,64,2.9815230571699476,5.6473497278962075,1.012701369296693,1.0327614840551211,28,52,12.748693466186523,9.04492473602295,36,12
1853,128,1.8316137113076865,5.375409921429937,1.0055763249128231,1.04451800040226,59,113,13.690634727478027,9.04492473602295,69,15
1854,1,9.84562621209236,9.845626212092368,0.9440004677058965,0.9440004677058998,0,0,9.983430862426758,9.983430862426758,1,1
1854,2,8.573448765299952,8.573448765299915,0.9762674722246785,0.9762674722246812,0,0,10.40552043914795,9.983430862426758,2,2
1854,3,7.588388721671465,7.588388721671465,0.9956544922893189,0.9956544922893206,0,0,10.731717109680176,9.983430862426758,3,3
1854,4,6.877257973516351,6.87725797351635,1.009827848015111,1.0098278480151124,0,0,10.882987022399902,9.983430862426758,4,4
1854,8,6.368144565603017,6.368144565603017,1.02101631595811,1.0210163159581098,0,0,11.16431999206543,9.983430862426758,8,8
1854,16,5.808961383316524,5.9002327718191125,1.033808667554823,1.0317484601837443,4,4,11.832915306091309,9.983430862426758,12,12
1854,32,4.94224075269953,5.727697433263109,1.0231857373285431,1.036499181542471,15,18,12.756348609924316,9.983430862426758,17,14
1854,64,3.6060683891485206,5.666296133615943,1.006827766222592,1.0391617986400516,31,50,13.595257759094238,9.983430862426758,33,14
1854,128,2.3120023648784764,5.654685259397427,1.0024701390689787,1.0414177107974523,60,113,14.70997142791748,9.983430862426758,68,15
1855,1,9.660037367312338,9.660037367312341,0.9521349845946675,0.9521349845946688,0,0,9.764226913452148,9.764226913452148,1,1
1855,2,7.609878548287343,7.609878548287344,0.9835727308759876,0.9835727308759874,0,0,10.009703636169434,9.764226913452148,2,2
1855,3,7.122126877714146,7.1221268777141455,0.9929285545233978,0.9929285545233972,0,0,10.208718299865723,9.764226913452148,3,3
1855,4,6.593172585438817,6.593172585438816,1.0061313437149753,1.0061313437149755,0,0,10.296950340270996,9.764226913452148,4,4
1855,8,5.760323890619459,5.763481603227822,1.0223889062105114,1.0223154640607555,1,1,10.45081901550293,9.764226913452148,7,7
1855,16,5.4305843605302835,5.468293354030787,1.0264918355186836,1.0246497108174806,4,5,10.818882942199707,9.764226913452148,12,11
1855,32,5.043865465870014,5.346928915653702,1.0259483360127877,1.0276619426144855,9,17,11.178089141845703,9.764226913452148,23,15
1855,64,4.0657066568981834,5.26337181377993,1.0199808951861886,1.02863919066177,28,47,11.496054649353027,9.764226913452148,36,17
1855,128,2.603518923143548,5.255860228300641,1.007183380103545,1.0297837008455242,61,105,11.91495418548584,9.764226913452148,67,23
1856,1,10.41765488779415,10.417654887794155,0.9370422633220025,0.9370422633220039,0,0,10.583307266235352,10.583307266235352,1,1
1856,2,8.769706171626403,8.769706171626405,0.9752519340685137,0.9752519340685144,0,0,10.593316078186035,10.583307266235352,2,2
1856,3,8.42732297632357,8.427322976323568,0.9858779366577152,0.9858779366577146,0,0,11.73986530303955,10.583307266235352,3,3
1856,4,8.424612649496577,8.424612649496579,0.9862142027087466,0.9862142027087469,0,0,11.758548736572266,10.583307266235352,4,4
1856,8,7.776482491985795,7.938677572113525,1.0034950172869335,1.0024613653231058,2,2,12.723371505737305,10.583307266235352,6,6
1856,16,7.361482033701919,7.76201231688619,1.0101388892084504,1.0100209532273978,7,7,13.429475784301758,10.583307266235352,9,9
1856,32,5.975799872940679,7.392332181613643,1.033861405313214,1.0238593991846971,15,20,13.916346549987793,10.583307266235352,17,12
1856,64,4.849217371609095,7.126464003851707,1.0340101896366982,1.035690680781459,31,49,14.409378051757812,10.583307266235352,33,15
1856,128,3.5152655860304245,7.035267382064707,1.01454858706286,1.0412557972912473,65,110,14.978090286254883,10.583307266235352,63,18
1857,1,9.873653206237515,9.87365320623752,0.944537200197192,0.944537200197194,0,0,10.016754150390625,10.016754150390625,1,1
1857,2,8.58667667228505,8.58667667228505,0.9734581319258353,0.9734581319258357,0,0,10.167208671569824,10.016754150390625,2,2
1857,3,8.299837165781534,8.299837165781533,0.9846654638922916,0.9846654638922903,0,0,11.435501098632812,10.016754150390625,3,3
1857,4,8.297108809164378,8.299837165781533,0.9839712116330155,0.9846654638922903,1,1,12.065196990966797,10.016754150390625,3,3
1857,8,8.017843762230502,8.159830149791903,0.9917573138458706,0.9947891939762092,2,2,12.71977424621582,10.016754150390625,6,6
1857,16,7.507461877549117,8.023365783426847,0.9929745316998011,1.0013913954665332,6,8,13.62069034576416,10.016754150390625,10,8
1857,32,5.915585194141678,7.676376197386417,1.00716587409287,1.0197122108837864,13,23,14.320658683776855,10.016754150390625,19,9
1857,64,4.535417880610799,7.307840149212195,1.004715173810204,1.0312306673970706,30,53,15.276845932006836,10.016754150390625,34,11
1857,128,2.8144005887848245,6.775934772249544,1.0074262581525557,1.0514778028513008,70,115,16.119571685791016,10.016754150390625,58,13
1858,1,6.013307469451402,6.013307469451406,0.9827470876106376,0.9827470876106406,0,0,6.0355329513549805,6.0355329513549805,1,1
1858,2,5.452432673825888,5.452432673825891,0.9919389198965741,0.9919389198965763,0,0,7.0502543449401855,6.0355329513549805,2,2
1858,3,5.317102716458304,5.3171027164583045,0.9959735250749333,0.9959735250749346,0,0,7.725732803344727,6.0355329513549805,3,3
1858,4,4.632613717561915,4.632613717561913,1.006855042043013,1.0068550420430153,0,0,7.940248966217041,6.0355329513549805,4,4
1858,8,4.203745644643932,4.203745644643928,1.015258249871472,1.015258249871474,0,0,8.277054786682129,6.0355329513549805,8,8
1858,16,3.6159148329610273,3.6458057575696703,1.0221285523116856,1.0223488446943052,4,4,8.64439868927002,6.0355329513549805,12,12
1858,32,3.1203586296997368,3.49027896995205,1.0209702374607632,1.025729257785673,12,17,9.172188758850098,6.0355329513549805,20,15
1858,64,2.0519617887374744,3.451076825104716,1.0075599368787145,1.0266238010944508,36,47,9.883901596069336,6.0355329513549805,28,17
1858,128,1.1578503896509933,3.450398526685081,1.0009379026447691,1.0268209324831838,64,109,10.70901107788086,6.0355329513549805,64,19
1859,1,12.993615464599767,12.993615464599772,0.9043316489536363,0.904331648953638,0,0,13.288537979125977,13.288537979125977,1,1
1859,2,11.97618838332516,11.976188383325164,0.9409102007988716,0.9409102007988726,0,0,13.769235610961914,13.288537979125977,2,2
1859,3,11.219239359684895,11.219239359684895,0.9617966255115159,0.9617966255115173,0,0,13.99842357635498,13.288537979125977,3,3
1859,4,11.114325263319984,11.114325263319985,0.9653805384578683,0.96538053845787,0,0,14.150471687316895,13.288537979125977,4,4
1859,8,10.837613774975397,10.837613774975399,0.9777161086680822,0.9777161086680816,0,0,14.600797653198242,13.288537979125977,8,8
1859,16,10.342370531748221,10.57326186102726,0.9911215424420694,0.9861744123442759,4,7,14.820781707763672,13.288537979125977,12,9
1859,32,9.018668718424347,10.400231463313025,1.0095974499169884,0.9944268596507733,13,20,15.48582649230957,13.288537979125977,19,12
1859,64,7.362775223167082,10.065575701508193,1.014154819477087,1.0120846877873284,30,53,16.127235412597656,13.288537979125977,34,11
1859,128,5.623898716217332,9.914864766057297,0.9967099650533174,1.0217368108589997,63,110,16.71229362487793,13.288537979125977,65,18
1860,1,7.930975159557503,7.930975159557506,0.958043586712736,0.9580435867127379,0,0,8.033722877502441,8.033722877502441,1,1
1860,2,6.473663463076505,6.473663463076508,0.9858776201798298,0.9858776201798316,0,0,8.050352096557617,8.033722877502441,2,2
1860,3,5.741031691936984,5.741031691936985,0.9971624704162529,0.9971624704162535,0,0,8.052152633666992,8.033722877502441,3,3
1860,4,5.590579860346254,5.590579860346255,0.9982230549235913,0.9982230549235926,0,0,8.088310241699219,8.033722877502441,4,4
1860,8,4.733588008495507,4.733588008495506,1.0144247537939761,1.014424753793977,0,0,8.287269592285156,8.033722877502441,8,8
1860,16,4.251882495253835,4.38747546254605,1.021920092629324,1.0209055759964645,2,3,8.985982894897461,8.033722877502441,14,13
1860,32,3.865172501991711,4.243441455089521,1.0226595758144956,1.0249331093842913,13,17,9.52081298828125,8.033722877502441,19,15
1860,64,2.2571031006025835,4.193512312576285,1.0082100118028428,1.027560637251411,28,42,10.364764213562012,8.033722877502441,36,22
1860,128,1.2203865006641414,4.124630858850436,1.0005906718938615,1.0312069063294997,62,105,11.141705513000488,8.033722877502441,66,23
1861,1,3.167198026663586,3.1671980266635877,0.9940997156720179,0.9940997156720194,0,0,3.1724534034729004,3.1724534034729004,1,1
1861,2,2.5536931655941424,2.553693165594142,0.9997024644542974,0.9997024644542983,0,0,3.7512712478637695,3.1724534034729004,2,2
1861,3,2.364764080501064,2.3647640805010637,1.0006104636471185,1.0006104636471198,0,0,3.827662706375122,3.1724534034729004,3,3
1861,4,2.027317204503714,2.027317204503713,1.0026775325436403,1.0026775325436412,0,0,3.8313632011413574,3.1724534034729004,4,4
1861,8,1.826998222185844,1.9405151479565834,1.0041925034020083,1.0031978031669786,1,1,4.0111083984375,3.1724534034729004,7,7
1861,16,1.5606198543173364,1.8220099553002147,1.005013347484953,1.004532475729195,5,7,4.539780139923096,3.1724534034729004,11,9
1861,32,1.1198782430392724,1.606178931987677,1.0034747544681282,1.006857330500775,14,20,5.022439479827881,3.1724534034729004,18,12
1861,64,0.6006784892638115,1.5904579983681335,1.0007238916986916,1.0070028717483561,31,49,5.668476104736328,3.1724534034729004,33,15
1861,128,0.11652526767952251,1.5776374168070935,0.9999504430988453,1.0075557136967066,61,113,6.234962463378906,3.1724534034729004,67,15
1862,1,7.107506683453779,7.107506683453781,0.9754953991157775,0.9754953991157784,0,0,7.146322727203369,7.146322727203369,1,1
1862,2,6.514463399588926,6.514463399588926,0.9889809126078675,0.9889809126078681,0,0,7.970341205596924,7.146322727203369,2,2
1862,3,6.163354789669624,6.163354789669625,0.9958910843932645,0.9958910843932647,0,0,8.21177864074707,7.146322727203369,3,3
1862,4,5.967922775656258,5.967922775656257,1.0032662981250087,1.003266298125008,0,0,8.343982696533203,7.146322727203369,4,4
1862,8,5.264797353853164,5.267595451514836,1.0153372484764147,1.0152674181473968,1,1,9.072945594787598,7.146322727203369,7,7
1862,16,4.488477835682118,4.541266251831685,1.0268767215086447,1.026485013715137,3,4,9.347516059875488,7.146322727203369,13,12
1862,32,4.022629153847045,4.518490787925671,1.0233135615388802,1.0277055675539515,10,19,9.84669303894043,7.146322727203369,22,13
1862,64,2.9795526872328044,4.415770948277967,1.0130780587187174,1.029045837794455,33,47,10.274898529052734,7.146322727203369,31,17
1862,128,1.5149996602314266,4.300161501948976,1.0043314844705544,1.0332914636571635,66,108,10.944452285766602,7.146322727203369,62,20
1863,1,10.008927938115358,10.008927938115312,0.9445390134727412,0.9445390134727418,0,0,10.143647193908691,10.143647193908691,1,1
1863,2,8.018518977160612,8.018518977160612,0.9921716996088474,0.9921716996088475,0,0,10.796672821044922,10.143647193908691,2,2
1863,3,7.862622433938734,7.862622433938734,0.9958213073997331,0.9958213073997336,0,0,11.150105476379395,10.143647193908691,3,3
1863,4,7.822708598580985,7.822708598580983,0.9966861204919372,0.9966861204919373,0,0,11.447152137756348,10.143647193908691,4,4
1863,8,6.493145984538485,6.6368004858177105,1.020665576974587,1.020502909156221,3,3,12.062531471252441,10.143647193908691,5,5
1863,16,6.04701851498371,6.244373636116299,1.0326463199409945,1.032191389749015,4,9,12.798346519470215,10.143647193908691,12,7
1863,32,5.17925067058011,6.051120885880735,1.0369021276556545,1.0387162050726069,14,21,13.333614349365234,10.143647193908691,18,11
1863,64,4.15922713214689,5.985809581446184,1.0287631042731615,1.0429095033043572,29,51,13.805925369262695,10.143647193908691,35,13
1863,128,2.7219799520460914,5.899277297212865,1.0218359265425037,1.0484758871295017,62,111,14.543001174926758,10.143647193908691,66,17
1864,1,6.432991190261844,6.432991190261844,0.9742334165330029,0.9742334165330029,0,0,6.480366230010986,6.480366230010986,1,1
1864,2,5.540407878071757,5.540407878071757,0.9866218363984087,0.9866218363984091,0,0,6.637359142303467,6.480366230010986,2,2
1864,3,4.744309644481503,4.744309644481504,0.9973024803579411,0.9973024803579407,0,0,6.941807270050049,6.480366230010986,3,3
1864,4,4.564817598029885,4.564817598029885,1.000578398530481,1.0005783985304808,0,0,6.944640636444092,6.480366230010986,4,4
1864,8,3.6658599478123337,3.679583355380473,1.0114411436826278,1.0117699917827578,1,1,7.407074451446533,6.480366230010986,7,7
1864,16,3.3537021198416106,3.437984596718961,1.0141018665022978,1.0153938838539993,6,6,7.920221328735352,6.480366230010986,10,10
1864,32,2.774404155756578,3.407256898197834,1.0088349121613143,1.0168094591890364,11,18,8.53044319152832,6.480366230010986,21,14
1864,64,2.227345904355181,3.325652714677505,1.006588241114169,1.0189835233592552,29,49,9.139839172363281,6.480366230010986,35,15
1864,128,1.227179886554275,3.304832772080033,1.001474367484617,1.0207881985109268,65,110,9.806440353393555,6.480366230010986,63,18
1865,1,10.041458485600653,10.041458485600657,0.9428520410483707,0.9428520410483724,0,0,10.191471099853516,10.191471099853516,1,1
1865,2,8.593217147243731,8.593217147243733,0.976134513523055,0.9761345135230564,0,0,10.531139373779297,10.191471099853516,2,2
1865,3,8.391479722316056,8.391479722316056,0.9813281293804892,0.9813281293804897,0,0,10.830605506896973,10.191471099853516,3,3
1865,4,8.383573363528804,8.383573363528805,0.9816771055252826,0.9816771055252839,0,0,10.929975509643555,10.191471099853516,4,4
1865,8,7.007610592854531,7.132534065874608,1.0081848053191058,1.0087712226276828,1,3,11.250142097473145,10.191471099853516,7,5
1865,16,6.648017159531107,6.984529672431393,1.0156844790214932,1.0136381243889496,6,9,11.65367603302002,10.191471099853516,10,7
1865,32,5.79454917891399,6.645865731607464,1.0216831563147761,1.0246185707684932,14,21,12.288040161132812,10.191471099853516,18,11
1865,64,4.270020888533451,6.627973874009589,1.0051805286202653,1.0267542402173708,28,51,12.876908302307129,10.191471099853516,36,13
1865,128,2.1251699949896414,6.459578497841323,1.0045136930431307,1.0363126065726416,61,113,13.28161907196045,10.191471099853516,67,15
1866,1,5.9331928561934335,5.933192856193436,0.9855889833006516,0.9855889833006533,0,0,5.948732852935791,5.948732852935791,1,1
1866,2,5.265997804178695,5.265997804178695,0.9967321056366029,0.9967321056366041,0,0,8.294608116149902,5.948732852935791,2,2
1866,3,4.889692426825294,4.889692426825294,1.0040228209429753,1.0040228209429762,0,0,8.804084777832031,5.948732852935791,3,3
1866,4,4.767317477115676,4.767317477115676,1.007070227540738,1.0070702275407386,0,0,8.904692649841309,5.948732852935791,4,4
1866,8,4.524244108109696,4.524244108109697,1.0160113952013987,1.016011395201398,0,0,10.290355682373047,5.948732852935791,8,8
1866,16,3.9701535896593976,4.248316539045633,1.021400748946631,1.0234445797062381,5,6,10.76419734954834,5.948732852935791,11,10
1866,32,3.578889695998023,4.209090117838941,1.0189481305692456,1.0258639872643829,12,19,11.336222648620605,5.948732852935791,20,13
1866,64,2.9597698183828287,4.176998808292784,1.014155695468356,1.027626137013173,29,48,12.291919708251953,5.948732852935791,35,16
1866,128,1.451270236756471,4.118300083162306,1.0014422731961394,1.0309439468001314,66,109,12.960545539855957,5.948732852935791,62,19
1867,1,2.386190582812753,2.386190582812753,0.9991822581300233,0.9991822581300235,0,0,2.38632869720459,2.38632869720459,1,1
1867,2,1.9182178194897594,1.9182178194897597,1.001738159291747,1.0017381592917465,0,0,2.73645281791687,2.38632869720459,2,2
1867,3,1.7846096802145597,1.7846096802145597,1.0024032815308057,1.0024032815308048,0,0,2.7476768493652344,2.38632869720459,3,3
1867,4,1.6999894520056764,1.699989452005677,1.0027241137137304,1.0027241137137295,0,0,3.0410826206207275,2.38632869720459,4,4
1867,8,1.5693924873563492,1.6426251147047266,1.0034720583454495,1.0029293171770965,2,3,3.1364123821258545,2.38632869720459,6,5
1867,16,1.2771242920459027,1.3194205862470858,1.003511708946669,1.0034359983651955,4,6,3.4155426025390625,2.38632869720459,12,10
1867,32,0.8283179226774346,1.3010488245044125,1.001497621967276,1.0038499420838805,14,21,3.7847349643707275,2.38632869720459,18,11
1867,64,0.352089515800488,1.2060956173269424,1.0009448238508485,1.0052143944488137,28,49,4.24300479888916,2.38632869720459,36,15
1867,128,0.023529136264831628,1.1712966115647865,1.0000129520430654,1.0053514007633169,62,110,4.655470848083496,2.38632869720459,66,18
1868,1,9.212770567947167,9.212770567947171,0.9557720979947169,0.9557720979947184,0,0,9.310522079467773,9.310522079467773,1,1
1868,2,8.740910942564541,8.740910942564543,0.967285290238784,0.9672852902387847,0,0,9.78262710571289,9.310522079467773,2,2
1868,3,6.707066992337142,6.707066992337143,1.0005012256296297,1.0005012256296313,0,0,9.954792022705078,9.310522079467773,3,3
1868,4,6.261895519529793,6.261895519529794,1.005905679780074,1.0059056797800752,0,0,9.962470054626465,9.310522079467773,4,4
1868,8,5.332718719595042,5.332718719595041,1.0223042093068244,1.0223042093068258,0,0,10.238960266113281,9.310522079467773,8,8
1868,16,4.984597046552831,5.161735966036581,1.0269243306671898,1.0264196049594354,4,6,10.704217910766602,9.310522079467773,12,10
1868,32,4.403399595862259,5.111405209622392,1.0229562139158108,1.0286929946921748,13,22,11.149524688720703,9.310522079467773,19,10
1868,64,3.760594820159487,5.011110138657481,1.0210786503532776,1.0326717927688673,32,49,11.458105087280273,9.310522079467773,32,15
1868,128,2.5461292624641145,4.984124323795758,1.0137059916744744,1.0338586402489467,58,111,11.771127700805664,9.310522079467773,70,17
1869,1,5.121744761771636,5.121744761771637,0.9887036107119044,0.9887036107119056,0,0,5.133158206939697,5.133158206939697,1,1
1869,2,4.664583731922545,4.664583731922546,0.9961976411033049,0.9961976411033062,0,0,6.641531467437744,5.133158206939697,2,2
1869,3,3.9196917841353254,3.9196917841353245,1.0063651734769996,1.0063651734770003,0,0,6.747183799743652,5.133158206939697,3,3
1869,4,3.6957028441852793,3.6957028441852806,1.0096739840855458,1.009673984085547,0,0,7.1231770515441895,5.133158206939697,4,4
1869,8,3.622500561325102,3.622500561325092,1.012098215110378,1.012098215110385,0,0,7.792851448059082,5.133158206939697,8,8
1869,16,3.400200505346953,3.6173261829961314,1.01118772433518,1.0125813376920116,4,7,8.344118118286133,5.133158206939697,12,9
1869,32,2.821361791213713,3.4196834417472886,1.0112037806221426,1.0166561023227334,14,24,8.887504577636719,5.133158206939697,18,8
1869,64,2.0660620824642497,3.4102329048678452,1.0054431080892343,1.016846842081327,32,54,9.708049774169922,5.133158206939697,32,10
1869,128,1.0573021655409764,3.3981614180878563,1.0015010451629998,1.0183842661019633,62,115,10.501879692077637,5.133158206939697,66,13
1870,1,11.262473508687364,11.262473508687336,0.9172653620293347,0.9172653620293383,0,0,11.521474838256836,11.521474838256836,1,1
1870,2,9.82588036897972,9.825880368979723,0.9605546246497497,0.9605546246497517,0,0,11.611454010009766,11.521474838256836,2,2
1870,3,9.496060006998334,9.496060006998336,0.9693573913293538,0.9693573913293558,0,0,11.99406623840332,11.521474838256836,3,3
1870,4,9.40680373709032,9.406803737090323,0.9700544521189349,0.9700544521189374,0,0,11.995792388916016,11.521474838256836,4,4
1870,8,8.617849421457404,8.629218005198211,0.9965220644850604,0.9951379046810821,2,2,12.575357437133789,11.521474838256836,6,6
1870,16,7.905581581100753,8.433139631621218,1.0137917367021394,1.0017810617040834,6,7,12.777612686157227,11.521474838256836,10,9
1870,32,5.914677978440087,6.997793483175502,1.0457045464867551,1.0337899285941916,15,20,13.516888618469238,11.521474838256836,17,12
1870,64,4.779554582191908,6.960599470921663,1.024659188811826,1.0360538909823231,31,49,14.182562828063965,11.521474838256836,33,15
1870,128,2.732485945619919,6.918152440325615,1.0093832536313796,1.0413185015679152,54,113,14.871747016906738,11.521474838256836,74,15
1871,1,9.923781904086129,9.923781904086134,0.9517604990883373,0.9517604990883387,0,0,10.029378890991211,10.029378890991211,1,1
1871,2,8.943215647519962,8.943215647519963,0.9769977176687651,0.9769977176687661,0,0,10.779232025146484,10.029378890991211,2,2
1871,3,8.708274149471295,8.708274149471297,0.9855825075318958,0.9855825075318972,0,0,11.826811790466309,10.029378890991211,3,3
1871,4,8.684457468684068,8.708274149471297,0.9845265114574487,0.9855825075318972,1,1,11.893789291381836,10.029378890991211,3,3
1871,8,6.547478302882512,6.617568296853653,1.0260448271873412,1.0277135507474908,1,1,12.085351943969727,10.029378890991211,7,7
1871,16,6.068413990150314,6.25003009961949,1.0351018840843194,1.0368739842300723,4,4,12.714385032653809,10.029378890991211,12,12
1871,32,5.228971198149296,5.998915688942987,1.0379601566697976,1.0453533983645749,13,18,13.170613288879395,10.029378890991211,19,14
1871,64,3.8278944752033106,5.64173036663916,1.0288680204551606,1.0573055237578226,26,47,13.651941299438477,10.029378890991211,38,17
1871,128,2.5130223560057274,5.583591751118651,1.0086539064430942,1.0607581586927664,58,107,14.297532081604004,10.029378890991211,70,21
1872,1,7.233284454008544,7.233284454008494,0.9690099819998249,0.9690099819998259,0,0,7.2942986488342285,7.2942986488342285,1,1
1872,2,6.152918525901404,6.152918525901406,0.9857421666467172,0.9857421666467179,0,0,7.388679504394531,7.2942986488342285,2,2
1872,3,5.9949756717060385,5.9949756717060385,0.9889884259380497,0.9889884259380497,0,0,7.442492485046387,7.2942986488342285,3,3
1872,4,5.585308764492326,5.585308764492326,0.994218521305281,0.994218521305281,0,0,7.542356014251709,7.2942986488342285,4,4
1872,8,4.197218521235581,4.246018776009216,1.0136490859007008,1.013244509824225,1,1,7.973197937011719,7.2942986488342285,7,7
1872,16,3.742423487367944,3.9762191665310223,1.016910551521676,1.0194591203800785,5,8,8.654007911682129,7.2942986488342285,11,8
1872,32,3.1406805868725147,3.8794008339148767,1.014119292401702,1.0222028182613307,15,22,9.406627655029297,7.2942986488342285,17,10
1872,64,1.9338170698299455,3.8060950195345837,1.0055644226751865,1.0249231462636197,32,52,10.026594161987305,7.2942986488342285,32,12
1872,128,1.1817027601297585,3.8060253529333448,1.0008043430216087,1.0250035715796468,66,114,10.6403169631958,7.2942986488342285,62,14
1873,1,7.183962487543437,7.183962487543437,0.9684033055253051,0.9684033055253046,0,0,7.24629545211792,7.24629545211792,1,1
1873,2,6.324794769886932,6.32479476988693,0.9820559337921451,0.982055933792144,0,0,7.517017364501953,7.24629545211792,2,2
1873,3,5.595443043278351,5.595443043278351,0.9946378645256347,0.9946378645256337,0,0,7.951764106750488,7.24629545211792,3,3
1873,4,5.584589992161061,5.584589992161062,0.9950533855967636,0.995053385596763,0,0,7.974660873413086,7.24629545211792,4,4
1873,8,4.849284763352105,4.855033717175763,1.0088569601718764,1.008914672893197,1,1,8.650483131408691,7.24629545211792,7,7
1873,16,4.484520125312787,4.734900061487912,1.0110006523650128,1.0110689907370733,5,6,9.072093963623047,7.24629545211792,11,10
1873,32,3.7845454228765116,4.446107410393368,1.014797282026256,1.0182331696588331,14,16,9.586665153503418,7.24629545211792,18,16
1873,64,2.5725168027708896,4.150051546334555,1.0088163480963748,1.0256547389920572,26,51,10.30383014678955,7.24629545211792,38,13
1873,128,1.1183546102885553,4.127263637757418,1.0021913270665521,1.0271704379439552,70,110,11.186901092529297,7.24629545211792,58,18
1874,1,10.200850176886597,10.200850176886602,0.9327916586155056,0.9327916586155071,0,0,10.398239135742188,10.398239135742188,1,1
1874,2,8.898966794587665,8.898966794587665,0.9634022834291267,0.9634022834291269,0,0,10.795909881591797,10.398239135742188,2,2
1874,3,8.488376535596153,8.488376535596151,0.9764245122835212,0.9764245122835205,0,0,11.108985900878906,10.398239135742188,3,3
1874,4,8.484286099486978,8.484286099486974,0.9767136886703535,0.9767136886703522,0,0,11.115750312805176,10.398239135742188,4,4
1874,8,7.12342677269851,7.248897257717704,1.0098689783545556,1.0102256904691218,2,3,11.473836898803711,10.398239135742188,6,5
1874,16,6.314391062702136,6.488232178290894,1.0294238065144616,1.0296796279308678,4,6,11.911600112915039,10.398239135742188,12,10
1874,32,5.520940961536947,6.148700074159157,1.0391026738401725,1.0386834367696367,11,16,12.401956558227539,10.398239135742188,21,16
1874,64,4.487138886086819,5.874568637045551,1.0386222321491199,1.0467525132702953,30,45,12.754467964172363,10.398239135742188,34,19
1874,128,2.7693882668105205,5.861745214424908,1.0104161867218977,1.0470396889983653,62,103,13.366901397705078,10.398239135742188,66,25
1875,1,7.823086328001735,7.823086328001734,0.9704948730013461,0.9704948730013458,0,0,7.873319149017334,7.873319149017334,1,1
1875,2,6.810622143316525,6.810622143316525,0.9843521811579112,0.9843521811579115,0,0,8.109167098999023,7.873319149017334,2,2
1875,3,6.051456148240102,6.051456148240103,0.9964341399165435,0.9964341399165435,0,0,8.22182559967041,7.873319149017334,3,3
1875,4,5.799294251702119,5.79929425170212,0.9998734459145285,0.999873445914529,0,0,8.377569198608398,7.873319149017334,4,4
1875,8,5.296075847790645,5.342758085200234,1.0065334491792213,1.0072896689197446,1,1,9.265460014343262,7.873319149017334,7,7
1875,16,4.893645304242792,5.2397631460592695,1.0106809728857582,1.012120382651809,4,6,9.856643676757812,7.873319149017334,12,10
1875,32,4.094810371019936,5.000226755994793,1.0153898793866405,1.0201520463247635,12,20,10.667844772338867,7.873319149017334,20,12
1875,64,2.9790053378578834,4.781146318276076,1.0123823082828882,1.0273180224255585,29,53,11.319180488586426,7.873319149017334,35,11
1875,128,1.4749105754092695,4.6536324001333345,1.0039058603000666,1.0320232097277309,59,113,12.1620512008667,7.873319149017334,69,15
1876,1,2.817952256560984,2.8179522565609845,0.9935054634189121,0.9935054634189107,0,0,2.825160026550293,2.825160026550293,1,1
1876,2,2.5244598420952675,2.524459842095266,0.9957925103215571,0.995792510321555,0,0,2.924008846282959,2.825160026550293,2,2
1876,3,2.4568676261791196,2.4568676261791302,0.9960957942326314,0.9960957942326298,0,0,3.197441577911377,2.825160026550293,3,3
1876,4,1.7677587325829245,1.7677587325829232,1.0007138736640633,1.0007138736640617,0,0,3.2406375408172607,2.825160026550293,4,4
1876,8,1.4427009480087463,1.442700948008744,1.0026319390514518,1.0026319390514482,0,0,3.305722713470459,2.825160026550293,8,8
1876,16,1.3315263676541733,1.3482769914087696,1.003092850919125,1.0032359523797356,5,5,3.461683511734009,2.825160026550293,11,11
1876,32,0.7636376885029872,1.2781503004305785,1.0026849173450973,1.0037720229430742,11,18,3.6889376640319824,2.825160026550293,21,14
1876,64,0.4280743274513851,1.2239998679355433,1.0010495569633413,1.0044727421040605,33,46,3.992753028869629,2.825160026550293,31,18
1876,128,0.02981849933070091,1.1689211707229026,0.9999732396503471,1.0048475625327749,65,109,4.351963043212891,2.825160026550293,63,19
1877,1,8.82577955904906,8.82577955904906,0.9577631883796602,0.95776318837966,0,0,8.915196418762207,8.915196418762207,1,1
1877,2,6.890962853690863,6.890962853690863,0.9897668519217169,0.9897668519217158,0,0,9.053821563720703,8.915196418762207,2,2
1877,3,6.6365338854309455,6.636533885430945,0.9939102043841783,0.9939102043841772,0,0,9.10767650604248,8.915196418762207,3,3
1877,4,6.230015683947247,6.230015683947247,0.9990724367568276,0.9990724367568261,0,0,9.139509201049805,8.915196418762207,4,4
1877,8,5.976558898476979,5.976712358917475,1.0048690501305741,1.0048480535131632,1,1,9.686738014221191,8.915196418762207,7,7
1877,16,5.184234386702725,5.364853628092793,1.019360900141584,1.0198373327743857,5,6,10.226011276245117,8.915196418762207,11,10
1877,32,4.4387774644043425,4.955583573884819,1.02346873927869,1.0261962110376721,13,22,10.801565170288086,8.915196418762207,19,10
1877,64,3.0582912545300784,4.908158458269924,1.0105538100520635,1.0269040719181453,32,52,11.449606895446777,8.915196418762207,32,12
1877,128,1.5981857346476585,4.908057068222779,1.0045068555993513,1.0269735398214612,62,115,12.017911911010742,8.915196418762207,66,13
1878,1,9.506199993832421,9.506199993832423,0.9484696536991061,0.9484696536991065,0,0,9.6288480758667,9.6288480758667,1,1
1878,2,7.869850242745953,7.869850242745953,0.9763849367395891,0.9763849367395894,0,0,9.772374153137207,9.6288480758667,2,2
1878,3,7.4942207967968715,7.494220796796873,0.9868560323750459,0.9868560323750458,0,0,10.82719898223877,9.6288480758667,3,3
1878,4,7.321522583515661,7.321522583515661,0.9931210639845943,0.9931210639845944,0,0,11.208569526672363,9.6288480758667,4,4
1878,8,7.1885767577514805,7.253739945602893,0.9974863733044126,0.9965703970600673,1,1,11.400106430053711,9.6288480758667,7,7
1878,16,6.712994586524508,6.949732019610994,1.0125354002909888,1.008982984506245,6,7,11.935236930847168,9.6288480758667,10,9
1878,32,6.164449359064374,6.661018349996086,1.0197382587070802,1.0170624237799322,16,18,12.260303497314453,9.6288480758667,16,14
1878,64,4.7964915946222115,6.456445414644426,1.0204808080758296,1.0263338981900665,29,49,12.719609260559082,9.6288480758667,35,15
1878,128,2.807293439259549,6.440569023865115,1.0071292281336799,1.0276386421489732,64,110,13.345788955688477,9.6288480758667,64,18
1879,1,6.999066915696637,6.999066915696637,0.9818335536475739,0.9818335536475741,0,0,7.020534038543701,7.020534038543701,1,1
1879,2,5.7842914476812926,5.7842914476812926,1.0011167251482032,1.0011167251482036,0,0,7.526010990142822,7.020534038543701,2,2
1879,3,5.742077666118373,5.742077666118373,1.0024597242569369,1.0024597242569369,0,0,7.9714579582214355,7.020534038543701,3,3
1879,4,5.312308906249796,5.312308906249796,1.00718217712922,1.0071821771292198,0,0,8.108621597290039,7.020534038543701,4,4
1879,8,4.7421825190605595,4.750544355381548,1.0137764030463745,1.0138002371829062,1,2,8.535552024841309,7.020534038543701,7,6
1879,16,4.065256293873049,4.230887740304592,1.0201089703374506,1.0210356044955748,6,7,8.895195960998535,7.020534038543701,10,9
1879,32,3.662217331442391,4.072644030488978,1.0171353879230316,1.024011641964557,15,18,9.60737419128418,7.020534038543701,17,14
1879,64,3.121257115961205,3.9716197339989745,1.0181840930166746,1.0279215842753466,28,47,10.152874946594238,7.020534038543701,36,17
1879,128,1.6293610558630178,3.931984476147333,1.006280706936913,1.0311352758322858,62,105,11.059635162353516,7.020534038543701,66,23
1880,1,11.613850671530663,11.613850671530619,0.9183302693829861,0.9183302693829881,0,0,11.866215705871582,11.866215705871582,1,1
1880,2,11.06004112405406,11.060041124054043,0.9395254394089784,0.9395254394089799,0,0,12.404752731323242,11.866215705871582,2,2
1880,3,10.787366815875382,10.787366815875385,0.9486602871486396,0.9486602871486414,0,0,12.789861679077148,11.866215705871582,3,3
1880,4,10.219455760754043,10.219455760754043,0.9650123235937926,0.9650123235937937,0,0,12.807751655578613,11.866215705871582,4,4
1880,8,9.438969947618784,9.462107748388119,0.9859626720879209,0.9864406187919028,2,2,13.638547897338867,11.866215705871582,6,6
1880,16,8.541517540624012,8.675007345253942,1.0186900979702975,1.0165849355714724,5,6,13.987885475158691,11.866215705871582,11,10
1880,32,6.844832387005317,8.047079602472213,1.0361050970412755,1.033922236499195,12,19,14.414708137512207,11.866215705871582,20,13
1880,64,5.1007635174611705,7.872025811633035,1.0269501479612655,1.0420162001788076,30,48,15.210617065429688,11.866215705871582,34,16
1880,128,3.4135348192422197,7.663286184355779,1.0169976954074753,1.0499499114453272,59,110,15.739306449890137,11.866215705871582,69,18
1881,1,5.549027870492099,5.5490278704921,0.9809109223810893,0.98091092238109,0,0,5.579225063323975,5.579225063323975,1,1
1881,2,4.376189903489337,4.376189903489337,1.00009972244421,1.00009972244421,0,0,6.483672618865967,5.579225063323975,2,2
1881,3,4.235872266594273,4.235872266594274,1.0024562002334214,1.002456200233421,0,0,6.499361515045166,5.579225063323975,3,3
1881,4,4.235054610795247,4.235054610795246,1.0025781477002063,1.0025781477002067,0,0,6.674859523773193,5.579225063323975,4,4
1881,8,3.1515918370774694,3.362674331987928,1.0110516075550138,1.0111625993408866,1,1,6.860456943511963,5.579225063323975,7,7
1881,16,2.7613059176903794,3.1044037951152514,1.013260343942158,1.0132744058620864,5,8,7.40575647354126,5.579225063323975,11,8
1881,32,2.289153606837419,2.8157708985453844,1.0133648791278245,1.0175140209044187,12,20,8.052413940429688,5.579225063323975,20,12
1881,64,1.6265567814071584,2.780920978508125,1.0037623412330232,1.0187329235103686,28,49,8.94249153137207,5.579225063323975,36,15
1881,128,0.7372930564048179,2.76700168550693,1.0002396111298424,1.0196874041761523,61,111,9.617963790893555,5.579225063323975,67,17
1882,1,11.665393734125102,11.66539373412511,0.9212212513962,0.9212212513962029,0,0,11.885344505310059,11.885344505310059,1,1
1882,2,9.6575531205354,9.657553120535404,0.9771461226446257,0.9771461226446287,0,0,12.122566223144531,11.885344505310059,2,2
1882,3,8.560985141324311,8.56098514132431,1.0031226875921164,1.0031226875921175,0,0,12.22159481048584,11.885344505310059,3,3
1882,4,8.303592708141561,8.303592708141561,1.0105430740027714,1.0105430740027732,0,0,12.409859657287598,11.885344505310059,4,4
1882,8,7.515698029208654,7.515893616765949,1.032024110414339,1.0321310758780862,1,1,13.750600814819336,11.885344505310059,7,7
1882,16,7.058651012605124,7.32438039412016,1.0333171283593878,1.0390513352802233,7,6,14.763595581054688,11.885344505310059,9,10
1882,32,6.495450710963591,7.3051791610333945,1.0233061293273709,1.0415091982356064,14,17,15.441446304321289,11.885344505310059,18,15
1882,64,4.762416929832496,7.160305017728089,1.0166141474823482,1.0448682071996633,28,51,16.232969284057617,11.885344505310059,36,13
1882,128,2.9773208304349303,7.142757497524171,1.0097693211983665,1.0466875688563468,66,115,16.887252807617188,11.885344505310059,62,13
1883,1,8.94750154986308,8.947501549863086,0.9560195447248401,0.9560195447248421,0,0,9.047042846679688,9.047042846679688,1,1
1883,2,8.004780867521177,8.00478086752118,0.9815271004775328,0.981527100477535,0,0,10.461541175842285,9.047042846679688,2,2
1883,3,7.225975496437506,7.225975496437506,0.9963951941763838,0.9963951941763844,0,0,10.479387283325195,9.047042846679688,3,3
1883,4,6.5640701533153685,6.564070153315368,1.0138823075663044,1.0138823075663048,0,0,11.457769393920898,9.047042846679688,4,4
1883,8,5.987513505111496,6.077140563193035,1.0299500849798595,1.0272666720674535,1,2,11.895120620727539,9.047042846679688,7,6
1883,16,5.134576812336611,5.992354375367533,1.0309640006640053,1.0328585462147304,5,7,12.522622108459473,9.047042846679688,11,9
1883,32,4.77348544964648,5.87088744867448,1.0314438744447463,1.0379859628276327,13,20,12.840008735656738,9.047042846679688,19,12
1883,64,3.891266331797931,5.7444676204123235,1.021559811855599,1.0420605627592119,27,52,13.446642875671387,9.047042846679688,37,12
1883,128,2.184758607249875,5.728972643539853,1.0094093552931833,1.0444278611501632,61,114,14.265678405761719,9.047042846679688,67,14
1884,1,3.422766442111797,3.4227664421117954,0.9949425593751897,0.9949425593751879,0,0,3.4263246059417725,3.4263246059417725,1,1
1884,2,2.8195338184489724,2.8195338184489724,0.9988401954917334,0.9988401954917325,0,0,3.722395896911621,3.4263246059417725,2,2
1884,3,2.801790918170873,2.8017909181708727,0.9991605320387869,0.9991605320387855,0,0,3.9832029342651367,3.4263246059417725,3,3
1884,4,2.7883611280794733,2.788361128079473,0.999095677792084,0.999095677792083,0,0,3.993591785430908,3.4263246059417725,4,4
1884,8,2.3140873078148307,2.382647429220787,1.0024247001448257,1.0020741641937274,2,3,4.248355388641357,3.4263246059417725,6,5
1884,16,2.051371362566178,2.2848468327373643,1.004277559307365,1.0031583044951868,5,8,4.72189998626709,3.4263246059417725,11,8
1884,32,1.512992384683028,2.1521438044459114,1.005319797394398,1.005838781068076,14,21,5.382368087768555,3.4263246059417725,18,11
1884,64,0.9149878069344002,2.139484506440786,1.0010284672255272,1.006297882117519,29,50,5.839376449584961,3.4263246059417725,35,14
1884,128,0.15524452725884105,2.0992958182343293,1.0004028872914181,1.007586981903915,64,114,6.413509368896484,3.4263246059417725,64,14
1885,1,6.3673686292940594,6.3673686292940594,0.9796760526813866,0.9796760526813886,0,0,6.397841453552246,6.397841453552246,1,1
1885,2,5.584759810115238,5.584759810115238,0.9914472161928131,0.9914472161928141,0,0,6.68227481842041,6.397841453552246,2,2
1885,3,4.9829826365526015,4.9829826365526015,0.9985657155242926,0.9985657155242931,0,0,6.748513698577881,6.397841453552246,3,3
1885,4,4.91492399768056,4.91492399768056,0.9989294040514478,0.9989294040514487,0,0,6.776540279388428,6.397841453552246,4,4
1885,8,4.426825218898251,4.5723667596818665,1.0026537322907791,1.0017601111991448,3,3,7.042265892028809,6.397841453552246,5,5
1885,16,3.912338190826064,4.392971480577673,1.0084683831594377,1.0053006631370744,7,9,7.410785675048828,6.397841453552246,9,7
1885,32,3.0498656371770685,4.251569867071491,1.0074475728636023,1.0079376583510498,16,23,7.724123954772949,6.397841453552246,16,9
1885,64,2.154760992674782,4.16846658874959,1.0040467816653806,1.0103629622148083,31,57,8.264459609985352,6.397841453552246,33,7
1885,128,0.8586864295575729,4.168238055888334,1.001351074090291,1.0104656411413937,65,120,8.733729362487793,6.397841453552246,63,8
1886,1,5.192305684557257,5.192305684557261,0.9842791180048821,0.9842791180048837,0,0,5.214097499847412,5.214097499847412,1,1
1886,2,4.33365693082084,4.333656930820841,0.9965872505054734,0.9965872505054748,0,0,6.633230209350586,5.214097499847412,2,2
1886,3,4.222635185846491,4.2226351858464914,0.9988351986531958,0.9988351986531968,0,0,7.062817096710205,5.214097499847412,3,3
1886,4,3.5890026374118627,3.5890026374118666,1.006490069931009,1.0064900699310098,0,0,7.354122161865234,5.214097499847412,4,4
1886,8,3.4737589815116436,3.473879229508037,1.0094464800590606,1.0094705305915905,1,1,7.689533710479736,5.214097499847412,7,7
1886,16,3.242570633539552,3.320459696506059,1.0106366047153288,1.01164327634807,5,7,8.505633354187012,5.214097499847412,11,9
1886,32,2.8430542991182404,3.2408145687188887,1.0110622105310512,1.0147444192090038,12,21,9.075431823730469,5.214097499847412,20,11
1886,64,1.850711203847261,3.1774404810421113,1.0040286948180446,1.0153725974880357,31,54,9.80178165435791,5.214097499847412,33,10
1886,128,0.961181567798622,3.1689954814043815,1.0019060751487343,1.0163912126061325,51,114,10.802495002746582,5.214097499847412,77,14
1887,1,7.424761869789712,7.424761869789712,0.9673487893591203,0.9673487893591202,0,0,7.4905805587768555,7.4905805587768555,1,1
1887,2,5.664132732808828,5.664132732808828,0.9942145011260668,0.9942145011260661,0,0,7.661711692810059,7.4905805587768555,2,2
1887,3,5.643868151342955,5.643868151342955,0.9950405265778434,0.995040526577843,0,0,8.054909706115723,7.4905805587768555,3,3
1887,4,5.318760650296735,5.318760650296735,0.9996800668885828,0.9996800668885822,0,0,8.478206634521484,7.4905805587768555,4,4
1887,8,4.899148315919099,5.00657019964631,1.0074715533817304,1.0063937966850114,2,3,8.725852012634277,7.4905805587768555,6,5
1887,16,4.157838919157583,4.736099680542628,1.0120361300980876,1.012180567138212,7,8,9.255438804626465,7.4905805587768555,9,8
1887,32,3.797980955043692,4.691699041374301,1.0143061427783733,1.0141354149805375,14,21,9.849310874938965,7.4905805587768555,18,11
1887,64,2.9820572730056587,4.663985847103124,1.012757709060847,1.0155142961039663,31,51,10.283082962036133,7.4905805587768555,33,13
1887,128,1.3308331304287024,4.64713292502089,1.0007993277597513,1.0168003257324858,72,113,10.978723526000977,7.4905805587768555,56,15
1888,1,5.000807734505431,5.0008077345054325,0.9880711263071441,0.9880711263071452,0,0,5.013958930969238,5.013958930969238,1,1
1888,2,4.342569612588757,4.342569612588757,0.9949379418557842,0.9949379418557845,0,0,5.246911525726318,5.013958930969238,2,2
1888,3,4.21680051781062,4.21680051781062,0.9970562424169327,0.9970562424169329,0,0,5.933021545410156,5.013958930969238,3,3
1888,4,4.139594697968376,4.139594697968376,0.9981369158805877,0.9981369158805884,0,0,6.034224033355713,5.013958930969238,4,4
1888,8,3.71879719289369,3.7281414583820447,1.0034555816045563,1.003661890286701,3,3,6.387197017669678,5.013958930969238,5,5
1888,16,3.4064181673928493,3.5344648175709117,1.006063020860582,1.007521107172738,6,6,7.056283950805664,5.013958930969238,10,10
1888,32,2.7849681323033164,3.484738771996407,1.0020556511736942,1.008621066370169,11,19,8.070965766906738,5.013958930969238,21,13
1888,64,2.1162199584442156,3.456075507248462,1.0039549010756885,1.0099184943006563,26,50,8.907103538513184,5.013958930969238,38,14
1888,128,0.9433817841613179,3.4434892428177704,1.0005350321946305,1.0110908506639442,60,113,9.75244140625,5.013958930969238,68,15
1889,1,8.732794297978689,8.732794297978696,0.954151723403736,0.9541517234037388,0,0,8.838508605957031,8.838508605957031,1,1
1889,2,7.238729015639986,7.238729015639987,0.9900957083528508,0.9900957083528521,0,0,10.026521682739258,8.838508605957031,2,2
1889,3,6.54098419574162,6.54098419574162,1.001692779115695,1.0016927791156958,0,0,10.222379684448242,8.838508605957031,3,3
1889,4,6.297569650792245,6.297569650792245,1.0044583253567303,1.0044583253567305,0,0,10.24527645111084,8.838508605957031,4,4
1889,8,5.8911252125502225,5.981563633585998,1.0124416803536118,1.010722799365285,1,1,10.641667366027832,8.838508605957031,7,7
1889,16,5.720679620315996,5.928918020263294,1.011391738888225,1.0136124691733757,6,6,11.137571334838867,8.838508605957031,10,10
1889,32,4.8148110224107805,5.8008613998899765,1.0222680910862694,1.0226154516602175,13,19,12.153950691223145,8.838508605957031,19,13
1889,64,3.6525355518661415,5.516241377134485,1.0095718199831047,1.0303344340082823,31,51,12.966704368591309,8.838508605957031,33,13
1889,128,1.9755192108991473,5.462541789944427,1.0054916650348726,1.0338132228163837,65,114,13.639588356018066,8.838508605957031,63,14
1890,1,8.687082503604843,8.687082503604849,0.9469655859769256,0.94696558597693,0,0,8.832151412963867,8.832151412963867,1,1
1890,2,7.941501921628006,7.94150192162801,0.9680518699895947,0.968051869989598,0,0,9.306829452514648,8.832151412963867,2,2
1890,3,7.697178589711659,7.697178589711659,0.9755182116130086,0.9755182116130106,0,0,10.111997604370117,8.832151412963867,3,3
1890,4,6.666842024526601,6.666842024526602,0.9989088185579598,0.9989088185579624,0,0,10.939091682434082,8.832151412963867,4,4
1890,8,5.899220264121985,5.899220264121984,1.0151107644388868,1.0151107644388888,0,0,11.330490112304688,8.832151412963867,8,8
1890,16,5.3586590569716375,5.583874496112152,1.0221339227062334,1.0245705492895267,4,4,11.857109069824219,8.832151412963867,12,12
1890,32,4.787277487493781,5.576433217024917,1.019958511105831,1.0261718772180748,14,16,12.440935134887695,8.832151412963867,18,16
1890,64,3.245309959029752,5.401716913162103,1.011546207254446,1.0359003909544833,31,46,13.20087718963623,8.832151412963867,33,18
1890,128,1.8828701613012209,5.350224148091339,1.0010343448855585,1.0390998762334274,72,108,13.908236503601074,8.832151412963867,56,20
1891,1,9.948835054419915,9.948835054419916,0.9365842802562471,0.9365842802562498,0,0,10.126737594604492,10.126737594604492,1,1
1891,2,8.121675386894436,8.121675386894438,0.9859083221048682,0.9859083221048699,0,0,11.384299278259277,10.126737594604492,2,2
1891,3,7.469449424079819,7.4694494240798175,1.0000560038530852,1.000056003853085,0,0,11.611501693725586,10.126737594604492,3,3
1891,4,7.449093394261709,7.44909339426171,1.0009835559790874,1.0009835559790885,0,0,11.841854095458984,10.126737594604492,4,4
1891,8,7.150836669768982,7.150836669768979,1.0115988505721112,1.0115988505721125,0,0,12.234248161315918,10.126737594604492,8,8
1891,16,6.111048263592246,6.380477764635767,1.029979554503449,1.0324669521026522,7,6,12.786317825317383,10.126737594604492,9,10
1891,32,5.633591489387314,6.3496156491255595,1.0281285612581206,1.0352568777040867,16,21,13.389969825744629,10.126737594604492,16,11
1891,64,4.443019335519351,6.293435629555062,1.0107529083300628,1.0406061333085936,30,49,14.257349967956543,10.126737594604492,34,15
1891,128,2.6145920122659585,6.2615492306937535,0.9977712894644617,1.0418314516552927,66,112,15.195112228393555,10.126737594604492,62,16
1892,1,10.284366035223728,10.284366035223725,0.9405521047275904,0.9405521047275937,0,0,10.431499481201172,10.431499481201172,1,1
1892,2,8.81342367007962,8.813423670079622,0.9703916596572493,0.9703916596572505,0,0,10.440412521362305,10.431499481201172,2,2
1892,3,8.324822173423353,8.324822173423334,0.9855110185199096,0.9855110185199123,0,0,10.672229766845703,10.431499481201172,3,3
1892,4,7.9013035307051664,7.901303530705168,0.9951639181988445,0.9951639181988468,0,0,10.751654624938965,10.431499481201172,4,4
1892,8,7.506510377554546,7.635157994763497,1.0061120819905067,1.0040658619928435,1,2,11.281540870666504,10.431499481201172,7,6
1892,16,7.104404044530213,7.5798051993479065,1.0055936722808974,1.0059067019979844,5,8,11.96690845489502,10.431499481201172,11,8
1892,32,5.816221473020858,6.439405589834315,1.0404920894342768,1.0385025392298748,11,20,12.638093948364258,10.431499481201172,21,12
1892,64,4.68272962204843,6.391843495769624,1.0185697129828832,1.0397503513044926,28,50,13.485048294067383,10.431499481201172,36,14
1892,128,3.190415332477325,6.323642305099758,1.003920984677944,1.0450155838574826,59,112,14.319439888000488,10.431499481201172,69,16
1893,1,10.435024339374229,10.435024339374237,0.9274469184253926,0.9274469184253953,0,0,10.656957626342773,10.656957626342773,1,1
1893,2,9.260524656541019,9.260524656541023,0.9543309749343252,0.9543309749343267,0,0,10.743099212646484,10.656957626342773,2,2
1893,3,8.288390152924844,8.288390152924846,0.9792535483740196,0.9792535483740203,0,0,11.10975170135498,10.656957626342773,3,3
1893,4,7.855253289221472,7.85525328922147,0.9902742769909044,0.9902742769909041,0,0,11.271063804626465,10.656957626342773,4,4
1893,8,6.929912376479388,6.940147055889652,1.0156257694683268,1.015569040679932,2,2,11.73689079284668,10.656957626342773,6,6
1893,16,6.780372313272402,6.852359469638348,1.0184172921166186,1.0202722745686177,4,6,12.365307807922363,10.656957626342773,12,10
1893,32,5.868731759047117,6.32071534615752,1.0339851621557983,1.0386548227320043,13,19,12.777883529663086,10.656957626342773,19,13
1893,64,4.28523505739267,6.200945424876235,1.0190120537631455,1.0442142487901878,29,48,13.485193252563477,10.656957626342773,35,16
1893,128,2.0446449440711296,6.156998041407626,1.0055935223145702,1.0467708396433661,64,111,14.317052841186523,10.656957626342773,64,17
1894,1,7.16405230053374,7.164052300533742,0.9735976369396621,0.9735976369396626,0,0,7.208959102630615,7.208959102630615,1,1
1894,2,6.229100801856562,6.229100801856566,0.9889074874525792,0.9889074874525785,0,0,7.371243953704834,7.208959102630615,2,2
1894,3,5.7474034545615895,5.747403454561589,0.9969251027890129,0.9969251027890125,0,0,7.527921676635742,7.208959102630615,3,3
1894,4,5.3220106461510355,5.323635611569065,1.0030723122470335,1.0029424491754773,1,1,7.943000316619873,7.208959102630615,3,3
1894,8,4.510490051403552,4.85649617296623,1.0095826306976055,1.0091224723541112,2,2,8.641916275024414,7.208959102630615,6,6
1894,16,3.8516017468811357,4.432802787980013,1.0155176116732738,1.0176096343804935,6,7,9.007657051086426,7.208959102630615,10,9
1894,32,2.9003960031494955,4.427790988757885,1.009218850245059,1.017921245588009,15,22,9.374947547912598,7.208959102630615,17,10
1894,64,2.101184574363441,4.263575735129121,1.0053162620141136,1.0238162640873483,34,51,9.705300331115723,7.208959102630615,30,13
1894,128,1.0500141312709395,4.263422217681972,1.001935708384548,1.0239278296161511,68,114,10.264848709106445,7.208959102630615,60,14
1895,1,12.934921359474282,12.934921359474288,0.9040254762469258,0.9040254762469274,0,0,13.249021530151367,13.249021530151367,1,1
1895,2,11.816565185925198,11.816565185925198,0.9407381638539871,0.9407381638539868,0,0,13.55923080444336,13.249021530151367,2,2
1895,3,10.653967769740722,10.65396776974072,0.97615181948432,0.9761518194843188,0,0,13.664092063903809,13.249021530151367,3,3
1895,4,10.471143003299762,10.47114300329976,0.9845782483345772,0.9845782483345761,0,0,14.705001831054688,13.249021530151367,4,4
1895,8,9.431353926151395,9.441758119828997,1.0223150854531249,1.0229400856435518,1,1,15.399171829223633,13.249021530151367,7,7
1895,16,9.072647237718227,9.375995703951695,1.021591356615474,1.0285062812729513,4,6,16.01692771911621,13.249021530151367,12,10
1895,32,7.726325609088174,9.072911669848038,1.0421324413351172,1.0505004419638067,12,20,16.56312370300293,13.249021530151367,20,12
1895,64,5.859455419895789,9.030136916015376,1.0353817277271817,1.054712298979426,27,50,17.389972686767578,13.249021530151367,37,14
1895,128,4.045022428226905,9.024326067421459,1.0122470938939878,1.056491222372414,67,111,18.362951278686523,13.249021530151367,61,17
1896,1,10.597192824561057,10.597192824561064,0.9288195121680242,0.9288195121680267,0,0,10.802124977111816,10.802124977111816,1,1
1896,2,9.440199204632929,9.440199204632934,0.9601427130752408,0.960142713075242,0,0,11.107355117797852,10.802124977111816,2,2
1896,3,8.352674253573154,8.352674253573136,0.985751375225409,0.9857513752254105,0,0,11.139802932739258,10.802124977111816,3,3
1896,4,8.222459234314083,8.222459234314082,0.9886041058544169,0.9886041058544188,0,0,11.19455623626709,10.802124977111816,4,4
1896,8,7.882139654965886,7.882304678254676,0.998416177066257,0.9985485972221669,1,1,12.490452766418457,10.802124977111816,7,7
1896,16,7.072816166335187,7.22653209969556,1.0168664063886161,1.0224543755814188,5,7,13.099615097045898,10.802124977111816,11,9
1896,32,6.1961084750570175,6.680083419254335,1.0440444728082068,1.0471593754814479,11,18,13.935652732849121,10.802124977111816,21,14
1896,64,5.282338722498302,6.451379461553086,1.0438461610537657,1.0571999386025193,30,46,14.569390296936035,10.802124977111816,34,18
1896,128,3.1065886920008863,6.41131961305204,1.0157831719645545,1.0607620390639867,58,109,15.371103286743164,10.802124977111816,70,19
1897,1,3.094449420620661,3.0944494206206614,0.9991120265573382,0.9991120265573384,0,0,3.0945820808410645,3.0945820808410645,1,1
1897,2,2.6520981115476454,2.6520981115476454,1.0026678966589821,1.002667896658982,0,0,3.1102654933929443,3.0945820808410645,2,2
1897,3,2.4925203236190674,2.492520323619068,1.0039147470429532,1.003914747042953,0,0,3.2007744312286377,3.0945820808410645,3,3
1897,4,2.4916063221428497,2.49160632214285,1.0039427887654244,1.0039427887654235,0,0,3.2801244258880615,3.0945820808410645,4,4
1897,8,2.4007653702002836,2.4143362508591593,1.0044210012673038,1.0047990032731564,2,2,3.480795383453369,3.0945820808410645,6,6
1897,16,2.131492722214763,2.3284209226488572,1.00434893698206,1.0054931421521678,6,9,3.6795568466186523,3.0945820808410645,10,7
1897,32,1.7107911419388557,2.1949102987410765,1.005936362706378,1.0069722086636816,14,25,3.9270403385162354,3.0945820808410645,18,7
1897,64,0.8113247953263116,2.1115891283380885,1.00364188139944,1.0076060598240937,30,54,4.152442932128906,3.0945820808410645,34,10
1897,128,0.04655360327413451,2.110090139804387,0.9999863092128946,1.0077379936794615,68,113,4.726521968841553,3.0945820808410645,60,15
1898,1,10.311192569896662,10.311192569896663,0.931454647997744,0.9314546479977442,0,0,10.507384300231934,10.507384300231934,1,1
1898,2,8.933503670736918,8.933503670736915,0.9676605974033703,0.9676605974033693,0,0,10.870158195495605,10.507384300231934,2,2
1898,3,7.689531172575651,7.689531172575651,0.9989079995263045,0.9989079995263026,0,0,11.440665245056152,10.507384300231934,3,3
1898,4,7.634005345440036,7.634005345440036,1.0013272372306945,1.0013272372306923,0,0,11.541824340820312,10.507384300231934,4,4
1898,8,7.4095043684988715,7.449127057431473,1.0089651699583904,1.00749322307274,1,2,11.80557918548584,10.507384300231934,7,6
1898,16,6.694838941308979,6.993462312631186,1.0238753872876565,1.0214218652541782,4,6,12.450850486755371,10.507384300231934,12,10
1898,32,6.0395029804924,6.824867309885592,1.0268621410194818,1.0317248623709747,12,20,12.909404754638672,10.507384300231934,20,12
1898,64,4.220209716779819,6.506400617427127,1.0192342574785112,1.0439831572821188,31,49,13.545599937438965,10.507384300231934,33,15
1898,128,2.4837302948257527,6.437518879390108,1.007667177604775,1.0496572117206426,62,112,14.441422462463379,10.507384300231934,66,16
1899,1,9.457301782425388,9.457301782425398,0.945206409503627,0.9452064095036298,0,0,9.59826946258545,9.59826946258545,1,1
1899,2,8.851932711001613,8.851932711001616,0.9587935241049679,0.9587935241049703,0,0,10.276688575744629,9.59826946258545,2,2
1899,3,7.772126729684055,7.7721267296840555,0.9840469146330428,0.9840469146330442,0,0,10.424842834472656,9.59826946258545,3,3
1899,4,7.084972770877687,7.084972770877687,1.000717399627673,1.0007173996276753,0,0,10.617894172668457,9.59826946258545,4,4
1899,8,7.07035326863081,7.081560253019814,1.0009613300142695,1.0010200009832975,2,2,10.896167755126953,9.59826946258545,6,6
1899,16,6.454368098653705,6.593700328712564,1.0148856747423753,1.0160428737777314,6,7,11.368151664733887,9.59826946258545,10,9
1899,32,4.960825880523474,5.605930508355076,1.0303859790853203,1.0353344196930465,13,23,12.244170188903809,9.59826946258545,19,9
1899,64,4.115051816734472,5.542407292699267,1.0233959994409103,1.037128574297463,29,49,12.868843078613281,9.59826946258545,35,15
1899,128,2.0257375540273683,5.483293299102851,1.007443452787797,1.0388680482373212,64,114,13.575096130371094,9.59826946258545,64,14
1900,1,5.653630977673845,5.653630977673849,0.980520785645524,0.980520785645527,0,0,5.685023307800293,5.685023307800293,1,1
1900,2,5.524408571044946,5.524408571044947,0.9828431273635921,0.9828431273635945,0,0,6.068502426147461,5.685023307800293,2,2
1900,3,5.520595672134895,5.520595672134897,0.98321624867272,0.9832162486727218,0,0,6.4186177253723145,5.685023307800293,3,3
1900,4,5.231932160997827,5.231932160997829,0.9884907200103361,0.9884907200103376,0,0,6.680076599121094,5.685023307800293,4,4
1900,8,4.550259628936088,4.68539764811819,0.996097090458479,0.9954050647250766,3,3,7.061151027679443,5.685023307800293,5,5
1900,16,4.4696872988981085,4.680888813531849,0.9984315561215338,0.9956319008683955,6,8,7.644858360290527,5.685023307800293,10,8
1900,32,3.9551678097999883,4.59858046072552,0.9984869226861119,0.9985020080598805,14,23,8.108489990234375,5.685023307800293,18,9
1900,64,3.05547181129512,4.474568851209001,0.994839027856841,1.0009104082279132,34,54,8.833425521850586,5.685023307800293,30,10
1900,128,2.3314919607586466,4.449989364700673,0.994934026817103,1.0031485440168617,65,116,9.637043952941895,5.685023307800293,63,12
1901,1,8.34264500406463,8.34264500406463,0.9561877133971451,0.956187713397146,0,0,8.450799942016602,8.450799942016602,1,1
1901,2,6.514839066202472,6.514839066202472,0.992542611704964,0.9925426117049645,0,0,8.651647567749023,8.450799942016602,2,2
1901,3,6.297208534326576,6.297208534326578,0.9968615186823101,0.9968615186823112,0,0,8.904204368591309,8.450799942016602,3,3
1901,4,6.029509723616037,6.0295097236160355,1.003333540656592,1.0033335406565924,0,0,9.144125938415527,8.450799942016602,4,4
1901,8,5.56181611142987,5.630721080464479,1.0104103687891413,1.010322425566834,3,3,9.491983413696289,8.450799942016602,5,5
1901,16,4.840007682983249,5.388568896216613,1.0134651433292534,1.0164539797236578,8,7,9.9481782913208,8.450799942016602,8,9
1901,32,4.241371791097997,5.326230654319938,1.0133238725013571,1.0181986276210915,15,22,10.316056251525879,8.450799942016602,17,10
1901,64,3.225345330403765,5.181704603774039,1.011641050088386,1.0243560215680472,30,46,10.780404090881348,8.450799942016602,34,18
1901,128,1.5257829260430382,5.1061400535885255,1.0041605377605802,1.0267814673235003,62,110,11.33346176147461,8.450799942016602,66,18
1902,1,6.6424690083801075,6.642469008380108,0.975956808650994,0.9759568086509961,0,0,6.681427955627441,6.681427955627441,1,1
1902,2,6.575618897927251,6.575618897927252,0.9784191259593866,0.9784191259593882,0,0,8.66185188293457,6.681427955627441,2,2
1902,3,5.953196516291121,5.953196516291118,0.9893026797054714,0.9893026797054736,0,0,9.08961009979248,6.681427955627441,3,3
1902,4,5.559064461418438,5.559717809221322,0.9997938244267915,0.9998779000401952,1,1,9.195688247680664,6.681427955627441,3,3
1902,8,5.036224392428015,5.058738355111721,1.0101191581197204,1.0099299055806452,3,3,9.450733184814453,6.681427955627441,5,5
1902,16,4.643908865842926,4.807462578965224,1.0123236628039929,1.013603006694055,5,9,9.854140281677246,6.681427955627441,11,7
1902,32,3.8529886265071753,4.561928881003048,1.0114953201809591,1.0186189293040788,13,22,10.52892780303955,6.681427955627441,19,10
1902,64,2.7605852532624042,4.510978859051728,1.0062571601459536,1.0214967770253642,28,51,11.428532600402832,6.681427955627441,36,13
1902,128,1.665136486698785,4.499242809688983,0.9976511225587239,1.0227081755352234,64,114,12.15904426574707,6.681427955627441,64,14
1903,1,10.64781575825991,10.647815758259915,0.9369619128323408,0.9369619128323428,0,0,10.816166877746582,10.816166877746582,1,1
1903,2,10.041028696091914,10.041028696091916,0.9549203402122117,0.9549203402122126,0,0,11.033492088317871,10.816166877746582,2,2
1903,3,8.376587004739768,8.37658700473977,0.9938354684504247,0.9938354684504269,0,0,11.115442276000977,10.816166877746582,3,3
1903,4,8.311479076551391,8.31147907655139,0.9954595145852356,0.9954595145852375,0,0,11.192843437194824,10.816166877746582,4,4
1903,8,6.9373777338617195,6.937377733861718,1.0242943674575078,1.0242943674575091,0,0,12.029479026794434,10.816166877746582,8,8
1903,16,6.660342681911651,6.66904445179461,1.0322072608279882,1.0318001157601064,2,3,12.557648658752441,10.816166877746582,14,13
1903,32,5.8771835184142995,6.446499321844722,1.037439912533745,1.038189504048522,10,15,13.521763801574707,10.816166877746582,22,17
1903,64,4.423934901528144,6.441169176814164,1.0274693877984218,1.0387440589839458,31,47,14.226226806640625,10.816166877746582,33,17
1903,128,2.8760155116078727,6.414666714347975,1.0167014732691082,1.0414672435555121,66,108,14.605990409851074,10.816166877746582,62,20
1904,1,4.183528115838297,4.183528115838298,0.9916214172314477,0.9916214172314486,0,0,4.191287994384766,4.191287994384766,1,1
1904,2,3.9441874811986595,3.94418748119866,0.995610849666194,0.9956108496661944,0,0,5.294532299041748,4.191287994384766,2,2
1904,3,3.891914153263644,3.891914153263644,0.9975773250345238,0.9975773250345248,0,0,6.026503086090088,4.191287994384766,3,3
1904,4,3.7936447246157194,3.7936447246157194,0.9997247029008032,0.9997247029008037,0,0,6.425327777862549,4.191287994384766,4,4
1904,8,3.059077665964279,3.1238415633357484,1.0067966455483164,1.0074220179910265,3,3,6.657958030700684,4.191287994384766,5,5
1904,16,2.6713648920455393,2.9489955844358153,1.0080375174673828,1.0097708891303117,5,8,6.952648639678955,4.191287994384766,11,8
1904,32,2.181386008246392,2.8113561220002974,1.006213891280722,1.0130667792936074,17,22,7.443057537078857,4.191287994384766,15,10
1904,64,1.620932272689454,2.73512171114384,1.0030645358359829,1.013592074289067,29,51,8.197139739990234,4.191287994384766,35,13
1904,128,0.5188414444660676,2.7062875676864153,0.9992620845644847,1.0142014538641204,61,112,8.85714054107666,4.191287994384766,67,16
1905,1,5.965753947607101,5.9657539476071015,0.983847020259762,0.9838470202597622,0,0,5.985673904418945,5.985673904418945,1,1
1905,2,4.133512429724637,4.133512429724636,1.0066523182201954,1.0066523182201963,0,0,6.723649024963379,5.985673904418945,2,2
1905,3,4.108502849919258,4.108502849919257,1.0070500887218379,1.0070500887218388,0,0,6.934844970703125,5.985673904418945,3,3
1905,4,4.081035054241622,4.081035054241621,1.0078991424872257,1.007899142487226,0,0,7.488275051116943,5.985673904418945,4,4
1905,8,3.4518095618287994,3.4600264081720735,1.0163143218955897,1.0163854740372158,1,1,7.945913791656494,5.985673904418945,7,7
1905,16,3.2509647923029084,3.394335929749683,1.0188545799871618,1.0193628455310138,3,6,8.366816520690918,5.985673904418945,13,10
1905,32,2.9238744844625195,3.344561324580106,1.0140880949185793,1.0207745927688632,13,20,8.921789169311523,5.985673904418945,19,12
1905,64,2.065160147682047,3.3167952105420517,1.0069024370164092,1.02124409824489,32,51,9.638294219970703,5.985673904418945,32,13
1905,128,0.8671363785895468,3.282145216504941,1.0012382540322378,1.0228334805751609,59,113,10.480335235595703,5.985673904418945,69,15
1906,1,5.442768859402823,5.442768859402826,0.9767187098195277,0.9767187098195298,0,0,5.487912178039551,5.487912178039551,1,1
1906,2,4.445068323646244,4.445068323646246,0.9891291090409952,0.989129109040997,0,0,5.868045806884766,5.487912178039551,2,2
1906,3,4.092809722847997,4.092809722847998,0.9938393293014586,0.9938393293014604,0,0,5.909037113189697,5.487912178039551,3,3
1906,4,4.041443735412502,4.0414437354124955,0.9948564628208171,0.994856462820819,0,0,6.15180778503418,5.487912178039551,4,4
1906,8,3.9225919901625725,3.9234079180121673,0.9985790367449816,0.9985191895647421,1,1,6.708885192871094,5.487912178039551,7,7
1906,16,3.6506236208988843,3.7966300004578706,1.003694929102982,1.002371926283756,5,7,7.550296306610107,5.487912178039551,11,9
1906,32,3.2057142530003486,3.6076105108055643,1.0044382739999729,1.0075246594044076,14,18,8.076115608215332,5.487912178039551,18,14
1906,64,2.1703831599745804,3.483333676824516,1.0050219737548505,1.0116687679707124,32,48,8.782539367675781,5.487912178039551,32,16
1906,128,1.1673707786842045,3.4796719676817953,0.9993455909672111,1.0119408334025777,64,109,9.363564491271973,5.487912178039551,64,19
1907,1,7.510297332639558,7.510297332639563,0.965125342121711,0.9651253421217131,0,0,7.581408977508545,7.581408977508545,1,1
1907,2,6.425490915397254,6.425490915397253,0.9836523916681716,0.9836523916681743,0,0,7.629662036895752,7.581408977508545,2,2
1907,3,5.879226467973252,5.879226467973251,0.9925069687711428,0.9925069687711439,0,0,8.000120162963867,7.581408977508545,3,3
1907,4,4.80376723512732,4.80376723512732,1.0063911594520598,1.00639115945206,0,0,8.033717155456543,7.581408977508545,4,4
1907,8,4.304436568851552,4.393876460742019,1.013411665711056,1.0128370294097628,1,2,8.584732055664062,7.581408977508545,7,6
1907,16,3.9167566774665423,4.212126015471122,1.0166895533129714,1.0175783917218026,5,6,9.16305923461914,7.581408977508545,11,10
1907,32,3.176837780389079,4.109025276801113,1.0156947570026191,1.0215801375332179,11,20,9.943970680236816,7.581408977508545,21,12
1907,64,2.307709594446259,4.06401839048995,1.0029965284357507,1.0242226994820782,32,48,10.602784156799316,7.581408977508545,32,16
1907,128,1.445372490899006,4.0319368741327954,1.0008023869421647,1.0260426161906884,59,111,11.539008140563965,7.581408977508545,69,17
1908,1,8.74313567718038,8.74313567718038,0.9481753535535106,0.9481753535535107,0,0,8.882417678833008,8.882417678833008,1,1
1908,2,7.198631999980607,7.198631999980606,0.9810985287542675,0.9810985287542672,0,0,9.138897895812988,8.882417678833008,2,2
1908,3,7.080907419009612,7.080907419009612,0.9846467241189585,0.9846467241189581,0,0,9.441875457763672,8.882417678833008,3,3
1908,4,6.8080531021708595,6.8080531021708595,0.9880019985579941,0.9880019985579922,0,0,9.493964195251465,8.882417678833008,4,4
1908,8,6.3931175271376866,6.400468165260754,0.998611170487591,0.998284511353493,1,1,9.950169563293457,8.882417678833008,7,7
1908,16,5.476462267052707,5.968250857912078,1.0115227761159797,1.010019801331819,6,8,10.490403175354004,8.882417678833008,10,8
1908,32,4.6137515805983575,5.772044494158612,1.012193189284667,1.0134005091556904,13,22,10.806203842163086,8.882417678833008,19,10
1908,64,2.959719803424347,5.454688575481762,1.0097638480645323,1.019749882478499,30,52,11.247207641601562,8.882417678833008,34,12
1908,128,1.6180566912126508,5.221572539753501,1.0040001967614607,1.0257856268294616,59,110,11.694681167602539,8.882417678833008,69,18
1909,1,5.462564600201939,5.462564600201925,0.9830285506069328,0.9830285506069341,0,0,5.48760986328125,5.48760986328125,1,1
1909,2,5.053011876708583,5.053011876708586,0.9878607717885057,0.9878607717885071,0,0,5.8806023597717285,5.48760986328125,2,2
1909,3,4.693603898061253,4.693603898061253,0.9926924689635186,0.9926924689635189,0,0,6.1061272621154785,5.48760986328125,3,3
1909,4,4.693589841310619,4.69358984131062,0.9926972622328034,0.9926972622328045,0,0,6.151071071624756,5.48760986328125,4,4
1909,8,3.7775473832917648,3.9363610671205884,1.000202168561746,1.0005526006447232,3,3,6.350030899047852,5.48760986328125,5,5
1909,16,3.3883334636578466,3.8139051127470416,1.003060576740384,1.0030217725292525,6,8,6.709225654602051,5.48760986328125,10,8
1909,32,2.324436431532185,3.322879700999337,1.0091353120941728,1.0103459012397389,15,24,7.162230491638184,5.48760986328125,17,8
1909,64,1.3105586643270855,3.322879700999337,1.0038841142321502,1.0103459012397389,29,56,7.5456976890563965,5.48760986328125,35,8
1909,128,0.45035512286708884,3.23947765442445,1.0005229804469602,1.0117684000110518,60,120,8.01393985748291,5.48760986328125,68,8
1910,1,8.347178475008965,8.347178475008963,0.9619841290978791,0.9619841290978798,0,0,8.424799919128418,8.424799919128418,1,1
1910,2,6.351957435285776,6.351957435285776,0.9956957824256654,0.9956957824256655,0,0,8.92226505279541,8.424799919128418,2,2
1910,3,5.6379197816870095,5.637919781687009,1.0103764562701554,1.0103764562701552,0,0,9.120208740234375,8.424799919128418,3,3
1910,4,5.592826741976927,5.637919781687009,1.0099994098475304,1.0103764562701552,1,1,9.34884262084961,8.424799919128418,3,3
1910,8,5.11323078741267,5.167429074653989,1.01761053979242,1.0180228747906797,2,2,9.953221321105957,8.424799919128418,6,6
1910,16,4.580686986437155,4.830568310348478,1.0254915150069381,1.0263293066507555,6,6,10.734424591064453,8.424799919128418,10,10
1910,32,3.9508992029603016,4.715632971480159,1.0205850204700777,1.0297499670499477,14,20,11.31829833984375,8.424799919128418,18,12
1910,64,3.431357097881714,4.688569073700094,1.0134962841478576,1.0319632016215483,30,48,11.881335258483887,8.424799919128418,34,16
1910,128,1.9059749535774104,4.550202210230328,1.0034929990236345,1.0358543712623074,65,112,12.407892227172852,8.424799919128418,63,16
1911,1,10.93032198552787,10.930321985527877,0.9317272576580045,0.9317272576580068,0,0,11.1207914352417,11.1207914352417,1,1
1911,2,10.196017074195057,10.19601707419506,0.9506167888479853,0.9506167888479871,0,0,11.323675155639648,11.1207914352417,2,2
1911,3,9.415802195580929,9.415802195580929,0.9710456889199872,0.971045688919989,0,0,11.590750694274902,11.1207914352417,3,3
1911,4,9.394789774587796,9.394789774587798,0.972651568780025,0.9726515687800266,0,0,11.788477897644043,11.1207914352417,4,4
1911,8,8.069036783227636,8.069036783227634,1.0037975227995213,1.0037975227995228,0,0,12.129899024963379,11.1207914352417,8,8
1911,16,7.675540063261487,7.757374688032141,1.0179481509660822,1.0164335336314312,3,5,13.005722999572754,11.1207914352417,13,11
1911,32,6.702913070610557,7.387272730956522,1.0310737229455087,1.0278956048877723,14,20,13.477837562561035,11.1207914352417,18,12
1911,64,4.671584551043835,6.877774567112365,1.0224131104234044,1.0423198759469987,28,48,14.045501708984375,11.1207914352417,36,16
1911,128,2.7857227771186586,6.849918181101507,1.0029451859401513,1.0456677701742045,62,110,14.648475646972656,11.1207914352417,66,18
1912,1,8.763181543383759,8.763181543383762,0.9523480249429938,0.952348024942995,0,0,8.87972354888916,8.87972354888916,1,1
1912,2,6.384815345801715,6.384815345801714,0.99890800689733,0.9989080068973311,0,0,9.327378273010254,8.87972354888916,2,2
1912,3,5.624728564058209,5.624728564058207,1.0139203129247747,1.0139203129247765,0,0,9.74356746673584,8.87972354888916,3,3
1912,4,5.601179483322209,5.601179483322209,1.014255366413035,1.0142553664130354,0,0,9.756368637084961,8.87972354888916,4,4
1912,8,5.389185517975832,5.5077275864253386,1.017086347771158,1.0160236028800105,2,2,9.89327621459961,8.87972354888916,6,6
1912,16,5.299607856618563,5.496391878168501,1.0172512955658544,1.0164312829183848,6,7,10.686429977416992,8.87972354888916,10,9
1912,32,4.904078235861809,5.485222980660626,1.0141017732886206,1.0172731662705954,14,21,11.18442440032959,8.87972354888916,18,11
1912,64,3.7711647718816197,5.475119364405886,1.0087540529775967,1.0182619649092608,33,51,11.932750701904297,8.87972354888916,31,13
1912,128,1.9446478019503242,5.440415291305861,1.0015593868279666,1.0209795175456242,65,113,12.726669311523438,8.87972354888916,63,15
1913,1,8.878731645478862,8.87873164547886,0.9479355443128262,0.9479355443128259,0,0,9.018708229064941,9.018708229064941,1,1
1913,2,7.335261580024145,7.335261580024145,0.9792828025925837,0.9792828025925839,0,0,9.188491821289062,9.018708229064941,2,2
1913,3,6.864941048562136,6.864941048562133,0.9903262033936191,0.9903262033936182,0,0,9.261578559875488,9.018708229064941,3,3
1913,4,6.13870050147424,6.13870050147424,1.0042838551950206,1.0042838551950204,0,0,9.354225158691406,9.018708229064941,4,4
1913,8,6.038329663633037,6.076272671089831,1.005800061780168,1.0050945728245677,2,2,9.723274230957031,9.018708229064941,6,6
1913,16,5.814891927516378,5.975209689532094,1.0098112726377884,1.0087341986802545,7,8,10.225099563598633,9.018708229064941,9,8
1913,32,5.0296448866988355,5.895201041096392,1.0121506134106095,1.0127427724470692,15,19,10.908045768737793,9.018708229064941,17,13
1913,64,3.5707625150821065,5.695679305983738,1.0123266199169358,1.0184843303431872,28,49,11.473997116088867,9.018708229064941,36,15
1913,128,1.8163864876699862,5.505544479855117,1.0029982523035943,1.0267026898505105,64,111,12.195432662963867,9.018708229064941,64,17
1914,1,10.081445302345687,10.081445302345687,0.9401494565496199,0.9401494565496198,0,0,10.236469268798828,10.236469268798828,1,1
1914,2,7.889444281778981,7.88944428177898,0.9849743283340567,0.9849743283340548,0,0,10.518657684326172,10.236469268798828,2,2
1914,3,7.087280450764152,7.087280450764153,1.0063717902784184,1.0063717902784168,0,0,10.96314811706543,10.236469268798828,3,3
1914,4,6.872212473049795,6.872212473049797,1.0118279673689985,1.0118279673689963,0,0,10.990090370178223,10.236469268798828,4,4
1914,8,6.516852217479208,6.750445995237797,1.0177122705131922,1.0155004547703381,1,2,11.195561408996582,10.236469268798828,7,6
1914,16,5.6958456423956285,6.003874422943027,1.0329363050284686,1.0331907732277734,3,7,11.711392402648926,10.236469268798828,13,9
1914,32,5.038634737514578,5.8243448639284185,1.0379533172398,1.0384593909661042,15,22,12.350186347961426,10.236469268798828,17,10
1914,64,3.8943417179973854,5.737327881131844,1.024266634991063,1.0427544511035485,33,49,12.85838508605957,10.236469268798828,31,15
1914,128,2.4679918318850107,5.614650389630262,1.012271763147666,1.0466859625179787,54,112,13.426168441772461,10.236469268798828,74,16
1915,1,8.763771099586592,8.763771099586595,0.9562978926004263,0.9562978926004287,0,0,8.861746788024902,8.861746788024902,1,1
1915,2,7.3153039397687065,7.315303939768707,0.9803858547296178,0.9803858547296187,0,0,9.020126342773438,8.861746788024902,2,2
1915,3,6.811777645935817,6.811777645935817,0.9933362676782913,0.9933362676782925,0,0,9.582799911499023,8.861746788024902,3,3
1915,4,6.74390088057968,6.743900880579681,0.9949372817497129,0.9949372817497135,0,0,9.88724136352539,8.861746788024902,4,4
1915,8,6.187365150539716,6.290675592343246,1.0082624011454817,1.0070550092239723,2,2,10.773337364196777,8.861746788024902,6,6
1915,16,5.96858853007684,6.267180155459862,1.0079558501310117,1.008908896091003,6,8,11.017858505249023,8.861746788024902,10,8
1915,32,4.0875913519478475,5.884122093362593,1.0158506573420563,1.02331698542253,13,22,11.87392807006836,8.861746788024902,19,10
1915,64,3.280249854354541,5.480914629618119,1.0106674645123266,1.0344479258257087,30,49,12.42813777923584,8.861746788024902,34,15
1915,128,1.7511667604975019,5.397673911123833,1.002577813870891,1.0403392021829037,67,111,13.338128089904785,8.861746788024902,61,17
1916,1,5.714877609944144,5.7148776099441445,0.9890147880352026,0.9890147880352046,0,0,5.7246503829956055,5.7246503829956055,1,1
1916,2,5.085314691519922,5.085314691519921,1.0013706441834742,1.0013706441834758,0,0,7.0746684074401855,5.7246503829956055,2,2
1916,3,4.485086621204961,4.48508662120496,1.009921098632936,1.009921098632937,0,0,7.311974048614502,5.7246503829956055,3,3
1916,4,4.484750384969631,4.48508662120496,1.009931727223743,1.009921098632937,1,1,7.345583915710449,5.7246503829956055,3,3
1916,8,4.236033212744285,4.246552293834634,1.015334137538904,1.0150453103303354,1,1,8.084222793579102,5.7246503829956055,7,7
1916,16,3.848265056407921,4.025298917549863,1.0197543668044504,1.019236350307214,5,7,8.53027629852295,5.7246503829956055,11,9
1916,32,3.3196867043030838,3.898496513399308,1.0140234282043927,1.021477600207406,16,20,9.082962989807129,5.7246503829956055,16,12
1916,64,2.349133865477644,3.888098366501516,1.0070721199036838,1.022165371419295,31,49,9.736220359802246,5.7246503829956055,33,15
1916,128,1.015863671490716,3.886971235102597,1.0017046258455458,1.0223658120532404,67,112,10.390671730041504,5.7246503829956055,61,16
1917,1,8.973483167162568,8.973483167162572,0.95947750339214,0.9594775033921429,0,0,9.054567337036133,9.054567337036133,1,1
1917,2,8.074054095294498,8.074054095294503,0.9779029378765101,0.9779029378765127,0,0,10.053767204284668,9.054567337036133,2,2
1917,3,8.063617660103374,8.063617660103375,0.9798902089608514,0.979890208960854,0,0,11.776467323303223,9.054567337036133,3,3
1917,4,7.921480188324668,7.92354464915943,0.9853899972321006,0.9859564726528789,1,1,11.793267250061035,9.054567337036133,3,3
1917,8,7.05707015689052,7.139137905848345,1.0088210004743323,1.0103417771510288,3,3,11.973169326782227,9.054567337036133,5,5
1917,16,6.378580794042751,6.621031230502321,1.0261974969593561,1.0306765058357197,7,8,12.748002052307129,9.054567337036133,9,8
1917,32,5.257832495939944,6.258319567402006,1.030508235812519,1.0407438928327901,14,21,13.322046279907227,9.054567337036133,18,11
1917,64,3.8418532629842566,6.072905017926044,1.0234390575214867,1.0465399523425911,32,50,13.887134552001953,9.054567337036133,32,14
1917,128,2.566907504486872,6.000780904070779,1.009135357033375,1.0524624924506716,64,113,14.655244827270508,9.054567337036133,64,15
1918,1,6.901472520822597,6.901472520822601,0.9758778203809012,0.9758778203809046,0,0,6.938873291015625,6.938873291015625,1,1
1918,2,4.733646778138164,4.733646778138162,1.0049470749911118,1.0049470749911142,0,0,7.216897010803223,6.938873291015625,2,2
1918,3,4.334674747432458,4.334674747432455,1.010017489544633,1.010017489544635,0,0,7.322593688964844,6.938873291015625,3,3
1918,4,4.258973678810969,4.2589736788109676,1.0111620495894498,1.0111620495894513,0,0,7.405180931091309,6.938873291015625,4,4
1918,8,3.9757116207127283,3.9757116207127337,1.017082185292522,1.0170821852925274,0,0,8.739009857177734,6.938873291015625,8,8
1918,16,3.7150069410393938,3.77836294602827,1.0190092884336899,1.021432222982913,5,6,9.363936424255371,6.938873291015625,11,10
1918,32,3.229177341717848,3.7390581048903924,1.0137368619695541,1.0237686141032962,14,20,10.313102722167969,6.938873291015625,18,12
1918,64,2.4055024371297726,3.7020761937458717,1.0068241600279282,1.0257927131808677,30,49,11.337268829345703,6.938873291015625,34,15
1918,128,1.5414709063541772,3.6822994114067873,1.00226784495907,1.0280711454897455,61,111,12.210719108581543,6.938873291015625,67,17
1919,1,4.286530059886194,4.286530059886195,0.9937778925383222,0.9937778925383237,0,0,4.290686130523682,4.290686130523682,1,1
1919,2,3.1462872743360597,3.1462872743360597,1.0006068966102362,1.000606896610237,0,0,4.722818374633789,4.290686130523682,2,2
1919,3,2.6993315544977645,2.699331554497764,1.0031523923769257,1.0031523923769263,0,0,4.729280948638916,4.290686130523682,3,3
1919,4,2.4868569550123176,2.4868569550123176,1.0038289764512918,1.0038289764512922,0,0,4.907326698303223,4.290686130523682,4,4
1919,8,2.06615189676167,2.124325991514605,1.0066879448406691,1.006929741739453,1,1,5.1250715255737305,4.290686130523682,7,7
1919,16,2.0044347794654143,2.0841445671400813,1.0065153221211216,1.0071837696351005,5,6,6.00227689743042,4.290686130523682,11,10
1919,32,1.5709031810826073,1.9392216274229859,1.0059200941315973,1.0103653934007841,12,20,6.6987996101379395,4.290686130523682,20,12
1919,64,1.1954403612983853,1.9333200853469696,1.0031130609810983,1.0108378775310736,30,48,7.2826738357543945,4.290686130523682,34,16
1919,128,0.6400457807612363,1.9331010779910756,1.000642727069629,1.0109210804645645,60,112,8.198640823364258,4.290686130523682,68,16
1920,1,6.614925540205661,6.614925540205663,0.9713914324653585,0.9713914324653593,0,0,6.671457767486572,6.671457767486572,1,1
1920,2,6.444602260519558,6.444602260519558,0.9754380523597971,0.9754380523597974,0,0,7.712323188781738,6.671457767486572,2,2
1920,3,5.605494405032733,5.605494405032732,0.9928406039735136,0.9928406039735118,0,0,7.896341800689697,6.671457767486572,3,3
1920,4,5.3657000226579035,5.365700022657903,0.996123767341443,0.9961237673414414,0,0,8.266034126281738,6.671457767486572,4,4
1920,8,4.857372714482675,4.857614987198918,1.0101697003190306,1.0102709880224436,1,1,8.684679985046387,6.671457767486572,7,7
1920,16,4.3593738021237485,4.792292643129986,1.0121386659138656,1.0122185125878636,4,7,9.113130569458008,6.671457767486572,12,9
1920,32,3.8606582721389913,4.66057420789342,1.0142497788729605,1.0170599856064568,13,21,9.630989074707031,6.671457767486572,19,11
1920,64,2.458117878232091,4.591508633508229,1.0043307165372564,1.0211218691355044,38,50,10.310784339904785,6.671457767486572,26,14
1920,128,1.4264733434555092,4.536594113861607,1.0016515050084411,1.0223468905762123,66,110,10.871537208557129,6.671457767486572,62,18
1921,1,7.386484517366154,7.386484517366122,0.9697350357986592,0.9697350357986616,0,0,7.440436363220215,7.440436363220215,1,1
1921,2,6.648946058575739,6.648946058575739,0.9815099472430927,0.9815099472430941,0,0,7.970267295837402,7.440436363220215,2,2
1921,3,5.907024861633072,5.907024861633071,0.9957040340453127,0.9957040340453136,0,0,8.265932083129883,7.440436363220215,3,3
1921,4,4.918569744700438,4.918569744700438,1.0149218998480605,1.0149218998480616,0,0,9.16646671295166,7.440436363220215,4,4
1921,8,4.224882211457946,4.318468217786339,1.0252030371243264,1.0258806794318063,2,2,10.49567699432373,7.440436363220215,6,6
1921,16,3.9312353336658488,4.193584029858599,1.024504844584945,1.0278387986373545,7,9,11.090678215026855,7.440436363220215,9,7
1921,32,3.6300895276767813,4.186920911936509,1.0248531972857948,1.0288801482526266,17,22,11.613382339477539,7.440436363220215,15,10
1921,64,2.6125451095035106,4.056829289621271,1.0107011600055644,1.03519278773719,31,53,12.581686973571777,7.440436363220215,33,11
1921,128,1.7561756078508157,4.000290241267507,1.000597215054401,1.0391346942071984,65,113,13.7426176071167,7.440436363220215,63,15
1922,1,2.1841636895890555,2.184163689589056,0.9976764362184208,0.9976764362184214,0,0,2.185347080230713,2.185347080230713,1,1
1922,2,1.9129084809835395,1.9129084809835397,0.9992919078159017,0.9992919078159022,0,0,2.3215057849884033,2.185347080230713,2,2
1922,3,1.7278439662337561,1.7278439662337568,1.0003919306922056,1.000391930692206,0,0,2.9115166664123535,2.185347080230713,3,3
1922,4,1.694511872511442,1.694511872511442,1.00091447723937,1.0009144772393703,0,0,3.057313919067383,2.185347080230713,4,4
1922,8,1.5276541253518765,1.6655711576318133,1.0000861910396315,1.001050735609867,3,3,3.2553210258483887,2.185347080230713,5,5
1922,16,1.0629694401875307,1.350770669588696,1.001143705991769,1.0027241560406752,7,9,3.5928878784179688,2.185347080230713,9,7
1922,32,0.7240414125665731,1.3306887504551137,1.0016383673917595,1.0030213264505319,17,23,3.925647258758545,2.185347080230713,15,9
1922,64,0.40863957696303616,1.2509684043837572,1.0001946287491974,1.003983326495327,27,53,4.323812961578369,2.185347080230713,37,11
1922,128,0.04326408835637516,1.1809348396662915,0.9999905459137984,1.0043841098901551,61,118,4.832432270050049,2.185347080230713,67,10
1923,1,9.918115393138029,9.918115393138034,0.9302000687443193,0.930200068744321,0,0,10.132732391357422,10.132732391357422,1,1
1923,2,8.110953012306794,8.110953012306796,0.9734947568688932,0.9734947568688934,0,0,10.442049026489258,10.132732391357422,2,2
1923,3,8.021534668367655,8.021534668367655,0.9767543072002207,0.9767543072002208,0,0,10.974997520446777,10.132732391357422,3,3
1923,4,8.020945493901975,8.021534668367655,0.9766442564325649,0.9767543072002208,1,1,11.478224754333496,10.132732391357422,3,3
1923,8,7.2211751773077895,7.286559128422255,0.996721194319396,0.9977589562251159,3,4,11.78016471862793,10.132732391357422,5,4
1923,16,6.300496821297281,6.675419054719936,1.0200361146071466,1.0156021425475754,5,7,12.099125862121582,10.132732391357422,11,9
1923,32,5.721795383258464,6.4547038794752565,1.0302199972177966,1.021513023515313,13,21,12.690116882324219,10.132732391357422,19,11
1923,64,4.275280140362206,6.381045518259622,1.0207554179108975,1.0252733378150016,25,52,13.308085441589355,10.132732391357422,39,12
1923,128,2.7266896730073915,6.2560712793197535,1.0142547805932678,1.0316544789280175,59,114,14.190376281738281,10.132732391357422,69,14
1924,1,9.944021938771897,9.944021938771895,0.9409859701935045,0.9409859701935044,0,0,10.102499961853027,10.102499961853027,1,1
1924,2,9.30318568438795,9.303185684387946,0.954032887267679,0.954032887267678,0,0,10.26912784576416,10.102499961853027,2,2
1924,3,8.95016891782299,8.950168917822989,0.9611892998728053,0.9611892998728044,0,0,10.33714771270752,10.102499961853027,3,3
1924,4,8.410355261469812,8.410355261469812,0.9774804251237486,0.9774804251237481,0,0,10.64806842803955,10.102499961853027,4,4
1924,8,7.548679989250482,7.55334143797437,0.9956749024944639,0.9954751917906824,1,1,10.770854949951172,10.102499961853027,7,7
1924,16,6.83937794777853,7.089233033351491,1.0042696393491402,1.0076997032383426,4,5,11.411718368530273,10.102499961853027,12,11
1924,32,6.20435303455789,6.853589563582747,1.006326209463329,1.0135868915078108,14,20,11.810868263244629,10.102499961853027,18,12
1924,64,5.071256798662841,6.719113660699895,1.0065844375203696,1.0188502020538746,31,50,12.29912281036377,10.102499961853027,33,14
1924,128,3.0203259094644204,6.699913758250265,0.9937052950108396,1.0204708704759922,64,110,12.898699760437012,10.102499961853027,64,18
1925,1,5.02091901153837,5.02091901153837,0.9798993521336837,0.9798993521336836,0,0,5.058233261108398,5.058233261108398,1,1
1925,2,4.35528908377427,4.355289083774269,0.9908311340573466,0.990831134057346,0,0,5.853781700134277,5.058233261108398,2,2
1925,3,4.2211715157466365,4.2211715157466365,0.9942049585209372,0.9942049585209367,0,0,6.24749755859375,5.058233261108398,3,3
1925,4,4.0321995676979006,4.0321995676979006,0.9972567067029037,0.9972567067029025,0,0,6.331742763519287,5.058233261108398,4,4
1925,8,3.7597825538770846,3.7968741646180386,1.0005116520603183,1.000715668331698,1,1,6.608887672424316,5.058233261108398,7,7
1925,16,3.072924430546413,3.261426534788473,1.0055415688757654,1.0061890296424654,5,5,6.892171382904053,5.058233261108398,11,11
1925,32,2.8007299713977525,3.1741217007575693,1.0054644587546,1.0076090734241334,14,15,7.309467315673828,5.058233261108398,18,17
1925,64,2.1150752703433753,3.0609171905528942,1.0047189725662804,1.010723955066066,26,47,7.963728427886963,5.058233261108398,38,17
1925,128,1.0333544005773296,2.9972674386110287,1.001758094729624,1.0118779577231882,66,112,8.712227821350098,5.058233261108398,62,16
1926,1,10.443650748476717,10.443650748476715,0.9254826038681837,0.9254826038681832,0,0,10.67853832244873,10.67853832244873,1,1
1926,2,8.974982293163832,8.974982293163832,0.9697801681791245,0.969780168179124,0,0,11.444317817687988,10.67853832244873,2,2
1926,3,8.670201076677055,8.670201076677055,0.9794835538650202,0.9794835538650197,0,0,11.790777206420898,10.67853832244873,3,3
1926,4,8.0029610944821,8.0029610944821,0.9971902095364777,0.997190209536476,0,0,11.935699462890625,10.67853832244873,4,4
1926,8,7.495063795248131,7.531493764048188,1.0138049096382835,1.012346415062369,1,1,12.3694429397583,10.67853832244873,7,7
1926,16,6.304115631448816,6.545725246906145,1.035683502279405,1.0342421453096955,8,8,13.21667766571045,10.67853832244873,8,8
1926,32,5.569149885692835,6.401491693672956,1.0345063017394749,1.039478231599457,12,20,13.755340576171875,10.67853832244873,20,12
1926,64,4.60023518692721,6.372969597933084,1.0282873925814824,1.041223599029906,30,50,14.551074981689453,10.67853832244873,34,14
1926,128,2.8640509781088914,6.292182709367907,1.015514936857845,1.0495911358955428,53,106,15.122392654418945,10.67853832244873,75,22
1927,1,6.90848725632787,6.908487256327877,0.970800324892428,0.9708003248924305,0,0,6.965631484985352,6.965631484985352,1,1
1927,2,4.954513930460079,4.954513930460078,1.0048488204724348,1.0048488204724366,0,0,7.743154048919678,6.965631484985352,2,2
1927,3,4.466945059660577,4.466945059660576,1.0121472197172787,1.0121472197172798,0,0,7.9946794509887695,6.965631484985352,3,3
1927,4,4.104578148179011,4.104578148179007,1.015998084251545,1.0159980842515475,0,0,8.41952133178711,6.965631484985352,4,4
1927,8,3.728684704564671,3.728689551589938,1.0208967631212427,1.020909328618748,1,1,8.821693420410156,6.965631484985352,7,7
1927,16,3.4869292412148694,3.671175676092467,1.0218166352231322,1.0233436788968855,6,6,9.54321002960205,6.965631484985352,10,10
1927,32,3.043780519150805,3.5706180712537905,1.0201558796582013,1.0268715502688892,15,18,10.312115669250488,6.965631484985352,17,14
1927,64,2.357286209704739,3.549844307012808,1.0089797253472703,1.0276692531226046,29,50,10.927459716796875,6.965631484985352,35,14
1927,128,1.439833164287128,3.549723933017923,1.0041705564617485,1.0277956978194072,65,112,11.837666511535645,6.965631484985352,63,16
1928,1,9.75155839892548,9.751558398925484,0.9367806808254839,0.9367806808254853,0,0,9.933917045593262,9.933917045593262,1,1
1928,2,8.544256966573789,8.544256966573789,0.9678027796216889,0.967802779621689,0,0,10.06861400604248,9.933917045593262,2,2
1928,3,7.955880414242567,7.955880414242567,0.9837056680688465,0.9837056680688455,0,0,10.308088302612305,9.933917045593262,3,3
1928,4,7.953482400283763,7.955880414242567,0.9836555927746614,0.9837056680688455,1,1,10.325129508972168,9.933917045593262,3,3
1928,8,6.549108640071602,6.572163576552288,1.0129527486128964,1.012763926436041,1,2,10.917234420776367,9.933917045593262,7,6
1928,16,6.294241545313954,6.3904612272871,1.0183116148824387,1.0176414678958252,5,7,11.226972579956055,9.933917045593262,11,9
1928,32,5.674586711391731,6.1739172912984515,1.0229495533521928,1.0236159911978637,11,19,11.799066543579102,9.933917045593262,21,13
1928,64,3.8049960462020693,5.936165124766983,1.0158013927543394,1.0326992724840478,32,49,12.451589584350586,9.933917045593262,32,15
1928,128,2.122110330988109,5.9014232330396075,1.0050000198482274,1.0350232167140354,69,111,13.032808303833008,9.933917045593262,59,17
1929,1,7.512446570442028,7.512446570442031,0.9722164063915505,0.972216406391552,0,0,7.559574604034424,7.559574604034424,1,1
1929,2,6.744127071763761,6.744127071763762,0.9839514813911844,0.9839514813911849,0,0,7.584202289581299,7.559574604034424,2,2
1929,3,6.441390037338646,6.441390037338647,0.9889515765358939,0.9889515765358945,0,0,7.929187297821045,7.559574604034424,3,3
1929,4,6.120122284577865,6.120122284577865,0.9962550387997497,0.9962550387997513,0,0,8.068114280700684,7.559574604034424,4,4
1929,8,5.796099892131081,5.80104653259982,1.0027937037729302,1.0026498364188057,1,1,8.246248245239258,7.559574604034424,7,7
1929,16,4.490510907592025,4.751271768241776,1.02148173273993,1.0203356825493515,6,9,8.911453247070312,7.559574604034424,10,7
1929,32,3.7116177660702587,4.5212586846775045,1.0187848445656627,1.0248145989094004,13,19,9.210850715637207,7.559574604034424,19,13
1929,64,2.408244907625088,4.402056844118657,1.0094788904769678,1.0284720726222445,29,49,9.669434547424316,7.559574604034424,35,15
1929,128,1.323125343904232,4.281898000402745,1.0034227873343116,1.032295069198243,65,110,10.328968048095703,7.559574604034424,63,18
1930,1,12.096033584929273,12.096033584929284,0.8977902295241925,0.897790229524195,0,0,12.482650756835938,12.482650756835938,1,1
1930,2,11.167390558720413,11.167390558720411,0.926626819265993,0.9266268192659941,0,0,13.006893157958984,12.482650756835938,2,2
1930,3,9.522751626655943,9.522751626655948,0.974782778934945,0.9747827789349486,0,0,13.031414031982422,12.482650756835938,3,3
1930,4,9.060818733933084,9.060818733933086,0.9862632473793156,0.9862632473793186,0,0,13.125524520874023,12.482650756835938,4,4
1930,8,8.46072298709781,8.460722987097808,1.004724955017447,1.0047249550174502,0,0,13.646757125854492,12.482650756835938,8,8
1930,16,8.101945358817543,8.230995221753103,1.0127705610277333,1.0145339438556586,4,6,14.082130432128906,12.482650756835938,12,10
1930,32,7.2139199712803,7.756469646391963,1.0360856946535186,1.0349670142858902,9,15,14.640634536743164,12.482650756835938,23,17
1930,64,5.366143458446484,7.6374033824698575,1.0280275819666953,1.0421756251229333,29,44,15.207642555236816,12.482650756835938,35,20
1930,128,3.433809349931734,7.558714151710634,1.0163470514361417,1.0463105326236395,66,103,15.769015312194824,12.482650756835938,62,25
1931,1,9.294291278026794,9.294291278026797,0.9562347099060622,0.9562347099060627,0,0,9.386737823486328,9.386737823486328,1,1
1931,2,8.078161880694326,8.078161880694328,0.9795413898291081,0.9795413898291077,0,0,9.765180587768555,9.386737823486328,2,2
1931,3,7.33975251712434,7.339752517124339,0.994733870278733,0.9947338702787325,0,0,9.863081932067871,9.386737823486328,3,3
1931,4,7.097320919320735,7.097320919320735,0.9994255489165013,0.9994255489165006,0,0,9.992644309997559,9.386737823486328,4,4
1931,8,6.480238849642471,6.48023929934132,1.0147206040273755,1.014716617563984,1,1,10.40334701538086,9.386737823486328,7,7
1931,16,5.768750721955269,5.90974964437881,1.0306851386475495,1.0319976365114631,2,5,10.817387580871582,9.386737823486328,14,11
1931,32,5.001201765116608,5.599337459483427,1.0338875880519154,1.038259986716889,14,22,11.277332305908203,9.386737823486328,18,10
1931,64,3.7976039647665236,5.577647705123438,1.0221191612647562,1.040178239443331,33,50,11.792807579040527,9.386737823486328,31,14
1931,128,2.294140662473,5.40458993381373,1.011919543952748,1.047543071377459,68,110,12.326386451721191,9.386737823486328,60,18
1932,1,8.218307325480028,8.21830732548003,0.9524056316940828,0.9524056316940832,0,0,8.343718528747559,8.343718528747559,1,1
1932,2,6.0725279814887045,6.0725279814887045,0.9953626471910817,0.9953626471910821,0,0,9.052339553833008,8.343718528747559,2,2
1932,3,5.0100948921948785,5.010094892194878,1.012048709010888,1.0120487090108887,0,0,9.255255699157715,8.343718528747559,3,3
1932,4,4.993396759347509,4.993396759347507,1.0127903596801746,1.012790359680176,0,0,10.354266166687012,8.343718528747559,4,4
1932,8,4.884324467852989,4.8880813113020345,1.0172020373050263,1.0177414628446404,1,1,11.377396583557129,8.343718528747559,7,7
1932,16,4.559811081550051,4.701746776484286,1.0201901758980279,1.0239519553158685,6,7,11.867329597473145,8.343718528747559,10,9
1932,32,4.307612314852931,4.664311304150537,1.0194702348308808,1.024984631561617,14,21,12.539971351623535,8.343718528747559,18,11
1932,64,3.254213587647785,4.4932724398789565,1.009097814460296,1.0308580096720374,30,53,13.393091201782227,8.343718528747559,34,11
1932,128,1.7793978522222036,4.455184689623417,0.999777585504845,1.0345694955909486,57,115,14.098536491394043,8.343718528747559,71,13
1933,1,7.826237131781616,7.826237131781617,0.9639534588536431,0.9639534588536437,0,0,7.900760173797607,7.900760173797607,1,1
1933,2,6.576492738374047,6.576492738374047,0.9811643403385224,0.9811643403385228,0,0,7.960311412811279,7.900760173797607,2,2
1933,3,5.669821038190079,5.669821038190079,0.9928950641593135,0.9928950641593135,0,0,8.021700859069824,7.900760173797607,3,3
1933,4,5.666621723595593,5.669821038190079,0.9927754632189929,0.9928950641593135,1,1,8.868006706237793,7.900760173797607,3,3
1933,8,5.4589380304363955,5.669821038190079,0.9923132243079427,0.9928950641593135,4,5,9.25201416015625,7.900760173797607,4,3
1933,16,5.353735531043365,5.637857334409339,0.9939259026366714,0.994162564227876,7,11,10.061708450317383,7.900760173797607,9,5
1933,32,4.908657435005366,5.59670071987672,1.0007268966925558,0.9969696953451072,16,25,10.39682674407959,7.900760173797607,16,7
1933,64,3.59928451406051,5.265495638766731,1.0060815853886749,1.008729852443271,35,56,10.868412971496582,7.900760173797607,29,8
1933,128,1.565430496415028,5.197215932175991,1.0023569169206865,1.01278600286789,62,117,11.504959106445312,7.900760173797607,66,11
1934,1,2.31748384068234,2.31748384068234,0.9963901926281273,0.9963901926281273,0,0,2.3201990127563477,2.3201990127563477,1,1
1934,2,2.159942950715201,2.1599429507152004,0.9986602669557337,0.9986602669557332,0,0,2.9487504959106445,2.3201990127563477,2,2
1934,3,2.1599330592781163,2.1599429507152004,0.9986544640922352,0.9986602669557332,1,1,2.9801716804504395,2.3201990127563477,2,2
1934,4,2.1447291665566857,2.1468961835736535,0.9988803442880143,0.9989303928968835,1,1,3.245788097381592,2.3201990127563477,3,3
1934,8,1.6200039862120834,1.623668950292316,1.004465674920937,1.0043943826544517,1,1,3.3804943561553955,2.3201990127563477,7,7
1934,16,1.4617878213756317,1.5395055792309156,1.0049417147468116,1.0048404541357656,7,7,3.9063985347747803,2.3201990127563477,9,9
1934,32,0.9784927393646008,1.4100758103327462,1.0026018679433553,1.005994317627298,12,22,4.208003044128418,2.3201990127563477,20,10
1934,64,0.4637236192008595,1.3936564899961144,1.0004445131978474,1.00618658738711,32,49,4.612283706665039,2.3201990127563477,32,15
1934,128,0.031223357185393347,1.3936564899961141,1.0000186954597705,1.00618658738711,65,113,5.2378153800964355,2.3201990127563477,63,15
1935,1,5.626542446703938,5.626542446703934,0.98466582630758,0.9846658263075809,0,0,5.645955562591553,5.645955562591553,1,1
1935,2,3.927160319862908,3.927160319862908,1.004219658826783,1.0042196588267835,0,0,5.776312351226807,5.645955562591553,2,2
1935,3,3.397103812882898,3.3971038128828988,1.0099887278948976,1.0099887278948971,0,0,5.844714641571045,5.645955562591553,3,3
1935,4,3.1753701315306735,3.175370131530673,1.011545845876781,1.011545845876781,0,0,6.040631294250488,5.645955562591553,4,4
1935,8,3.0202086464944125,3.020208646494412,1.0131007593536734,1.0131007593536736,0,0,6.332614898681641,5.645955562591553,8,8
1935,16,2.6746636875035508,2.7629210277352656,1.016174375081996,1.015709737018836,5,5,6.7477803230285645,5.645955562591553,11,11
1935,32,2.239478549923082,2.5494708345354975,1.013523611668929,1.018130974257458,13,19,7.3501811027526855,5.645955562591553,19,13
1935,64,1.592831476784639,2.530686889659575,1.0070243931654563,1.01849930576013,26,49,7.913271903991699,5.645955562591553,38,15
1935,128,0.8670454498834758,2.5306868896595747,1.0011814458936024,1.0184993057601301,61,113,8.547623634338379,5.645955562591553,67,15
1936,1,9.381391082220905,9.38139108222091,0.9432678892686646,0.9432678892686664,0,0,9.535918235778809,9.535918235778809,1,1
1936,2,8.13156139791462,8.131561397914618,0.973977259339722,0.9739772593397236,0,0,10.654464721679688,9.535918235778809,2,2
1936,3,7.3707830113116595,7.37078301131166,0.9948661079817073,0.994866107981708,0,0,11.186604499816895,9.535918235778809,3,3
1936,4,7.158556476204242,7.158556476204244,1.0025521334873624,1.0025521334873628,0,0,11.39928913116455,9.535918235778809,4,4
1936,8,6.1072823046419575,6.146459492285861,1.0307013668434084,1.0302677519145234,1,1,12.013677597045898,9.535918235778809,7,7
1936,16,5.496625706376653,5.8535799195118745,1.0362298069753042,1.0376770298149616,4,5,12.47652530670166,9.535918235778809,12,11
1936,32,5.119219530466016,5.758926018024542,1.0358570809355978,1.0425386917153312,14,18,13.443044662475586,9.535918235778809,18,14
1936,64,4.090398006701322,5.723160013334507,1.0207269313791234,1.046382490338136,28,47,14.206023216247559,9.535918235778809,36,17
1936,128,2.715634124129995,5.707496135414924,1.0032172329206288,1.0478864958388652,65,109,15.217166900634766,9.535918235778809,63,19
1937,1,6.230974459038771,6.230974459038771,0.9809923049182326,0.9809923049182336,0,0,6.257488250732422,6.257488250732422,1,1
1937,2,5.524107230366532,5.524107230366531,0.9889503834693287,0.9889503834693292,0,0,6.3703227043151855,6.257488250732422,2,2
1937,3,4.699381963169171,4.699381963169171,0.9994568624065308,0.9994568624065319,0,0,6.415205001831055,6.257488250732422,3,3
1937,4,4.415436184451141,4.41543618445114,1.0032692211919145,1.0032692211919159,0,0,6.734710216522217,6.257488250732422,4,4
1937,8,3.7971739420945765,3.7971739420945756,1.0094558911564642,1.0094558911564644,0,0,7.250845909118652,6.257488250732422,8,8
1937,16,3.3296524155937113,3.6891300854477573,1.0097063270825424,1.0122914856718266,4,3,8.02899169921875,6.257488250732422,12,13
1937,32,2.759808947994228,3.6086836818221615,1.006320821918974,1.0148791553023409,16,18,8.561783790588379,6.257488250732422,16,14
1937,64,2.2202142057721233,3.57538676170979,1.0035744819800991,1.0180675613311252,31,44,9.204102516174316,6.257488250732422,33,20
1937,128,0.9447818818220127,3.5475097030376364,1.0003280085836037,1.0198938522797718,64,106,10.067167282104492,6.257488250732422,64,22
1938,1,10.571606216807275,10.57160621680728,0.9385911233127211,0.9385911233127227,0,0,10.731818199157715,10.731818199157715,1,1
1938,2,8.831043844132878,8.83104384413288,0.9841841765583315,0.9841841765583341,0,0,10.827792167663574,10.731818199157715,2,2
1938,3,8.299269059134954,8.299269059134955,0.9958743567538639,0.9958743567538668,0,0,11.117227554321289,10.731818199157715,3,3
1938,4,7.521249864133025,7.521249864133024,1.0125606756364434,1.0125606756364454,0,0,11.234624862670898,10.731818199157715,4,4
1938,8,6.836623381684215,6.836623381684216,1.0280638447170616,1.0280638447170607,0,0,11.940142631530762,10.731818199157715,8,8
1938,16,6.247296595473386,6.480334334459634,1.03712151513217,1.0355967262465129,2,4,12.337864875793457,10.731818199157715,14,12
1938,32,5.569963683747718,6.18171232167239,1.042925161554163,1.0400018970816571,11,19,12.794119834899902,10.731818199157715,21,13
1938,64,4.544304313526184,6.037107675489683,1.0358161878168684,1.0460420998679931,28,47,13.30301284790039,10.731818199157715,36,17
1938,128,2.5176482162779372,5.8064008164158105,1.009098668608404,1.0588304362794347,63,106,13.967299461364746,10.731818199157715,65,22
1939,1,3.3533676714828493,3.353367671482851,0.9919721566216927,0.991972156621695,0,0,3.362642526626587,3.362642526626587,1,1
1939,2,2.4083905062044133,2.4083905062044138,0.9995892426760502,0.9995892426760522,0,0,3.7493488788604736,3.362642526626587,2,2
1939,3,2.363881156476941,2.363881156476941,0.999997955502558,0.9999979555025604,0,0,4.043191432952881,3.362642526626587,3,3
1939,4,2.355786385913998,2.3557863859139974,1.0001488798417875,1.0001488798417897,0,0,4.262361526489258,3.362642526626587,4,4
1939,8,2.2469439680391625,2.2473861704968225,1.0003516870526628,1.0003659965437193,1,1,4.394442558288574,3.362642526626587,7,7
1939,16,1.5958331282844591,1.999120557392225,1.0018165799146872,1.002304706316873,6,9,4.8027496337890625,3.362642526626587,10,7
1939,32,1.1567557972823022,1.8479281064449369,1.0033937147771392,1.0058578885871423,14,20,5.039489269256592,3.362642526626587,18,12
1939,64,0.6194325289548236,1.6879706447946274,1.0008630250655266,1.0070531949850505,31,52,5.430700302124023,3.362642526626587,33,12
1939,128,0.05400955015165841,1.5676931288234766,1.0000271006397865,1.0076075324833864,62,114,6.015501976013184,3.362642526626587,66,14
1940,1,11.560338713297243,11.560338713297247,0.930171739684495,0.9301717396844953,0,0,11.753630638122559,11.753630638122559,1,1
1940,2,11.36461747974276,11.36461747974276,0.9384477177769541,0.9384477177769543,0,0,12.26212215423584,11.753630638122559,2,2
1940,3,11.205200500399357,11.205200500399355,0.9467326811785645,0.9467326811785639,0,0,13.65869140625,11.753630638122559,3,3
1940,4,10.860295249852646,10.860295249852646,0.9590618216925901,0.9590618216925901,0,0,13.743501663208008,11.753630638122559,4,4
1940,8,10.106536584582075,10.22505025430622,0.9874879071300458,0.9883213918771507,2,2,14.044793128967285,11.753630638122559,6,6
1940,16,9.11602413009114,9.524554209944585,1.0114244629486926,1.0120412888786243,5,7,14.577917098999023,11.753630638122559,11,9
1940,32,7.19434456852598,9.280224019692271,1.0265093912431742,1.025298541901975,15,20,15.20280647277832,11.753630638122559,17,12
1940,64,4.812976290345447,9.246718475672214,1.008267161125043,1.027036046577111,34,51,15.686306953430176,11.753630638122559,30,13
1940,128,2.8691109195701126,9.137583986224508,1.0029179667539978,1.0305213900736927,61,116,16.206562042236328,11.753630638122559,67,12
1941,1,11.692358700234099,11.692358700234102,0.9140526574568936,0.9140526574568955,0,0,11.964526176452637,11.964526176452637,1,1
1941,2,9.49914785027828,9.499147850278279,0.9691213308226101,0.9691213308226098,0,0,12.31584358215332,11.964526176452637,2,2
1941,3,9.496129148822062,9.49914785027828,0.969547809263118,0.96912133082261,1,1,12.390029907226562,11.964526176452637,2,2
1941,4,9.399998603936387,9.415318561324154,0.9711846535860928,0.9701062545270793,1,1,12.484236717224121,11.964526176452637,3,3
1941,8,8.70045451185687,9.031219340194973,0.9860468837088667,0.9761370404260281,2,4,12.668006896972656,11.964526176452637,6,4
1941,16,6.930060218060616,7.183908008593778,1.0281143827847659,1.0201125483427649,3,8,13.056634902954102,11.964526176452637,13,8
1941,32,5.867261263938975,6.4458856356062935,1.0408760024245935,1.0346581472237073,13,16,13.405510902404785,11.964526176452637,19,16
1941,64,4.999911700285156,6.374741930921053,1.0362148499163122,1.0370398338320332,32,47,13.843092918395996,11.964526176452637,32,17
1941,128,3.496872845883963,6.3061556708430055,1.0245648967431982,1.0413852565576736,58,107,14.335728645324707,11.964526176452637,70,21
1942,1,9.848541212997496,9.848541212997501,0.9444252483500568,0.9444252483500584,0,0,9.985879898071289,9.985879898071289,1,1
1942,2,8.643542718870576,8.643542718870577,0.9732578899453863,0.9732578899453874,0,0,10.061332702636719,9.985879898071289,2,2
1942,3,8.510797934603051,8.510797934603051,0.9752330187310371,0.9752330187310381,0,0,10.238790512084961,9.985879898071289,3,3
1942,4,7.6146809861408045,7.6146809861408045,0.9856405422987446,0.9856405422987454,0,0,10.338114738464355,9.985879898071289,4,4
1942,8,6.5422665004386245,6.544001670055003,1.0088245334118593,1.0086759819413382,1,1,10.554929733276367,9.985879898071289,7,7
1942,16,5.671150877715647,5.741015167688573,1.026222496728729,1.0253527774102915,4,6,10.800396919250488,9.985879898071289,12,10
1942,32,5.089431468343926,5.530247015650787,1.02969473102101,1.0300259200226385,15,18,11.258809089660645,9.985879898071289,17,14
1942,64,3.9402282546861147,5.424597525446702,1.022994106736609,1.0316128131474303,26,44,11.813177108764648,9.985879898071289,38,20
1942,128,2.3946965390360657,5.2217391114664515,1.0093914195867342,1.0369284107104169,55,101,12.18155288696289,9.985879898071289,73,27
1943,1,6.0074793459542155,6.007479345954218,0.9823971721605677,0.9823971721605692,0,0,6.030992031097412,6.030992031097412,1,1
1943,2,4.834978674798211,4.834978674798211,0.9968555775485775,0.9968555775485786,0,0,6.2383809089660645,6.030992031097412,2,2
1943,3,4.454578168434493,4.454578168434493,1.0001903230509643,1.000190323050965,0,0,6.686479091644287,6.030992031097412,3,3
1943,4,4.2037929296575465,4.2037929296575465,1.0025544118859175,1.0025544118859189,0,0,6.733502388000488,6.030992031097412,4,4
1943,8,4.040623284262822,4.040623284262822,1.005465058189419,1.0054650581894196,0,0,7.166623115539551,6.030992031097412,8,8
1943,16,3.4878671046317447,3.7202741703102076,1.0108884524708994,1.0092905597659338,6,5,7.657456874847412,6.030992031097412,10,11
1943,32,2.861805239657482,3.670499742255717,1.0111385480575235,1.010007455687849,13,22,8.284416198730469,6.030992031097412,19,10
1943,64,1.791331705154107,3.4014743871397473,1.0042955529702613,1.014342081920871,32,51,9.094125747680664,6.030992031097412,32,13
1943,128,0.9376943275395567,3.3517397409987106,1.0016754796539675,1.0166389344765265,57,111,9.850373268127441,6.030992031097412,71,17
1944,1,6.486825733656005,6.486825733656007,0.9813766910210465,0.9813766910210502,0,0,6.510172367095947,6.510172367095947,1,1
1944,2,5.133162639757794,5.133162639757792,1.0042569288607162,1.00425692886072,0,0,8.272589683532715,6.510172367095947,2,2
1944,3,4.75580721230959,4.755807212309586,1.0130696336787037,1.0130696336787073,0,0,8.533504486083984,6.510172367095947,3,3
1944,4,4.549194635388434,4.549194635388436,1.0149770937389044,1.0149770937389078,0,0,9.168546676635742,6.510172367095947,4,4
1944,8,4.348755784838534,4.484274837177085,1.0172136288622613,1.0179869177749223,3,2,9.976692199707031,6.510172367095947,5,6
1944,16,4.119608250417462,4.461954012394602,1.0162489339825929,1.019813287219679,7,8,10.804596900939941,6.510172367095947,9,8
1944,32,3.5491804922969385,4.3722986221892715,1.0134532124492752,1.025216400359712,16,23,11.794254302978516,6.510172367095947,16,9
1944,64,2.941350321360823,4.372106808795085,1.0059768885437668,1.0253723465916682,28,54,12.865425109863281,6.510172367095947,36,10
1944,128,1.8229448040229124,4.34432802475417,1.0047271479125515,1.0285854179669212,58,114,13.686500549316406,6.510172367095947,70,14
1945,1,4.061765740604392,4.0617657406043834,0.9879190957283566,0.9879190957283567,0,0,4.078817367553711,4.078817367553711,1,1
1945,2,3.541224246525328,3.541224246525328,0.9937313842157767,0.9937313842157762,0,0,4.267815589904785,4.078817367553711,2,2
1945,3,3.3280191558734185,3.3280191558734176,0.9958781963954069,0.9958781963954063,0,0,4.308142185211182,4.078817367553711,3,3
1945,4,3.113665274542775,3.113665274542774,0.9976796574635898,0.9976796574635887,0,0,4.4241414070129395,4.078817367553711,4,4
1945,8,2.697859640196109,2.749611353033745,0.999219156035341,0.9988944119661449,3,3,4.534812927246094,4.078817367553711,5,5
1945,16,2.417615194684308,2.593091672339463,1.0022062768037647,1.0004884094903228,6,9,4.672726631164551,4.078817367553711,10,7
1945,32,1.733518022890842,2.1949606305634277,1.0021295372061019,1.002505177655749,14,25,4.974334239959717,4.078817367553711,18,7
1945,64,1.0857904155853717,2.0937206516853917,1.000736218008739,1.0031502327393678,32,55,5.263716220855713,4.078817367553711,32,9
1945,128,0.4338686955045755,2.023996950497195,1.000179842037876,1.004618477099075,65,117,5.735317707061768,4.078817367553711,63,11
1946,1,8.680258549542136,8.68025854954214,0.9569731384150392,0.956973138415041,0,0,8.772449493408203,8.772449493408203,1,1
1946,2,7.860828855040417,7.86082885504042,0.9752125387122355,0.9752125387122381,0,0,9.38404369354248,8.772449493408203,2,2
1946,3,7.553866543478197,7.553866543478198,0.9819780808557768,0.9819780808557775,0,0,9.54147720336914,8.772449493408203,3,3
1946,4,6.622554706531414,6.622554706531414,1.001557051122859,1.0015570511228613,0,0,9.574285507202148,8.772449493408203,4,4
1946,8,5.712146599792498,5.7482695323604345,1.021220225891561,1.0212893217637604,2,2,10.406880378723145,8.772449493408203,6,6
1946,16,5.224753414238569,5.548091517281943,1.0212195774118205,1.0255366868121347,4,6,11.142923355102539,8.772449493408203,12,10
1946,32,4.554345967185348,5.349226195986236,1.0216895684752956,1.0290895319000841,12,19,11.999372482299805,8.772449493408203,20,13
1946,64,3.763951159107369,5.1783877030502286,1.017748143459889,1.0349538494606192,28,50,12.558229446411133,8.772449493408203,36,14
1946,128,2.2005333684298747,5.1360117391577305,1.005945029764304,1.0380082340816577,62,112,13.141168594360352,8.772449493408203,66,16
1947,1,10.03757849541488,10.037578495414886,0.9437059829639105,0.9437059829639127,0,0,10.178671836853027,10.178671836853027,1,1
1947,2,8.180237739217375,8.180237739217377,0.9888320511095385,0.9888320511095405,0,0,10.95654010772705,10.178671836853027,2,2
1947,3,7.594085944969203,7.594085944969202,1.0039855790265966,1.0039855790265984,0,0,11.537842750549316,10.178671836853027,3,3
1947,4,7.555872509781381,7.555872509781381,1.0062829437501137,1.0062829437501155,0,0,11.873395919799805,10.178671836853027,4,4
1947,8,7.22922527116427,7.230472210356043,1.0152995349960179,1.0152847023872618,1,1,12.528691291809082,10.178671836853027,7,7
1947,16,6.655042618364294,6.982726646599093,1.0241254048729878,1.0229275656134904,3,6,13.135703086853027,10.178671836853027,13,10
1947,32,5.526679663321093,6.436870259535375,1.0313039590928716,1.0442461230111297,15,20,13.817611694335938,10.178671836853027,17,12
1947,64,4.800306113812513,6.384690669949301,1.028646552946717,1.0476378438389686,30,50,14.50204849243164,10.178671836853027,34,14
1947,128,2.7123468390137293,6.276105049117271,1.0084663702209649,1.054344609556921,60,107,15.367423057556152,10.178671836853027,68,21
1948,1,11.118532502129653,11.11853250212966,0.9248681607335505,0.9248681607335523,0,0,11.345471382141113,11.345471382141113,1,1
1948,2,9.32848139088342,9.328481390883422,0.9647146902356099,0.9647146902356107,0,0,11.452983856201172,11.345471382141113,2,2
1948,3,8.987891528536876,8.987891528536872,0.9751189803450452,0.9751189803450445,0,0,11.821243286132812,11.345471382141113,3,3
1948,4,8.914652532027578,8.914652532027581,0.9749405556338948,0.9749405556338969,0,0,11.86377239227295,11.345471382141113,4,4
1948,8,7.520842111234256,7.522056676946818,1.0115042250765351,1.0116954834499332,1,1,12.398008346557617,11.345471382141113,7,7
1948,16,6.919484727930278,6.9706066368729775,1.0314786307271302,1.030561075113456,2,4,12.977093696594238,11.345471382141113,14,12
1948,32,5.733794470048253,6.875144328334095,1.0294926821307473,1.0341351770674296,14,18,13.53207778930664,11.345471382141113,18,14
1948,64,5.085544140275068,6.829947115233765,1.0250293339457086,1.0365116785413377,30,48,13.926897048950195,11.345471382141113,34,16
1948,128,3.5929611419957084,6.778790713258901,1.0137077372227319,1.0399159429620815,61,111,14.358075141906738,11.345471382141113,67,17
1949,1,7.389356125706168,7.389356125706172,0.9712169858175052,0.9712169858175065,0,0,7.440708160400391,7.440708160400391,1,1
1949,2,6.4891138677422795,6.489113867742234,0.9869832472920212,0.9869832472920219,0,0,8.062902450561523,7.440708160400391,2,2
1949,3,6.446911642009822,6.446911642009821,0.988229365460938,0.9882293654609382,0,0,8.09509563446045,7.440708160400391,3,3
1949,4,6.358846239127687,6.358846239127686,0.9909242262433677,0.9909242262433678,0,0,8.165139198303223,7.440708160400391,4,4
1949,8,5.116118650746589,5.118648099832959,1.0081195056907994,1.008232497738455,1,1,8.531311988830566,7.440708160400391,7,7
1949,16,4.272118714244159,4.657722514015504,1.0151405382064356,1.0166899191121685,7,9,8.947029113769531,7.440708160400391,9,7
1949,32,3.5148828859723924,4.614200557659601,1.015095266230397,1.0183344338849505,13,21,9.51162052154541,7.440708160400391,19,11
1949,64,2.641757743273061,4.569425749190564,1.0103916781029425,1.0211480124769754,30,51,10.087430953979492,7.440708160400391,34,13
1949,128,1.146767752053854,4.49189612261483,1.0023737399052912,1.0237232319465872,66,115,10.721020698547363,7.440708160400391,62,13
1950,1,5.51160789674796,5.511607896747963,0.9830656246239381,0.98306562462394,0,0,5.53558349609375,5.53558349609375,1,1
1950,2,4.634000774145858,4.634000774145859,0.9947056810404503,0.9947056810404524,0,0,5.8825364112854,5.53558349609375,2,2
1950,3,4.272419873096036,4.272419873096036,0.9988011576005669,0.9988011576005682,0,0,6.035007476806641,5.53558349609375,3,3
1950,4,3.7148885995610104,3.71488859956101,1.006287705868588,1.0062877058685886,0,0,6.2299323081970215,5.53558349609375,4,4
1950,8,2.9232613744966045,2.9232974887551553,1.0113365444631537,1.0113098612057407,2,2,6.580532550811768,5.53558349609375,6,6
1950,16,2.7042016284853756,2.7471555458770784,1.013371496873223,1.0135009936338366,5,9,7.102809906005859,5.53558349609375,11,7
1950,32,2.385996635862653,2.6183428849833916,1.0136587408242295,1.0156579853577226,12,22,7.702004909515381,5.53558349609375,20,10
1950,64,1.6323041505160316,2.5860391931840683,1.0057466434646423,1.0167123288623308,31,51,8.35582160949707,5.53558349609375,33,13
1950,128,0.6925987333054866,2.5556607508908926,1.0010672787040513,1.0178341415895191,62,112,9.413725852966309,5.53558349609375,66,16
1951,1,6.416720594461163,6.41672059446116,0.9786047812184986,0.9786047812185014,0,0,6.44926118850708,6.44926118850708,1,1
1951,2,5.70773038736149,5.707730387361491,0.989048583329629,0.9890485833296314,0,0,7.633152484893799,6.44926118850708,2,2
1951,3,5.105598424390914,5.105598424390912,0.9983424402657032,0.9983424402657048,0,0,7.67349100112915,6.44926118850708,3,3
1951,4,4.818226868915191,4.81822686891519,1.003085185262097,1.0030851852620992,0,0,7.673916339874268,6.44926118850708,4,4
1951,8,4.186340590961124,4.242385558029136,1.0087207554331,1.0097095730188577,2,2,7.839848041534424,6.44926118850708,6,6
1951,16,3.567804913835438,3.703088929146673,1.0141104830162386,1.0154524305134185,5,4,8.240684509277344,6.44926118850708,11,12
1951,32,2.815572827350669,3.4004321086710694,1.0107815567464837,1.0182551263830746,14,22,8.91240119934082,6.44926118850708,18,10
1951,64,1.8183947203346285,3.3791024820542623,1.0034106308539419,1.0189431503541848,35,53,9.56865406036377,6.44926118850708,29,11
1951,128,1.079471053791596,3.362868198049065,1.0037500741552774,1.0200396472671924,59,113,10.3670015335083,6.44926118850708,69,15
1952,1,8.529090761307863,8.529090761307867,0.9619457067959772,0.9619457067959789,0,0,8.604996681213379,8.604996681213379,1,1
1952,2,7.020455960470135,7.020455960470135,0.9906099068918875,0.9906099068918885,0,0,9.150246620178223,8.604996681213379,2,2
1952,3,6.911106440973075,6.911106440973075,0.9922180437762891,0.9922180437762902,0,0,9.179839134216309,8.604996681213379,3,3
1952,4,6.860912748190572,6.8609127481905645,0.9943025726817013,0.9943025726817026,0,0,10.112286567687988,8.604996681213379,4,4
1952,8,6.225810381022662,6.267873287410425,1.0039672701412476,1.0036698160289526,1,1,10.327948570251465,8.604996681213379,7,7
1952,16,5.983769118709508,6.075702175194941,1.008249433795987,1.0083610659914384,3,5,10.747200965881348,8.604996681213379,13,11
1952,32,5.1227535686892205,5.705003429464688,1.0205954121445089,1.0174443557496295,13,19,11.075373649597168,8.604996681213379,19,13
1952,64,3.2343930752762535,5.193654204776431,1.0130652891886962,1.0250596742284932,32,49,11.431703567504883,8.604996681213379,32,15
1952,128,2.079312155759723,5.154768414920194,1.0059986365698437,1.0281143540817113,61,112,11.852622985839844,8.604996681213379,67,16
1953,1,8.00440399036669,8.004403990366692,0.9684516974755722,0.968451697475574,0,0,8.06087875366211,8.06087875366211,1,1
1953,2,6.748831811704552,6.748831811704552,0.9894541221866505,0.9894541221866522,0,0,8.082637786865234,8.06087875366211,2,2
1953,3,6.5254505414037745,6.525450541403775,0.9937606927549771,0.9937606927549785,0,0,9.052657127380371,8.06087875366211,3,3
1953,4,6.5216902170160544,6.5216902170160544,0.9942205168653752,0.9942205168653765,0,0,9.18985652923584,8.06087875366211,4,4
1953,8,6.047078063997005,6.047310479335761,1.0040596450152646,1.0041440754165505,1,1,9.6227445602417,8.06087875366211,7,7
1953,16,5.11491476314409,5.946032623034084,1.0057436656832295,1.007390007537607,5,6,10.23867130279541,8.06087875366211,11,10
1953,32,4.354165344941085,5.4443928559566075,1.010031842183829,1.0212509762928135,12,21,10.713774681091309,8.06087875366211,20,11
1953,64,3.465908686947491,5.346046017572568,1.007391180772323,1.025755859498242,32,43,11.223383903503418,8.06087875366211,32,21
1953,128,1.7399124596660802,5.131611871691736,1.0005073333272332,1.0279252123192464,61,110,11.804048538208008,8.06087875366211,67,18
1954,1,10.61627016861183,10.616270168611834,0.9331331125679698,0.9331331125679712,0,0,10.800823211669922,10.800823211669922,1,1
1954,2,9.737733482186666,9.737733482186668,0.9593101897718788,0.959310189771879,0,0,11.908656120300293,10.800823211669922,2,2
1954,3,8.655052306769358,8.65505230676936,0.9836917350529317,0.9836917350529328,0,0,12.053030014038086,10.800823211669922,3,3
1954,4,8.316811025906475,8.316811025906475,0.9934826844355258,0.9934826844355261,0,0,12.133419036865234,10.800823211669922,4,4
1954,8,8.07666066546248,8.092308969007231,1.0025425505643648,1.0019102273831009,1,1,12.714914321899414,10.800823211669922,7,7
1954,16,7.234607755497298,7.739285450126717,1.0082483436142313,1.0135943987207412,5,7,13.097752571105957,10.800823211669922,11,9
1954,32,6.14076220310219,7.32059161965748,1.0211038148470475,1.0275536414311583,15,21,13.561492919921875,10.800823211669922,17,11
1954,64,4.477820524145458,7.24423419444572,1.0154715986497531,1.032460071159804,28,51,14.201638221740723,10.800823211669922,36,13
1954,128,2.9259716767639214,7.171076306876037,1.0059068821685404,1.0394743831733186,65,112,14.775145530700684,10.800823211669922,63,16
1955,1,11.179146456171434,11.179146456171445,0.9195186556887778,0.9195186556887819,0,0,11.434905052185059,11.434905052185059,1,1
1955,2,9.409247792126004,9.409247792126006,0.9740246193591964,0.9740246193591985,0,0,12.275508880615234,11.434905052185059,2,2
1955,3,8.808302215916102,8.808302215916102,0.9898576523465412,0.9898576523465425,0,0,12.49313735961914,11.434905052185059,3,3
1955,4,8.470539989947786,8.470539989947786,0.999381724779369,0.9993817247793702,0,0,12.739192008972168,11.434905052185059,4,4
1955,8,7.721663680101682,7.7216636801016785,1.0186000132938315,1.0186000132938335,0,0,13.04913330078125,11.434905052185059,8,8
1955,16,7.004873898134142,7.403013662922175,1.0279441346497038,1.0272249401933438,7,8,13.550922393798828,11.434905052185059,9,8
1955,32,6.1820634507266785,7.3080216264959645,1.0351984687877593,1.030559351029812,13,22,14.058454513549805,11.434905052185059,19,10
1955,64,4.888658420988286,7.001669643790101,1.0273543385411639,1.0410804503061515,30,51,14.654244422912598,11.434905052185059,34,13
1955,128,2.850000505495946,6.997550721866035,1.0096337395876778,1.0420340585787349,63,113,15.143821716308594,11.434905052185059,65,15
1956,1,8.571761369540583,8.571761369540587,0.9548757237814247,0.9548757237814267,0,0,8.675904273986816,8.675904273986816,1,1
1956,2,7.450596030911339,7.45059603091134,0.9775019554328679,0.9775019554328694,0,0,9.460225105285645,8.675904273986816,2,2
1956,3,6.76115993387029,6.761159933870289,0.9909164148180274,0.990916414818028,0,0,9.464372634887695,8.675904273986816,3,3
1956,4,6.534598407710396,6.534598407710396,0.9972494731977517,0.9972494731977514,0,0,9.831262588500977,8.675904273986816,4,4
1956,8,6.318885586581645,6.429462154620621,1.0001904746738495,0.9995841693937422,1,3,10.49196720123291,8.675904273986816,7,5
1956,16,5.440535854763436,5.860199241951971,1.0134209555560383,1.0152063753831202,5,7,11.495946884155273,8.675904273986816,11,9
1956,32,5.1319993466274365,5.802847870186228,1.0090976796732054,1.0172887141279912,14,18,11.905305862426758,8.675904273986816,18,14
1956,64,3.9419636663171453,5.5030095456303,1.0138090152682435,1.0270424920963346,30,52,12.688278198242188,8.675904273986816,34,12
1956,128,2.8100271700442554,5.478278385808249,1.0109078337058102,1.029947339370274,67,112,13.41635799407959,8.675904273986816,61,16
1957,1,9.623462083896683,9.623462083896683,0.9443840266745108,0.9443840266745134,0,0,9.76919937133789,9.76919937133789,1,1
1957,2,7.253121688014432,7.253121688014431,0.9942869507511448,0.9942869507511455,0,0,9.785346984863281,9.76919937133789,2,2
1957,3,6.058139317323139,6.058139317323139,1.0133996192419032,1.0133996192419032,0,0,9.859694480895996,9.76919937133789,3,3
1957,4,5.6802855563120485,5.680285556312047,1.0214615243536973,1.0214615243537004,0,0,9.931716918945312,9.76919937133789,4,4
1957,8,5.0069420485646186,5.019677015156096,1.0337257722339488,1.0335672562619516,1,1,10.722068786621094,9.76919937133789,7,7
1957,16,4.770354474086107,4.880045490408687,1.037267729892015,1.0373890989758672,7,7,11.485455513000488,9.76919937133789,9,9
1957,32,4.213500650364965,4.821244703119974,1.0308012725403013,1.0391923384858202,16,22,12.452807426452637,9.76919937133789,16,10
1957,64,3.0387923723419195,4.7151239388913355,1.0170085587793032,1.0450000148393062,30,47,13.210041046142578,9.76919937133789,34,17
1957,128,1.9647759510981044,4.696222180311531,1.0073603714342132,1.046383501666364,65,108,14.180488586425781,9.76919937133789,63,20
1958,1,8.631112669100926,8.631112669100931,0.9536486995823866,0.9536486995823892,0,0,8.743722915649414,8.743722915649414,1,1
1958,2,6.629102928627031,6.629102928627031,0.9947875408440594,0.9947875408440614,0,0,9.097638130187988,8.743722915649414,2,2
1958,3,5.676332923354709,5.676332923354705,1.0122186373398425,1.012218637339846,0,0,9.132906913757324,8.743722915649414,3,3
1958,4,5.61615434005969,5.616154340059688,1.0128554517346853,1.012855451734688,0,0,9.270506858825684,8.743722915649414,4,4
1958,8,5.177191689915198,5.177191689915193,1.0191592266600642,1.019159226660067,0,0,9.78246021270752,8.743722915649414,8,8
1958,16,4.687444041712548,4.932780561083992,1.027170487269242,1.0246637712499556,6,5,10.167562484741211,8.743722915649414,10,11
1958,32,4.3491178559910795,4.769778961269537,1.0312443021765696,1.0299333764288665,13,17,10.533520698547363,8.743722915649414,19,15
1958,64,3.219366935873238,4.75465607847811,1.021125412350233,1.0307129295561936,28,48,11.161646842956543,8.743722915649414,36,16
1958,128,1.9443919713126918,4.710200124069096,1.0055605106397238,1.0341798673450113,58,110,11.905056953430176,8.743722915649414,70,18
1959,1,7.014378202718413,7.014378202718415,0.9746632359039721,0.974663235903973,0,0,7.055092811584473,7.055092811584473,1,1
1959,2,5.2951974456158,5.295197445615799,0.9992564542450405,0.9992564542450408,0,0,7.293862819671631,7.055092811584473,2,2
1959,3,4.787655462411068,4.787655462411068,1.0059469171557542,1.0059469171557545,0,0,7.38051176071167,7.055092811584473,3,3
1959,4,4.760901768703405,4.760901768703405,1.0064428859888448,1.0064428859888448,0,0,7.4481000900268555,7.055092811584473,4,4
1959,8,4.157985832901188,4.534652205404976,1.0146329125961624,1.0110942923614348,1,1,8.175956726074219,7.055092811584473,7,7
1959,16,3.7875245144343315,4.409710748955786,1.019595635307948,1.0144895524342754,6,7,9.155024528503418,7.055092811584473,10,9
1959,32,3.2435611946419733,4.240549363462959,1.0091743983156296,1.0194470142684593,16,25,9.928787231445312,7.055092811584473,16,7
1959,64,2.5988204424993886,4.081266261269638,1.0053079317655667,1.02562124908721,27,52,10.733938217163086,7.055092811584473,37,12
1959,128,1.546867561682588,4.070187004048221,1.002012606419136,1.0268184254262813,55,115,11.604869842529297,7.055092811584473,73,13
1960,1,8.041942149219311,8.04194214921929,0.9675719990232511,0.9675719990232539,0,0,8.09931468963623,8.09931468963623,1,1
1960,2,7.412792728160952,7.412792728160954,0.985265167514605,0.985265167514607,0,0,9.824166297912598,8.09931468963623,2,2
1960,3,6.742881948873222,6.742881948873222,1.0002566533554293,1.0002566533554313,0,0,10.051013946533203,8.09931468963623,3,3
1960,4,6.185058967495939,6.185058967495937,1.0125907579351536,1.012590757935155,0,0,10.120226860046387,8.09931468963623,4,4
1960,8,6.103878094103657,6.168006487240979,1.0136181243101232,1.0131705247743064,3,3,10.551347732543945,8.09931468963623,5,5
1960,16,5.696981421862979,5.903503403908607,1.024216413320728,1.02289394058638,6,9,10.829275131225586,8.09931468963623,10,7
1960,32,4.604541860498705,5.824727694016579,1.0183680216281192,1.0259736656224085,14,23,11.377554893493652,8.09931468963623,18,9
1960,64,3.373073655921513,5.657706758109575,1.0075429579674244,1.0273633594942972,32,52,11.962650299072266,8.09931468963623,32,12
1960,128,2.0242308504212465,5.479873340209086,1.0013312996401302,1.0310932883393107,67,115,12.628138542175293,8.09931468963623,61,13
1961,1,9.028502745662143,9.028502745662148,0.9492219382917144,0.9492219382917162,0,0,9.154336929321289,9.154336929321289,1,1
1961,2,7.67962925672507,7.679629256725071,0.9818863818287247,0.9818863818287253,0,0,10.353951454162598,9.154336929321289,2,2
1961,3,6.768418980362105,6.768418980362105,0.9996872623016011,0.9996872623016014,0,0,10.443826675415039,9.154336929321289,3,3
1961,4,6.574620193425844,6.574620193425844,1.003201956470504,1.0032019564705044,0,0,10.520596504211426,9.154336929321289,4,4
1961,8,6.077679226353836,6.077679226353838,1.014202960256374,1.0142029602563747,0,0,11.052608489990234,9.154336929321289,8,8
1961,16,5.49847619004988,5.679602299738503,1.0238021081909918,1.025075607421039,4,4,11.536395072937012,9.154336929321289,12,12
1961,32,4.745183101078608,5.478963207189537,1.0252645195523584,1.028478668192275,11,21,11.918222427368164,9.154336929321289,21,11
1961,64,3.631666239676506,5.415087817610942,1.0180970465902273,1.032351324895937,32,49,12.3543119430542,9.154336929321289,32,15
1961,128,2.2282784840139374,5.32721453159031,1.0104756480149433,1.0381585297148757,59,107,12.866623878479004,9.154336929321289,69,21
1962,1,8.58098950049627,8.580989500496274,0.9536490542054435,0.9536490542054445,0,0,8.690316200256348,8.690316200256348,1,1
1962,2,8.10954629969661,8.10954629969661,0.9675410822281652,0.9675410822281658,0,0,10.159850120544434,8.690316200256348,2,2
1962,3,7.701981135686102,7.701981135686102,0.978502376135706,0.9785023761357066,0,0,10.674003601074219,8.690316200256348,3,3
1962,4,6.812585658316784,6.812585658316783,1.0024702715242617,1.0024702715242617,0,0,10.770637512207031,8.690316200256348,4,4
1962,8,6.572250874639905,6.676860825462474,1.0091859730450203,1.008128964874973,1,1,11.0379638671875,8.690316200256348,7,7
1962,16,5.763251294822964,6.128943168049338,1.0246908600462903,1.0263160304535766,5,8,11.929057121276855,8.690316200256348,11,8
1962,32,5.075495398551771,5.797074191566445,1.033118732766311,1.0352065061419473,14,21,12.631213188171387,8.690316200256348,18,11
1962,64,3.5290809035703843,5.765081765578836,1.0217114492002581,1.0364941706682562,30,50,13.100536346435547,8.690316200256348,34,14
1962,128,2.363663263765333,5.765081765578836,1.0114012344280927,1.0364941706682562,60,114,13.650652885437012,8.690316200256348,68,14
1963,1,5.838725291657331,5.838725291657332,0.9844387635527657,0.9844387635527673,0,0,5.857544422149658,5.857544422149658,1,1
1963,2,5.61028476389514,5.61028476389514,0.9919921886869332,0.9919921886869343,0,0,8.4321928024292,5.857544422149658,2,2
1963,3,5.3821478397368585,5.382147839736858,0.9971218513646006,0.9971218513646007,0,0,8.509196281433105,5.857544422149658,3,3
1963,4,5.316707788187195,5.316707788187196,0.9976844006444038,0.9976844006444044,0,0,8.520379066467285,5.857544422149658,4,4
1963,8,4.411375803000436,4.434397020380307,1.0113662803734127,1.012043144975249,1,2,8.796076774597168,5.857544422149658,7,6
1963,16,3.743556376388547,4.029794762785943,1.0210390435332786,1.0218482147543475,5,6,9.370352745056152,5.857544422149658,11,10
1963,32,3.289032307100455,3.934554089295717,1.018341176204947,1.0247622229654023,11,18,9.824700355529785,5.857544422149658,21,14
1963,64,2.6109616681347605,3.874513301330017,1.012215252680718,1.0258245858188195,31,50,10.196298599243164,5.857544422149658,33,14
1963,128,1.5020139529173813,3.8453559571801215,1.0043621328756631,1.0279104628169304,60,111,10.794842720031738,5.857544422149658,68,17
1964,1,4.864425300155339,4.86442530015534,0.9873199941741417,0.9873199941741443,0,0,4.879483222961426,4.879483222961426,1,1
1964,2,4.209694988244348,4.2096949882443475,0.9953290435588944,0.9953290435588957,0,0,5.6772379875183105,4.879483222961426,2,2
1964,3,3.7853756073728246,3.7853756073728246,1.0006938005877788,1.0006938005877803,0,0,5.764904975891113,4.879483222961426,3,3
1964,4,3.7546208372089387,3.754620837208938,1.001081689416349,1.001081689416349,0,0,5.870928764343262,4.879483222961426,4,4
1964,8,2.7637898120285627,2.7923252961649987,1.0116265312091963,1.0112490084115173,1,1,6.250150203704834,4.879483222961426,7,7
1964,16,2.658155587180049,2.789003015930537,1.010043942504933,1.0113807599012568,4,8,6.95345401763916,4.879483222961426,12,8
1964,32,2.315013773652567,2.7048337148303174,1.0100006536896706,1.013423871253457,16,22,7.466802597045898,4.879483222961426,16,10
1964,64,1.6444536787450657,2.639517365492888,1.005131525881759,1.0146666699102378,29,49,8.24620246887207,4.879483222961426,35,15
1964,128,0.8109794506709571,2.637668847108384,0.9998910891498127,1.0150504135837966,62,109,8.925118446350098,4.879483222961426,66,19
1965,1,8.748006248819298,8.7480062488193,0.9547652951977245,0.9547652951977255,0,0,8.855076789855957,8.855076789855957,1,1
1965,2,7.335741460221092,7.335741460221093,0.9821555758898608,0.9821555758898615,0,0,9.301002502441406,8.855076789855957,2,2
1965,3,6.702143870096176,6.702143870096177,0.9953338470125255,0.9953338470125246,0,0,9.713737487792969,8.855076789855957,3,3
1965,4,6.110405941018816,6.110405941018816,1.0051114802158183,1.0051114802158185,0,0,9.857318878173828,8.855076789855957,4,4
1965,8,5.596707585453552,5.702747649534867,1.0095698940265543,1.0110299001994454,1,1,10.145637512207031,8.855076789855957,7,7
1965,16,5.289969943357481,5.552564911878795,1.0112609182666756,1.0160646211929132,5,6,10.875576972961426,8.855076789855957,11,10
1965,32,4.677757861741997,5.445497609126855,1.002553689502015,1.0163401902794549,13,17,11.445005416870117,8.855076789855957,19,15
1965,64,4.164231954958598,5.3480315964559315,1.0048407075524015,1.0216272460652984,31,46,11.925467491149902,8.855076789855957,33,18
1965,128,3.3031606443319057,5.245906124934229,1.0018277976842707,1.0275770525014694,62,107,12.2944974899292,8.855076789855957,66,21
1966,1,5.606260441865081,5.606260441865083,0.9820566963215234,0.9820566963215248,0,0,5.632055759429932,5.632055759429932,1,1
1966,2,4.939655167688944,4.939655167688944,0.9902078649349528,0.990207864934953,0,0,5.797171115875244,5.632055759429932,2,2
1966,3,4.1570150816188525,4.1570150816188525,0.9991889554991822,0.9991889554991826,0,0,5.97394323348999,5.632055759429932,3,3
1966,4,3.9744741287010945,3.9744741287010945,1.0019030534713822,1.0019030534713824,0,0,7.2379302978515625,5.632055759429932,4,4
1966,8,3.6376921545871608,3.764900919590729,1.0053296642953873,1.0052586076501067,2,2,7.547354698181152,5.632055759429932,6,6
1966,16,3.202198064772204,3.4309098460518155,1.0106837020110246,1.011141624025745,4,7,8.072691917419434,5.632055759429932,12,9
1966,32,2.5468774917165415,3.281430338614597,1.0108957482365035,1.016170101124157,16,21,9.216338157653809,5.632055759429932,16,11
1966,64,1.9608198445142166,3.20650208988996,1.0063853324743643,1.0194506815281899,30,49,10.130115509033203,5.632055759429932,34,15
1966,128,1.2649229860322877,3.1755074014686673,1.0022210495199366,1.0212027415278422,59,110,11.078492164611816,5.632055759429932,69,18
1967,1,9.328661459727346,9.328661459727352,0.950489057043572,0.9504890570435742,0,0,9.443793296813965,9.443793296813965,1,1
1967,2,8.198613450452894,8.198613450452898,0.9782410368160182,0.9782410368160204,0,0,10.269622802734375,9.443793296813965,2,2
1967,3,7.812838961026341,7.812838961026342,0.9846959975754932,0.9846959975754926,0,0,10.278349876403809,9.443793296813965,3,3
1967,4,7.4219956536834255,7.421995653683425,0.9941601828257999,0.9941601828257993,0,0,10.339621543884277,9.443793296813965,4,4
1967,8,6.841893383876515,6.842883796647044,1.0059601454040654,1.0060558567708568,1,1,10.977468490600586,9.443793296813965,7,7
1967,16,5.560194251075372,5.726381247053396,1.0328050688699935,1.0301076555325595,4,6,11.214685440063477,9.443793296813965,12,10
1967,32,5.365808365833786,5.609918306096729,1.035202497789975,1.033623376765866,10,18,11.500787734985352,9.443793296813965,22,14
1967,64,4.3445107009561985,5.490782590798456,1.0296424732303917,1.0368899463515049,29,49,12.098161697387695,9.443793296813965,35,15
1967,128,2.7120155741064793,5.399627619900819,1.0122515670203633,1.0425409937875518,68,110,12.650967597961426,9.443793296813965,60,18
1968,1,8.111916767492962,8.111916767492966,0.9671835213429764,0.9671835213429776,0,0,8.172550201416016,8.172550201416016,1,1
1968,2,6.870614125897841,6.870614125897843,0.9887522480554009,0.9887522480554024,0,0,9.255999565124512,8.172550201416016,2,2
1968,3,6.541719088769902,6.541719088769903,0.9985582103040105,0.9985582103040124,0,0,9.808382987976074,8.172550201416016,3,3
1968,4,6.325760575844788,6.325760575844789,1.0019637310095273,1.0019637310095284,0,0,10.289301872253418,8.172550201416016,4,4
1968,8,6.119389867862995,6.121889355779496,1.0100929690628833,1.009638978680736,1,1,10.49142074584961,8.172550201416016,7,7
1968,16,5.661434210624223,6.0505525233182995,1.009498540212058,1.0128035398856194,5,7,10.76528549194336,8.172550201416016,11,9
1968,32,4.468104826827814,5.374622530286356,1.02217898371343,1.0295914343025563,11,20,11.19997501373291,8.172550201416016,21,12
1968,64,3.287037481434239,5.343417531408269,1.0146558907539802,1.0309807016328383,28,51,11.502812385559082,8.172550201416016,36,13
1968,128,1.5945157297165327,5.343417531408269,1.0018384003545509,1.0309807016328383,61,115,11.798269271850586,8.172550201416016,67,13
1969,1,9.16009685327996,9.160096853279963,0.9574260943603391,0.9574260943603411,0,0,9.2461519241333,9.2461519241333,1,1
1969,2,8.570850644095241,8.570850644095241,0.9722447372832324,0.9722447372832337,0,0,10.84756851196289,9.2461519241333,2,2
1969,3,7.446067424880222,7.446067424880223,0.9997208622199778,0.9997208622199784,0,0,10.873498916625977,9.2461519241333,3,3
1969,4,7.445126555945938,7.445126555945938,1.0000016881860905,1.0000016881860911,0,0,11.001679420471191,9.2461519241333,4,4
1969,8,6.920785627407116,6.938210007060935,1.0133114888735115,1.013613928458566,2,3,11.542574882507324,9.2461519241333,6,5
1969,16,5.836433570094599,6.226252935410289,1.025932544600066,1.0293821855211802,3,5,11.984582901000977,9.2461519241333,13,11
1969,32,5.1147735822011535,6.005147247043594,1.0243875310376886,1.0340286487224501,15,21,12.422771453857422,9.2461519241333,17,11
1969,64,3.577524155882881,5.982399621794446,1.0124570458268467,1.034821732927739,29,52,12.907669067382812,9.2461519241333,35,12
1969,128,2.0789371712578455,5.886437608518439,1.0051398527221258,1.038456101470475,61,114,13.440624237060547,9.2461519241333,67,14
1970,1,11.489970885201325,11.489970885201291,0.9218274606349929,0.9218274606349949,0,0,11.718777656555176,11.718777656555176,1,1
1970,2,9.122884859778603,9.122884859778605,0.9799612766107193,0.9799612766107222,0,0,11.8748197555542,11.718777656555176,2,2
1970,3,8.661954971455952,8.661954971455954,0.9884940876314599,0.9884940876314605,0,0,11.877767562866211,11.718777656555176,3,3
1970,4,8.374573720635375,8.374573720635375,0.9941599269338619,0.9941599269338622,0,0,11.968751907348633,11.718777656555176,4,4
1970,8,7.598940271690851,7.644939793846682,1.009813127341916,1.0088432427371696,1,1,12.438334465026855,11.718777656555176,7,7
1970,16,7.119865791760496,7.194518226674504,1.0206439725917817,1.0207464455813091,4,4,12.850884437561035,11.718777656555176,12,12
1970,32,6.205997301839511,7.000401712460097,1.0335154267559628,1.0267487536056263,14,20,13.17844295501709,11.718777656555176,18,12
1970,64,4.878963683321727,6.660757874089758,1.0373320824006247,1.0396351999040672,29,49,13.58194351196289,11.718777656555176,35,15
1970,128,3.012771977376413,6.620751245681693,1.0193099467247395,1.0431278031635078,69,107,14.009048461914062,11.718777656555176,59,21
1971,1,8.889031855952982,8.889031855952988,0.9575990296752991,0.9575990296753023,0,0,8.979660034179688,8.979660034179688,1,1
1971,2,7.914986045913942,7.914986045913913,0.9711530698515936,0.971153069851596,0,0,9.119383811950684,8.979660034179688,2,2
1971,3,7.670692696850095,7.670692696850094,0.9731685826521723,0.9731685826521723,0,0,9.36447525024414,8.979660034179688,3,3
1971,4,6.190204578197324,6.195257861452853,1.0066347197808447,1.006050296869594,1,1,9.514809608459473,8.979660034179688,3,3
1971,8,5.888449613701869,5.917071084857027,1.0128084668460813,1.0110058299973463,1,1,9.89236068725586,8.979660034179688,7,7
1971,16,5.215177512425901,5.266918380350149,1.0227737300932227,1.0214274404616237,4,5,10.362210273742676,8.979660034179688,12,11
1971,32,4.095514588268239,5.194375910278853,1.016358293776971,1.0242646812267358,13,18,11.016558647155762,8.979660034179688,19,14
1971,64,3.1555796322376355,4.946195401195944,1.0109751887790672,1.0323406114957314,29,46,11.78148365020752,8.979660034179688,35,18
1971,128,1.8936750052608982,4.92513055398539,1.0015785135103195,1.033930568389749,59,111,12.484067916870117,8.979660034179688,69,17
1972,1,8.908909726935157,8.90890972693516,0.9453866991675275,0.9453866991675283,0,0,9.055508613586426,9.055508613586426,1,1
1972,2,7.357801068643962,7.357801068643961,0.978423959003389,0.9784239590033881,0,0,9.154581069946289,9.055508613586426,2,2
1972,3,6.604897031334423,6.604897031334423,0.9923771173217063,0.9923771173217064,0,0,9.282140731811523,9.055508613586426,3,3
1972,4,6.369347164898055,6.3693471648980555,0.9969112069072082,0.9969112069072085,0,0,9.482278823852539,9.055508613586426,4,4
1972,8,5.777238929527778,5.777845818571885,1.0082520199620388,1.0081870669673862,1,1,9.876486778259277,9.055508613586426,7,7
1972,16,5.011468506180316,5.0963823168536875,1.0231622720280849,1.0215319010244177,6,6,10.238207817077637,9.055508613586426,10,10
1972,32,4.3270420517977914,4.646906416663397,1.036256907339686,1.0325580856579026,13,19,10.696321487426758,9.055508613586426,19,13
1972,64,3.4997495753875243,4.552623266720374,1.0265551478549826,1.0366436511157402,36,47,11.29021167755127,9.055508613586426,28,17
1972,128,2.217726376629821,4.544517693693913,1.0065836648639273,1.0374103454347736,67,109,12.086038589477539,9.055508613586426,61,19
1973,1,10.466529355133126,10.466529355133122,0.9255470766132954,0.9255470766132969,0,0,10.69653606414795,10.69653606414795,1,1
1973,2,8.918945030422195,8.918945030422194,0.9703013272497033,0.9703013272497023,0,0,10.99606990814209,10.69653606414795,2,2
1973,3,8.220784628737091,8.220784628737112,0.9877938842781362,0.9877938842781339,0,0,11.123015403747559,10.69653606414795,3,3
1973,4,8.110567039119664,8.110567039119664,0.9902747865702574,0.9902747865702556,0,0,11.329102516174316,10.69653606414795,4,4
1973,8,7.230456830190483,7.242485716212584,1.0131025189845317,1.0130548237450854,2,2,11.919939041137695,10.69653606414795,6,6
1973,16,6.436898203976551,6.829949061459405,1.0276127445389351,1.0222259373613674,4,8,12.49345874786377,10.69653606414795,12,8
1973,32,5.731687138267772,6.429382073580163,1.0364426771534783,1.0350031476885855,13,19,12.97227668762207,10.69653606414795,19,13
1973,64,4.616927191211266,6.3407414581849455,1.0289747328992327,1.0398367401986035,25,46,13.254899978637695,10.69653606414795,39,18
1973,128,3.0739193563254945,6.251779509778298,1.012328367290062,1.0432214399248476,67,106,13.658327102661133,10.69653606414795,61,22
1974,1,5.031593831091614,5.031593831091617,0.9879760438235657,0.9879760438235673,0,0,5.044682502746582,5.044682502746582,1,1
1974,2,4.8523103476740435,4.852310347674044,0.9909533823067753,0.9909533823067763,0,0,6.4962663650512695,5.044682502746582,2,2
1974,3,4.435050786059455,4.435050786059455,0.9971039617575372,0.9971039617575379,0,0,6.537107944488525,5.044682502746582,3,3
1974,4,4.422121582873181,4.422121582873181,0.9974045872241847,0.9974045872241841,0,0,6.749359607696533,5.044682502746582,4,4
1974,8,3.6089056509432864,3.643482108738554,1.0109205335149931,1.0115643397059308,2,1,7.530541896820068,5.044682502746582,6,7
1974,16,3.2589527480914744,3.4094218743665032,1.0151025113715098,1.0164303617935433,6,7,8.35076904296875,5.044682502746582,10,9
1974,32,2.501186199478186,3.3413318902771705,1.0063987333389037,1.0171918906806092,15,21,9.080242156982422,5.044682502746582,17,11
1974,64,1.7120338610680272,3.2296800859537607,1.0043169324869448,1.0205728474046833,32,49,9.805241584777832,5.044682502746582,32,15
1974,128,1.0362921063614179,3.100833286336724,1.0013489252148138,1.025110604511071,68,112,10.474495887756348,5.044682502746582,60,16
1975,1,7.768568945915505,7.768568945915509,0.9563722714139548,0.9563722714139559,0,0,7.880743980407715,7.880743980407715,1,1
1975,2,5.887422723427688,5.88742272342769,0.9901998784618176,0.9901998784618185,0,0,8.086308479309082,7.880743980407715,2,2
1975,3,5.862309057078701,5.8623090570787015,0.9911674672001726,0.9911674672001729,0,0,8.518026351928711,7.880743980407715,3,3
1975,4,5.8619557827305755,5.861955782730576,0.9911941930960659,0.9911941930960668,0,0,8.52094554901123,7.880743980407715,4,4
1975,8,5.465658738108851,5.600312797560012,0.9980132524742802,0.9974289884845469,3,3,8.966241836547852,7.880743980407715,5,5
1975,16,5.309945595041829,5.578322713601405,1.0000935774712092,0.9988535700786031,6,9,9.417632102966309,7.880743980407715,10,7
1975,32,4.176289252645176,5.524729490099712,1.0096916036697683,1.0023495041377917,13,20,9.88277530670166,7.880743980407715,19,12
1975,64,2.80479524585018,5.282870090907282,1.0073282062894713,1.0085277240698822,30,51,10.398580551147461,7.880743980407715,34,13
1975,128,1.6200597779646655,5.217904924611899,1.0024439069819764,1.013655224199131,60,113,11.125906944274902,7.880743980407715,68,15
1976,1,8.441272145717681,8.441272145717644,0.966251285754676,0.9662512857546774,0,0,8.502598762512207,8.502598762512207,1,1
1976,2,8.006946173411984,8.006946173411986,0.9782398631264759,0.9782398631264768,0,0,10.280050277709961,8.502598762512207,2,2
1976,3,8.006815166684541,8.006815166684543,0.9783483593399931,0.9783483593399942,0,0,10.414138793945312,8.502598762512207,3,3
1976,4,7.473160276094147,7.473160276094148,0.9900163644941063,0.9900163644941072,0,0,10.439581871032715,8.502598762512207,4,4
1976,8,6.466061688752773,6.542882352294644,1.0155184352812656,1.015090114035549,2,2,10.871613502502441,8.502598762512207,6,6
1976,16,5.954777280154435,6.240358116264317,1.0220807379907781,1.0211967219298606,6,7,11.261048316955566,8.502598762512207,10,9
1976,32,5.11257897770995,5.693039616706496,1.030373455862601,1.0341562390055041,10,18,11.830612182617188,8.502598762512207,22,14
1976,64,4.3672704547105585,5.655810709572786,1.023634774888734,1.0356035819108529,28,46,12.459553718566895,8.502598762512207,36,18
1976,128,2.1541575309683023,5.5461687871155005,1.0074167006484194,1.0396744818865864,58,111,13.056333541870117,8.502598762512207,70,17
1977,1,8.537769215979097,8.537769215979099,0.95787862379435,0.9578786237943511,0,0,8.628884315490723,8.628884315490723,1,1
1977,2,6.372993387463662,6.372993387463662,0.9993371888162776,0.9993371888162783,0,0,9.078727722167969,8.628884315490723,2,2
1977,3,5.989632726309591,5.989632726309591,1.0065077306556487,1.006507730655649,0,0,10.183807373046875,8.628884315490723,3,3
1977,4,5.817151115956174,5.817151115956175,1.010922178573689,1.010922178573687,0,0,10.385146141052246,8.628884315490723,4,4
1977,8,5.537368315657458,5.696661622790321,1.0127078151414715,1.0147616395994417,3,3,11.12190055847168,8.628884315490723,5,5
1977,16,5.108036220390452,5.431934126369269,1.0182479272382516,1.0235308381711083,6,8,12.053414344787598,8.628884315490723,10,8
1977,32,4.17796061762865,5.374579105017458,1.0127914103235438,1.0267616313062562,17,23,12.687125205993652,8.628884315490723,15,9
1977,64,3.5926980958320884,5.261888239601887,1.0117619861211626,1.0342167275774021,27,51,13.6520357131958,8.628884315490723,37,13
1977,128,2.1178459758710324,5.258309263890341,1.0049321421754995,1.0352358073884578,68,115,14.70045280456543,8.628884315490723,60,13
1978,1,6.788635036924914,6.788635036924916,0.9782216511671855,0.9782216511671867,0,0,6.820195198059082,6.820195198059082,1,1
1978,2,5.998704354275195,5.998704354275196,0.9953297472472067,0.9953297472472077,0,0,8.991368293762207,6.820195198059082,2,2
1978,3,5.894832003819555,5.894832003819555,0.999250589497435,0.9992505894974354,0,0,10.05551815032959,6.820195198059082,3,3
1978,4,5.892774775528972,5.894832003819555,0.9990815098746408,0.9992505894974354,1,1,10.061662673950195,6.820195198059082,3,3
1978,8,5.801440562389147,5.81768729382001,1.0020920984830726,1.0031102182705014,2,2,10.84813117980957,6.820195198059082,6,6
1978,16,5.516735179079278,5.670643264255217,1.0089259721789856,1.0108536060317372,6,7,11.788384437561035,6.820195198059082,10,9
1978,32,4.136555881172491,5.497919839989453,1.0182353061654084,1.0182427679019812,11,22,12.459321022033691,6.820195198059082,21,10
1978,64,3.1192096279508945,5.3906427372573775,1.0120117274203362,1.0247465487574576,30,52,13.0563383102417,6.820195198059082,34,12
1978,128,2.00928198107818,5.363629102693848,1.0020570126697974,1.0278426854429288,68,113,13.866602897644043,6.820195198059082,60,15
1979,1,5.944571226459648,5.944571226459646,0.9773773029478059,0.9773773029478076,0,0,5.983096122741699,5.983096122741699,1,1
1979,2,4.733173510898961,4.733173510898962,0.9921152749479019,0.9921152749479025,0,0,6.3748779296875,5.983096122741699,2,2
1979,3,4.604587788536912,4.604587788536913,0.9942591072582009,0.9942591072582015,0,0,6.621159553527832,5.983096122741699,3,3
1979,4,4.373226775003175,4.373226775003175,0.997615999761603,0.9976159997616044,0,0,6.74567174911499,5.983096122741699,4,4
1979,8,3.7538043485820154,3.7547930101921962,1.0074541389161824,1.0075240312827431,3,3,7.517595291137695,5.983096122741699,5,5
1979,16,3.4606297088751483,3.5776776351776935,1.009392168008401,1.0110936123903447,8,7,8.198233604431152,5.983096122741699,8,9
1979,32,2.6159971473718246,3.4570886874393696,1.0065856768923145,1.0147808697268645,15,21,8.753719329833984,5.983096122741699,17,11
1979,64,1.9428340453427793,3.384595004114647,1.0059262222132865,1.0166705589290965,28,52,9.532243728637695,5.983096122741699,36,12
1979,128,0.910729232463009,3.296261124898904,1.0005606087169028,1.018966077497916,62,110,10.345666885375977,5.983096122741699,66,18
1980,1,7.020341937023577,7.0203419370235824,0.972252372957164,0.9722523729571668,0,0,7.069798469543457,7.069798469543457,1,1
1980,2,5.52459892721692,5.524598927216896,0.9949022889383915,0.9949022889383934,0,0,7.528428077697754,7.069798469543457,2,2
1980,3,5.257462401677437,5.257462401677438,0.9996273171137567,0.9996273171137591,0,0,8.244672775268555,7.069798469543457,3,3
1980,4,5.257360674194784,5.257462401677438,0.9995908315400157,0.9996273171137591,1,1,8.661806106567383,7.069798469543457,3,3
1980,8,5.056748454696763,5.0785543018991675,1.0040180629389186,1.0041143385763815,1,1,8.750717163085938,7.069798469543457,7,7
1980,16,4.2879806694348614,4.493071559251261,1.01430742323401,1.0132476887377593,8,6,9.200864791870117,7.069798469543457,8,10
1980,32,3.9301705174426425,4.4920353147091445,1.012934267849198,1.0135567800162497,15,21,9.76535701751709,7.069798469543457,17,11
1980,64,2.7708143974607404,4.468398882631103,1.0059547705290761,1.0149936751657165,31,52,10.353910446166992,7.069798469543457,33,12
1980,128,1.6222603247489646,4.4660894227479195,0.9987291200245322,1.015216953684103,64,114,10.979291915893555,7.069798469543457,64,14
1981,1,8.963953260328601,8.9639532603286,0.9503864211169255,0.9503864211169262,0,0,9.086648941040039,9.086648941040039,1,1
1981,2,6.905211569265291,6.905211569265291,0.9886423110966907,0.9886423110966905,0,0,9.499229431152344,9.086648941040039,2,2
1981,3,6.777200243699721,6.777200243699721,0.9934678949416532,0.9934678949416531,0,0,10.130514144897461,9.086648941040039,3,3
1981,4,6.616107408862607,6.616107408862606,0.9964145404785656,0.9964145404785645,0,0,10.370529174804688,9.086648941040039,4,4
1981,8,6.09439788250968,6.1201886867076425,1.0060673675771443,1.005173765735794,1,2,10.66430950164795,9.086648941040039,7,6
1981,16,5.724989756814672,5.894519873617126,1.0146725570784032,1.0135405042007535,7,7,11.258424758911133,9.086648941040039,9,9
1981,32,5.354125991841471,5.812654836149545,1.0140823378584152,1.016586587007816,14,23,11.67503547668457,9.086648941040039,18,9
1981,64,4.48310624403111,5.710205508734597,1.0110422675198891,1.0208348810344179,32,52,12.090449333190918,9.086648941040039,32,12
1981,128,2.9335449502470365,5.683638336379478,0.9980021112049648,1.0222801882165429,60,114,12.517956733703613,9.086648941040039,68,14
1982,1,9.137122375690096,9.137122375690085,0.9460717549737552,0.946071754973757,0,0,9.275457382202148,9.275457382202148,1,1
1982,2,8.446578362619833,8.446578362619835,0.9645306990124172,0.9645306990124185,0,0,11.107776641845703,9.275457382202148,2,2
1982,3,7.896019447607434,7.8960194476074355,0.980182893887606,0.9801828938876072,0,0,11.415080070495605,9.275457382202148,3,3
1982,4,7.895656774937579,7.895656774937578,0.9802631766719989,0.9802631766719992,0,0,11.4757080078125,9.275457382202148,4,4
1982,8,7.376490218591568,7.473540466072977,0.9925090021883476,0.9913660341710129,1,2,11.840253829956055,9.275457382202148,7,6
1982,16,6.587369460055749,7.2807691608053435,1.0020533435369363,0.9957229481976709,7,8,12.134462356567383,9.275457382202148,9,8
1982,32,5.590637307899468,6.903573549139525,1.016118016905579,1.009056730884016,14,22,12.892663955688477,9.275457382202148,18,10
1982,64,4.17198762627958,6.7034303483895386,1.0127254704463249,1.0170217996323072,29,52,13.493481636047363,9.275457382202148,35,12
1982,128,2.6483278547818796,6.498300723271782,1.0069464202763938,1.0258819275605944,63,110,13.979044914245605,9.275457382202148,65,18
1983,1,10.366586266826072,10.366586266826074,0.934671978419921,0.9346719784199216,0,0,10.54806137084961,10.54806137084961,1,1
1983,2,8.873727931437664,8.873727931437667,0.9654097429699225,0.9654097429699218,0,0,10.58202838897705,10.54806137084961,2,2
1983,3,7.680564482576161,7.680564482576161,0.9890849247667997,0.9890849247668012,0,0,10.639297485351562,10.54806137084961,3,3
1983,4,7.322220130276789,7.322220130276788,0.9967731386273795,0.9967731386273795,0,0,10.80894947052002,10.54806137084961,4,4
1983,8,6.756254053434956,6.763859294013684,1.010958554946498,1.0107989625790288,1,1,11.086283683776855,10.54806137084961,7,7
1983,16,6.436938925865531,6.62176649536942,1.0154585946819812,1.0135872856672656,4,5,11.403108596801758,10.54806137084961,12,11
1983,32,5.4340795438302685,6.500808086526796,1.02790168293472,1.0202069070575752,13,19,11.951960563659668,10.54806137084961,19,13
1983,64,4.118141896451516,5.91410624714912,1.0262053162239957,1.0386599926814628,25,44,12.40947437286377,10.54806137084961,39,20
1983,128,2.7527895659487003,5.757610509275991,1.0126932757450409,1.0458872847146452,66,106,12.927450180053711,10.54806137084961,62,22
1984,1,14.262570939346283,14.262570939346295,0.8662493631468549,0.8662493631468577,0,0,14.802892684936523,14.802892684936523,1,1
1984,2,14.0495826997992,14.049582699799204,0.8764668248554519,0.8764668248554539,0,0,14.955018997192383,14.802892684936523,2,2
1984,3,13.614862931692834,13.614862931692839,0.8937906414641583,0.89379064146416,0,0,14.996816635131836,14.802892684936523,3,3
1984,4,13.393990083395751,13.393990083395753,0.9030877482353933,0.9030877482353945,0,0,15.04286003112793,14.802892684936523,4,4
1984,8,12.469746037567749,12.572419842037048,0.9430659115004875,0.9371729333104757,2,3,15.329949378967285,14.802892684936523,6,5
1984,16,10.831886490957286,11.114585879623911,0.9978919581571061,0.9885249528086942,6,9,15.640641212463379,14.802892684936523,10,7
1984,32,9.997783919588864,11.018226972357034,1.0088368580064002,0.9937952528348054,13,23,15.981281280517578,14.802892684936523,19,9
1984,64,7.320659399983498,9.608923321891817,1.0565731411352497,1.0403231496907304,30,50,16.452239990234375,14.802892684936523,34,14
1984,128,4.77472782327735,9.024306387552564,1.0343976083978315,1.062057663479826,58,111,16.892684936523438,14.802892684936523,70,17
1985,1,7.35684726040239,7.356847260402389,0.965083639031341,0.9650836390313409,0,0,7.431660175323486,7.431660175323486,1,1
1985,2,7.007674262872408,7.007674262872408,0.972291064098707,0.9722910640987067,0,0,7.993465900421143,7.431660175323486,2,2
1985,3,6.522427386941565,6.522427386941567,0.9808562909313769,0.9808562909313776,0,0,8.180801391601562,7.431660175323486,3,3
1985,4,5.825738665844499,5.825738665844498,0.9902349782971087,0.9902349782971076,0,0,8.188699722290039,7.431660175323486,4,4
1985,8,5.782669861701618,5.800455601127746,0.9913365348737303,0.9909132563410677,1,1,8.438326835632324,7.431660175323486,7,7
1985,16,5.035350235599974,5.29630842565587,1.0041605508282883,1.0002198291825375,6,8,8.991859436035156,7.431660175323486,10,8
1985,32,3.6029521440463905,4.738090586556702,1.0163866227472922,1.0130870774479876,12,16,9.42679214477539,7.431660175323486,20,16
1985,64,2.823895536481483,4.687835329566966,1.0095982580066476,1.0158760013167187,28,48,9.920612335205078,7.431660175323486,36,16
1985,128,1.3368620303686412,4.5141196611172925,1.0027993084095854,1.0217725479339965,59,111,10.57381820678711,7.431660175323486,69,17
1986,1,3.1915187704394206,3.191518770439421,0.9951960527418592,0.9951960527418596,0,0,3.194969892501831,3.194969892501831,1,1
1986,2,2.6010588274037896,2.601058827403789,0.99506546249432,0.9950654624943194,0,0,3.288567304611206,3.194969892501831,2,2
1986,3,2.287214110861822,2.2872141108618216,0.9980665914627525,0.9980665914627511,0,0,3.365068197250366,3.194969892501831,3,3
1986,4,2.2439907021254024,2.243990702125402,0.9991943403413668,0.9991943403413659,0,0,3.4982426166534424,3.194969892501831,4,4
1986,8,1.9615887031585235,2.0024551034325753,0.9996723067310392,1.0000883840499122,3,1,3.6236705780029297,3.194969892501831,5,7
1986,16,1.7581705224010613,1.9648353495101718,1.0012448769106608,1.0009806400084362,5,5,3.7632081508636475,3.194969892501831,11,11
1986,32,1.006667359563437,1.7637161309775715,1.001315838969429,1.0026585067527645,14,20,4.1083760261535645,3.194969892501831,18,12
1986,64,0.32844364234967793,1.6796587593027867,0.999953249697547,1.0032985589618142,32,52,4.364150047302246,3.194969892501831,32,12
1986,128,0.024086828920087358,1.5464823143359454,0.9999575677419856,1.004809141791228,62,116,4.858653545379639,3.194969892501831,66,12
1987,1,10.443758673597529,10.443758673597486,0.9323635735238459,0.9323635735238486,0,0,10.636984825134277,10.636984825134277,1,1
1987,2,9.467817994979201,9.467817994979203,0.9620388447082632,0.9620388447082646,0,0,11.545125007629395,10.636984825134277,2,2
1987,3,8.542135361377325,8.542135361377326,0.9870068786148798,0.9870068786148813,0,0,11.637347221374512,10.636984825134277,3,3
1987,4,8.436234353085506,8.542135361377326,0.9871268219751923,0.9870068786148813,1,1,11.661480903625488,10.636984825134277,3,3
1987,8,7.60336408786368,7.79705056112331,1.0127563411987206,1.0115200500915562,2,3,12.467046737670898,10.636984825134277,6,5
1987,16,6.897483538087218,7.400105359606957,1.023733532221758,1.0216715734685806,6,9,13.08349895477295,10.636984825134277,10,7
1987,32,5.32619536943947,6.885250462474371,1.0217434702562986,1.0385253427861358,13,22,13.784133911132812,10.636984825134277,19,10
1987,64,3.789452230720402,6.660121423482838,1.014916440217912,1.0509997143980514,33,51,14.772887229919434,10.636984825134277,31,13
1987,128,2.4719458917368673,6.412782939632852,1.0087985477460892,1.0609417708502422,58,110,15.669052124023438,10.636984825134277,70,18
1988,1,5.383511645985413,5.383511645985412,0.9810193433159065,0.9810193433159063,0,0,5.415550231933594,5.415550231933594,1,1
1988,2,5.180535192370031,5.180535192370031,0.9834099756839086,0.9834099756839085,0,0,5.662505626678467,5.415550231933594,2,2
1988,3,5.159453431463452,5.1594534314634535,0.9834391339687418,0.9834391339687424,0,0,5.694742679595947,5.415550231933594,3,3
1988,4,4.7708974811003815,4.77261820880688,0.9887617785042541,0.9886678507256627,1,1,5.7397780418396,5.415550231933594,3,3
1988,8,3.929930056074227,3.9499964585834575,1.000908723841117,1.0003539167085367,2,5,6.137890338897705,5.415550231933594,6,3
1988,16,3.7143497605233198,3.9270534386899394,1.0021950972903437,1.000284828490282,6,12,6.348415851593018,5.415550231933594,10,4
1988,32,3.13355979525122,3.9270534386899394,1.0003963380861212,1.000284828490282,15,28,6.601339340209961,5.415550231933594,17,4
1988,64,2.470204721915086,3.841794534480426,0.9963604443757471,1.0014247393880484,36,59,6.9539666175842285,5.415550231933594,28,5
1988,128,2.145662370815683,3.8211563519334453,0.9969648198245196,1.0022060525868366,65,121,7.348119735717773,5.415550231933594,63,7
1989,1,9.785664839447861,9.785664839447865,0.9512309912847083,0.9512309912847094,0,0,9.896403312683105,9.896403312683105,1,1
1989,2,8.076419997827394,8.076419997827394,0.9911991888528333,0.9911991888528344,0,0,10.215681076049805,9.896403312683105,2,2
1989,3,7.655159700566414,7.655159700566413,0.9988248230150805,0.9988248230150812,0,0,10.309296607971191,9.896403312683105,3,3
1989,4,7.620982711368664,7.620982711368664,0.9993128692958508,0.9993128692958518,0,0,10.476912498474121,9.896403312683105,4,4
1989,8,7.079007137593949,7.186473596919534,1.0107994486578962,1.0080619862982148,2,3,10.914703369140625,9.896403312683105,6,5
1989,16,6.102777012307986,6.521307944338734,1.0236253115791558,1.0207763921592306,6,9,11.208951950073242,9.896403312683105,10,7
1989,32,4.771195035880086,5.784311217313448,1.0361618928906682,1.038676967292386,14,20,11.82451057434082,9.896403312683105,18,12
1989,64,2.6187581366188932,5.725778499567071,1.0107104936656446,1.04077818728395,30,50,12.610437393188477,9.896403312683105,34,14
1989,128,1.5466584301169222,5.7147247236712335,1.0047910131425488,1.0417661352486527,60,113,13.457808494567871,9.896403312683105,68,15
1990,1,6.129206166373262,6.129206166373263,0.9809178438566177,0.9809178438566181,0,0,6.156360149383545,6.156360149383545,1,1
1990,2,5.3116717166551615,5.3116717166551615,0.9960535104564991,0.9960535104564993,0,0,7.011989593505859,6.156360149383545,2,2
1990,3,4.984048839477774,4.984048839477773,1.0022147878222867,1.0022147878222865,0,0,7.417059421539307,6.156360149383545,3,3
1990,4,4.910117595369629,4.910117595369629,1.0037671878756198,1.0037671878756198,0,0,7.8102126121521,6.156360149383545,4,4
1990,8,4.63672423113592,4.652773474566383,1.0087615939064314,1.009353743208746,1,1,8.268577575683594,6.156360149383545,7,7
1990,16,4.028130885465481,4.4009586208315765,1.0119681497286637,1.0145352869276034,5,7,8.952064514160156,6.156360149383545,11,9
1990,32,3.5859661030100285,4.320829678605532,1.0107288534851173,1.018068931584063,15,22,9.510418891906738,6.156360149383545,17,10
1990,64,2.64125455436361,4.278738420531134,1.0041646712222652,1.0204624020266042,33,52,10.487937927246094,6.156360149383545,31,12
1990,128,1.4463627977887386,4.2768847422344844,0.9995579636497196,1.0210596926217534,53,114,11.132694244384766,6.156360149383545,75,14
1991,1,9.060301858785792,9.060301858785795,0.9550555424115731,0.9550555424115754,0,0,9.159058570861816,9.159058570861816,1,1
1991,2,6.895167812294919,6.895167812294918,0.9940120334314904,0.9940120334314897,0,0,9.360651016235352,9.159058570861816,2,2
1991,3,6.675253721004808,6.675253721004808,0.9970799950897848,0.9970799950897864,0,0,9.459344863891602,9.159058570861816,3,3
1991,4,6.475889298425655,6.475889298425655,1.0009515020505826,1.0009515020505848,0,0,9.567412376403809,9.159058570861816,4,4
1991,8,6.05236361867086,6.066881253970967,1.0163602625949677,1.0168130059520806,1,1,11.015410423278809,9.159058570861816,7,7
1991,16,5.4508594684588765,5.55079168197527,1.0265440847705105,1.0278739459199113,2,3,11.575571060180664,9.159058570861816,14,13
1991,32,4.525156398189303,5.314778663715298,1.0236062990451125,1.0315240600724054,12,18,12.367599487304688,9.159058570861816,20,14
1991,64,3.2763561267259504,5.3042727125899995,1.0134061353835147,1.0327975355176844,31,50,13.074841499328613,9.159058570861816,33,14
1991,128,1.910652672021489,5.271288947643124,1.0063003634214023,1.0353383375775236,55,111,13.816788673400879,9.159058570861816,73,17
1992,1,6.287422499324243,6.287422499324212,0.9763514524659458,0.9763514524659475,0,0,6.328403949737549,6.328403949737549,1,1
1992,2,5.666964857828409,5.66696485782841,0.9888142761631447,0.9888142761631458,0,0,7.032787799835205,6.328403949737549,2,2
1992,3,5.650511307038724,5.650511307038724,0.9892418753144678,0.9892418753144685,0,0,7.203418254852295,6.328403949737549,3,3
1992,4,5.628928528570589,5.628928528570589,0.9896839643705322,0.9896839643705333,0,0,7.342957973480225,6.328403949737549,4,4
1992,8,5.265425832858236,5.369577484808054,0.9950394206156746,0.9958099497916912,2,3,7.913303852081299,6.328403949737549,6,5
1992,16,4.8151492918414185,5.1811674215610815,0.9956117679141192,1.0000639965984348,7,8,8.5670804977417,6.328403949737549,9,8
1992,32,3.5344754258178095,4.921426335158601,1.0060760435840939,1.0066262523772909,13,23,9.057528495788574,6.328403949737549,19,9
1992,64,2.8131401229556383,4.693211411529871,1.0020817079380369,1.0147928007225278,33,50,9.52706241607666,6.328403949737549,31,14
1992,128,1.360224614875403,4.34004944619452,1.0024896514667607,1.021994563714063,65,115,10.157538414001465,6.328403949737549,63,13
1993,1,5.333767872016702,5.333767872016705,0.983362563208211,0.9833625632082124,0,0,5.358297348022461,5.358297348022461,1,1
1993,2,4.690946884624056,4.690946884624056,0.9928161596837055,0.9928161596837061,0,0,5.456275463104248,5.358297348022461,2,2
1993,3,4.662817613898938,4.662817613898939,0.9935095520269936,0.993509552026994,0,0,5.506258010864258,5.358297348022461,3,3
1993,4,4.662744184931952,4.662744184931954,0.9935293829711491,0.9935293829711497,0,0,5.752684116363525,5.358297348022461,4,4
1993,8,4.512457385237849,4.565605568033628,0.9968142145946259,0.9959371179028071,2,3,6.035243034362793,5.358297348022461,6,5
1993,16,3.4568898959625263,3.856509755784474,1.0073629110931859,1.0046352369746852,6,9,6.422505855560303,5.358297348022461,10,7
1993,32,2.6049577434799622,3.8141633613399946,1.001478627953003,1.0055676391192674,12,26,7.047829627990723,5.358297348022461,20,6
1993,64,1.8440790003812448,3.781037318760521,1.0020611395684913,1.0074022901898583,33,55,7.714696884155273,5.358297348022461,31,9
1993,128,0.7434876067230394,3.74241948444858,1.0006642245696478,1.009642488179311,57,117,8.402107238769531,5.358297348022461,71,11
1994,1,3.919070255759086,3.9190702557590877,0.9877574543068363,0.9877574543068383,0,0,3.937432289123535,3.937432289123535,1,1
1994,2,3.6263979425629893,3.6263979425629898,0.9909599076126427,0.9909599076126443,0,0,4.044467926025391,3.937432289123535,2,2
1994,3,3.5390198538121247,3.539019853812125,0.9915627197830834,0.9915627197830845,0,0,4.191016674041748,3.937432289123535,3,3
1994,4,3.3913662106342914,3.3913662106342923,0.9928345676352563,0.9928345676352579,0,0,4.239447593688965,3.937432289123535,4,4
1994,8,3.1579113294349264,3.2161478945374693,0.992942888273989,0.9933713832573663,2,2,4.472222805023193,3.937432289123535,6,6
1994,16,2.9547959107199606,3.048156156009957,0.9960786671578558,0.9954509119621531,5,8,4.670718669891357,3.937432289123535,11,8
1994,32,2.338351063214801,3.004043286403305,0.9976754182010646,0.9969974506116528,14,23,4.918854713439941,3.937432289123535,18,9
1994,64,1.410527866159576,2.8919767715347313,0.9996439785385944,0.9989671810640003,29,54,5.119532108306885,3.937432289123535,35,10
1994,128,0.5243573657532627,2.8288859177652466,0.999469361889278,1.000073602696584,64,115,5.492826461791992,3.937432289123535,64,13
1995,1,9.106898130140884,9.10689813014089,0.9537861794651435,0.9537861794651452,0,0,9.207046508789062,9.207046508789062,1,1
1995,2,8.622039845518161,8.622039845518163,0.9673485788318856,0.967348578831887,0,0,10.464726448059082,9.207046508789062,2,2
1995,3,7.9833552898690625,7.983355289869063,0.9819271227368862,0.9819271227368871,0,0,10.579885482788086,9.207046508789062,3,3
1995,4,7.119745128780926,7.125714422003744,0.9999824610815101,1.0000050747660387,1,1,10.592754364013672,9.207046508789062,3,3
1995,8,6.374397330287945,6.42142871277382,1.016406630460549,1.016182995128008,2,2,11.015498161315918,9.207046508789062,6,6
1995,16,6.077418511456181,6.35978088682049,1.0171696658333194,1.01966510274433,6,7,12.06740665435791,9.207046508789062,10,9
1995,32,4.928349338609629,5.8325344156156795,1.0303704287096238,1.038194063299139,13,20,12.917383193969727,9.207046508789062,19,12
1995,64,3.7063352723157714,5.82505410990405,1.014060985217614,1.0397561385260037,32,50,13.638517379760742,9.207046508789062,32,14
1995,128,2.1841385959544164,5.806340101829928,1.0019528530485189,1.0429720216232556,62,112,14.579449653625488,9.207046508789062,66,16
1996,1,7.741418972616275,7.741418972616277,0.9681955293451022,0.9681955293451027,0,0,7.798842430114746,7.798842430114746,1,1
1996,2,6.548758771648719,6.5487587716487194,0.9916265609822806,0.9916265609822801,0,0,8.898162841796875,7.798842430114746,2,2
1996,3,5.918715082486162,5.918715082486158,1.0023896813009623,1.002389681300961,0,0,9.046765327453613,7.798842430114746,3,3
1996,4,5.917681286481776,5.917681286481776,1.002580387946946,1.002580387946946,0,0,9.271956443786621,7.798842430114746,4,4
1996,8,5.142924489779848,5.2820535447554295,1.0122545845263526,1.0122256284913491,1,1,10.031293869018555,7.798842430114746,7,7
1996,16,4.735541376323017,4.933962243614419,1.0188809765541817,1.0193414312999736,5,6,10.361114501953125,7.798842430114746,11,10
1996,32,3.878178168635308,4.881701560736237,1.014522301271884,1.0218095387616524,12,21,10.774970054626465,7.798842430114746,20,11
1996,64,2.9616331268018334,4.835938046592176,1.0075086023397042,1.0248890629833065,27,49,11.506878852844238,7.798842430114746,37,15
1996,128,1.8130929089533587,4.771522143715523,1.0017095073114062,1.0283743647484913,64,111,12.373546600341797,7.798842430114746,64,17
1997,1,8.153674589260852,8.153674589260852,0.9594947727001589,0.9594947727001587,0,0,8.24414348602295,8.24414348602295,1,1
1997,2,6.013746983194895,6.013746983194895,0.9953045091604378,0.995304509160437,0,0,8.370345115661621,8.24414348602295,2,2
1997,3,5.840556996666849,5.840556996666849,0.9990220145307128,0.9990220145307118,0,0,9.190516471862793,8.24414348602295,3,3
1997,4,5.437394922296238,5.43739492229624,1.0078146709005187,1.0078146709005178,0,0,9.259787559509277,8.24414348602295,4,4
1997,8,5.2833494149563895,5.2972662365822405,1.0111019957834004,1.011536547259827,1,1,9.541800498962402,8.24414348602295,7,7
1997,16,4.729043197595229,5.165588919531345,1.0149232367220042,1.0152763505251918,6,7,9.98110580444336,8.24414348602295,10,9
1997,32,4.2797965882840225,5.110152197775323,1.0190004502881185,1.017389779117457,16,22,10.392572402954102,8.24414348602295,16,10
1997,64,3.1639626849904685,4.900326721321268,1.015973345394939,1.0274416788505636,29,50,11.028669357299805,8.24414348602295,35,14
1997,128,1.771855931382788,4.862770586584378,1.0033141421262197,1.0296193089293109,63,109,11.633599281311035,8.24414348602295,65,19
1998,1,6.806828775052646,6.806828775052646,0.9777352312878825,0.9777352312878846,0,0,6.839831352233887,6.839831352233887,1,1
1998,2,5.650858109550857,5.6508581095508585,0.9950260050845148,0.9950260050845168,0,0,6.879640579223633,6.839831352233887,2,2
1998,3,4.951154291833243,4.951154291833242,1.0032756359006025,1.0032756359006039,0,0,6.8866119384765625,6.839831352233887,3,3
1998,4,4.79793507329758,4.7979350732975785,1.0050692405185249,1.005069240518526,0,0,7.214254379272461,6.839831352233887,4,4
1998,8,4.381810514875192,4.381810514875191,1.0115295387077055,1.0115295387077068,0,0,7.555844783782959,6.839831352233887,8,8
1998,16,3.754515598704824,3.9494665582567188,1.017882187817651,1.0164988635167338,6,7,8.0344877243042,6.839831352233887,10,9
1998,32,2.7543895465518493,3.7644012737548387,1.014283376548143,1.0204148495792156,12,17,8.63589859008789,6.839831352233887,20,15
1998,64,1.8864954585166092,3.6887255383395003,1.004665212145517,1.0232463160764782,32,45,9.14547061920166,6.839831352233887,32,19
1998,128,0.9911178764536059,3.6188357660426234,1.0019777405900427,1.0256773894027866,55,105,9.7568941116333,6.839831352233887,73,23
1999,1,9.085060348218772,9.085060348218775,0.9644845248953867,0.9644845248953886,0,0,9.146973609924316,9.146973609924316,1,1
1999,2,7.88070564801222,7.880705648012221,0.9866451724666755,0.9866451724666767,0,0,9.163973808288574,9.146973609924316,2,2
1999,3,7.644745672092802,7.644745672092802,0.989347419876992,0.9893474198769926,0,0,9.495680809020996,9.146973609924316,3,3
1999,4,7.2964997067515185,7.2964997067515185,0.9936106865102632,0.9936106865102641,0,0,9.573019981384277,9.146973609924316,4,4
1999,8,6.502527141117675,6.502527141117675,1.0097405244654425,1.0097405244654434,0,0,9.966809272766113,9.146973609924316,8,8
1999,16,5.591413182073811,5.8966452710739725,1.024778080144174,1.0216814455653682,5,6,10.453351974487305,9.146973609924316,11,10
1999,32,4.941739857245478,5.576729253376327,1.0307081319705755,1.0300366256588689,11,19,11.226653099060059,9.146973609924316,21,13
1999,64,3.1839694032637684,5.320598261026643,1.0095519776718773,1.0382180932487284,33,48,11.885054588317871,9.146973609924316,31,16
1999,128,2.143959476561028,5.267290424956673,1.0079492535407857,1.0406380905837622,59,109,12.464877128601074,9.146973609924316,69,19
2000,1,6.8061149997114505,6.806114999711451,0.9730889727585896,0.9730889727585897,0,0,6.853966236114502,6.853966236114502,1,1
2000,2,6.7063821165900945,6.706382116590094,0.9753422116636434,0.9753422116636425,0,0,7.628528594970703,6.853966236114502,2,2
2000,3,5.718518138452662,5.718518138452662,0.9909205282317839,0.9909205282317826,0,0,7.701082229614258,6.853966236114502,3,3
2000,4,5.407840536663933,5.444795320417401,0.995737258072078,0.995440633207948,1,1,7.893938064575195,6.853966236114502,3,3
2000,8,5.200647622786521,5.356658865478626,0.9973780634834705,0.9968081580235946,2,2,8.29720401763916,6.853966236114502,6,6
2000,16,4.674903337690725,4.7731717054564715,1.0090415348004371,1.0099130914798962,5,7,8.615931510925293,6.853966236114502,11,9
2000,32,3.675288331320378,4.582885273844844,1.0072022998107504,1.011974470595539,13,22,9.160805702209473,6.853966236114502,19,10
2000,64,2.970674740486904,4.550798749569934,1.0038643318557194,1.0128517110131106,29,52,9.646923065185547,6.853966236114502,35,12
2000,128,1.2521462137086619,4.310574731692579,1.0009999058841368,1.0197837912474417,64,112,10.291831970214844,6.853966236114502,64,16
2001,1,13.132179260921198,13.132179260921205,0.8806015070743736,0.8806015070743751,0,0,13.60707950592041,13.60707950592041,1,1
2001,2,11.873080220986015,11.873080220986015,0.9225007078915701,0.9225007078915701,0,0,13.8862943649292,13.60707950592041,2,2
2001,3,10.869487885878144,10.869487885878142,0.9547651037577329,0.9547651037577314,0,0,13.898483276367188,13.60707950592041,3,3
2001,4,10.420535954194941,10.420535954194941,0.974617634352976,0.9746176343529742,0,0,14.017967224121094,13.60707950592041,4,4
2001,8,10.12803016572732,10.13574530267751,0.9830505956853989,0.9831349579749056,1,1,14.722283363342285,13.60707950592041,7,7
2001,16,9.573602796728744,9.623953737179248,1.0095787285327233,1.00571255504304,6,7,14.889430046081543,13.60707950592041,10,9
2001,32,8.262696819837249,9.366046313023336,1.0447999309686256,1.0167260307730785,13,17,15.400435447692871,13.60707950592041,19,15
2001,64,6.88405071757272,8.89230685873508,1.0392270868712945,1.0365315031306443,27,48,15.889303207397461,13.60707950592041,37,16
2001,128,3.78700827078685,8.30771147502222,1.0241356187128394,1.0549770397707035,63,112,16.210214614868164,13.60707950592041,65,16
2002,1,6.286066265827631,6.286066265827631,0.9693379584255405,0.9693379584255408,0,0,6.352914810180664,6.352914810180664,1,1
2002,2,5.3080854183851365,5.3080854183851365,0.9876220335483485,0.9876220335483484,0,0,7.573713302612305,6.352914810180664,2,2
2002,3,5.178866316711273,5.178866316711273,0.992592173900914,0.9925921739009134,0,0,8.205777168273926,6.352914810180664,3,3
2002,4,5.158636496942762,5.158636496942762,0.9937396482205263,0.9937396482205261,0,0,8.278511047363281,6.352914810180664,4,4
2002,8,5.042570091305109,5.048399615076783,0.9968625666937098,0.9969540760528384,3,4,9.125,6.352914810180664,5,4
2002,16,4.4783523987857246,4.899058446672072,1.0026353404379176,1.0031967233830041,5,8,9.471600532531738,6.352914810180664,11,8
2002,32,3.6022709809389286,4.665401092501807,1.007327667155603,1.008614346797318,13,22,9.994497299194336,6.352914810180664,19,10
2002,64,2.9167662854236776,4.403393627267277,1.010402536265615,1.0158822644780163,27,51,10.592259407043457,6.352914810180664,37,13
2002,128,1.4996923922835856,4.330902743598634,1.0012898769698206,1.0186534919044663,55,114,11.156932830810547,6.352914810180664,73,14
2003,1,8.357837655629538,8.357837655629538,0.9566446605480214,0.9566446605480221,0,0,8.460752487182617,8.460752487182617,1,1
2003,2,6.589071274286085,6.589071274286085,0.9861920053406404,0.9861920053406401,0,0,8.49788761138916,8.460752487182617,2,2
2003,3,6.377021724861115,6.377021724861115,0.9926487274290763,0.9926487274290756,0,0,8.840137481689453,8.460752487182617,3,3
2003,4,6.1095138778464735,6.109513877846473,0.9981282633342445,0.9981282633342439,0,0,9.00075626373291,8.460752487182617,4,4
2003,8,5.283025428268408,5.335830014231171,1.0140456462861305,1.013620772073867,2,2,9.358973503112793,8.460752487182617,6,6
2003,16,4.748948541410349,5.180469816036607,1.0124556292690374,1.0151998889720328,7,6,10.180367469787598,8.460752487182617,9,10
2003,32,4.076117994828664,5.053431030948817,1.0105806552971195,1.0202112527946827,15,20,10.742274284362793,8.460752487182617,17,12
2003,64,2.707782289719369,4.948009786537349,1.0091195451379538,1.0251901024177363,30,49,11.313992500305176,8.460752487182617,34,15
2003,128,1.7180954952512175,4.880602729330459,1.0032908985246733,1.0275681970078432,60,113,12.013463020324707,8.460752487182617,68,15
2004,1,10.309791215115968,10.309791215115975,0.9414117311205495,0.9414117311205522,0,0,10.454093933105469,10.454093933105469,1,1
2004,2,8.452394687508585,8.452394687508585,0.9840041273457238,0.9840041273457256,0,0,11.49316692352295,10.454093933105469,2,2
2004,3,8.44084119727672,8.44084119727672,0.984880901738914,0.9848809017389153,0,0,11.69737720489502,10.454093933105469,3,3
2004,4,8.30625407494686,8.306254074946862,0.9879907087923127,0.9879907087923143,0,0,12.501015663146973,10.454093933105469,4,4
2004,8,7.2520781937433645,7.354536641231718,1.012207556686139,1.011320441143422,1,2,13.033735275268555,10.454093933105469,7,6
2004,16,6.760662012318859,7.187502531180275,1.0178994144738365,1.0187497508502235,6,7,13.269160270690918,10.454093933105469,10,9
2004,32,6.150787902872682,7.133419429304462,1.0153698784239629,1.0209036788026715,13,22,13.710002899169922,10.454093933105469,19,10
2004,64,5.4537406971251805,6.940901140250607,1.0211856034845006,1.0261277248932024,31,51,14.156289100646973,10.454093933105469,33,13
2004,128,3.0865127847808016,6.861692697706842,1.0034908281282617,1.029276068806859,62,115,14.55244255065918,10.454093933105469,66,13
2005,1,11.37781294348732,11.377812943487328,0.9122113492003775,0.9122113492003797,0,0,11.676456451416016,11.676456451416016,1,1
2005,2,9.783844719057075,9.783844719057075,0.9533450432821751,0.9533450432821761,0,0,11.736421585083008,11.676456451416016,2,2
2005,3,9.205975501586261,9.205975501586263,0.9699722711755909,0.9699722711755923,0,0,12.080759048461914,11.676456451416016,3,3
2005,4,9.05899811103802,9.05899811103802,0.974339669420579,0.9743396694205805,0,0,12.254852294921875,11.676456451416016,4,4
2005,8,8.432243633567573,8.432271623769442,0.9916326117477401,0.9916538033468869,1,1,12.867817878723145,11.676456451416016,7,7
2005,16,7.8033300889928485,8.21161437372042,1.0061880304421957,1.0014209563697651,3,5,13.865350723266602,11.676456451416016,13,11
2005,32,6.9712256391768985,7.916259970786092,1.0185214556914617,1.0145296272657032,15,21,14.572366714477539,11.676456451416016,17,11
2005,64,5.484982105289148,7.898141388474703,1.0183307919199849,1.0168651029728202,28,52,15.48497200012207,11.676456451416016,36,12
2005,128,3.1878350610364405,7.779655213666559,1.0081889608702836,1.029269872347162,61,112,16.20743751525879,11.676456451416016,67,16
2006,1,8.38278133961785,8.38278133961785,0.9549667476691451,0.9549667476691452,0,0,8.492425918579102,8.492425918579102,1,1
2006,2,6.439733135120799,6.4397331351207985,0.9883163907003705,0.9883163907003696,0,0,9.138020515441895,8.492425918579102,2,2
2006,3,6.36439887258935,6.364398872589348,0.9911156723693813,0.9911156723693795,0,0,9.48698616027832,8.492425918579102,3,3
2006,4,6.360684155091783,6.364398872589348,0.9906356727286454,0.9911156723693795,1,1,10.15506649017334,8.492425918579102,3,3
2006,8,5.571963990637669,5.8140325392542,1.003843656696684,1.0061381618500327,2,3,10.773574829101562,8.492425918579102,6,5
2006,16,4.960979644847856,5.448535288892417,1.0160489026263193,1.0191234178782285,5,7,11.470712661743164,8.492425918579102,11,9
2006,32,4.264770331758416,5.206468307768219,1.0070562539045378,1.0210180982687753,14,25,12.18166446685791,8.492425918579102,18,7
2006,64,3.395069872489512,5.202768787461574,1.0020472318196512,1.0220895972817927,33,56,12.862608909606934,8.492425918579102,31,8
2006,128,2.2176764462420384,5.086809083338341,1.0031229150301577,1.0305272987356902,65,118,13.700684547424316,8.492425918579102,63,10
2007,1,7.795280862139411,7.795280862139414,0.9683385995063054,0.9683385995063074,0,0,7.853189945220947,7.853189945220947,1,1
2007,2,6.190412167132907,6.190412167132908,0.9923586278034693,0.9923586278034708,0,0,8.237544059753418,7.853189945220947,2,2
2007,3,5.546272247102638,5.546272247102638,1.001985263693079,1.0019852636930802,0,0,8.534451484680176,7.853189945220947,3,3
2007,4,5.5335787437074275,5.533578743707427,1.0023431308415074,1.0023431308415085,0,0,8.734196662902832,7.853189945220947,4,4
2007,8,5.3433858630963815,5.533409118220449,1.0018930385462181,1.0023805145111875,3,3,9.232305526733398,7.853189945220947,5,5
2007,16,4.977458317647274,5.4021518746078945,1.0083606114889934,1.005736371361098,6,8,9.454833030700684,7.853189945220947,10,8
2007,32,4.319408025278885,5.217530694913745,1.0130470219322882,1.0111841443618237,15,21,9.928672790527344,7.853189945220947,17,11
2007,64,3.260113027195384,5.003734174270186,1.015756649637847,1.0209558533594612,31,51,10.735394477844238,7.853189945220947,33,13
2007,128,1.720862396965158,4.818124045744845,1.0047114139665227,1.0285209462349252,59,110,11.5554780960083,7.853189945220947,69,18
2008,1,6.938196825296655,6.938196825296658,0.974947528835666,0.9749475288356684,0,0,6.979219436645508,6.979219436645508,1,1
2008,2,4.900474767016854,4.900474767016861,1.007300321479022,1.007300321479024,0,0,7.599507808685303,6.979219436645508,2,2
2008,3,4.813211265700897,4.813211265700895,1.0079069723983884,1.0079069723983902,0,0,8.168644905090332,6.979219436645508,3,3
2008,4,4.452671934572091,4.452671934572098,1.0151199889862415,1.0151199889862434,0,0,8.663790702819824,6.979219436645508,4,4
2008,8,4.37220592559229,4.412083596895307,1.016527845468011,1.017059939181248,2,2,9.44008731842041,6.979219436645508,6,6
2008,16,4.085454285742418,4.391031039834736,1.019561916133974,1.018176826489729,5,8,9.95434856414795,6.979219436645508,11,8
2008,32,3.3883746606890472,4.3632613866115655,1.0176889419026176,1.020386097567757,15,22,10.407909393310547,6.979219436645508,17,10
2008,64,2.7339432945683133,4.247147795217574,1.0135362410524142,1.0262448097936587,27,53,10.933887481689453,6.979219436645508,37,11
2008,128,1.70999305587328,4.2144275976292525,1.0061353068528889,1.0275791436491313,63,111,11.664826393127441,6.979219436645508,65,17
2009,1,12.197206183641391,12.197206183641391,0.9003261119046343,0.9003261119046349,0,0,12.546483039855957,12.546483039855957,1,1
2009,2,10.516474831129251,10.516474831129253,0.9455189080166306,0.9455189080166306,0,0,12.560101509094238,12.546483039855957,2,2
2009,3,7.905275918468094,7.905275918468097,1.012904281773145,1.0129042817731413,0,0,12.61107063293457,12.546483039855957,3,3
2009,4,7.769297762420839,7.769297762420842,1.0174626969497993,1.0174626969497953,0,0,13.220205307006836,12.546483039855957,4,4
2009,8,7.694129292657,7.717874524327471,1.0192201586223821,1.0204483137409128,2,2,14.249456405639648,12.546483039855957,6,6
2009,16,7.3071745380659,7.655749470255209,1.0280521514267473,1.0263418301952758,4,6,14.994997024536133,12.546483039855957,12,10
2009,32,6.852908715071217,7.643849006843109,1.0202714031454336,1.0277019158719367,14,20,15.414159774780273,12.546483039855957,18,12
2009,64,5.658035078606031,7.521272890938828,1.0229312687675187,1.0351728822417399,31,54,16.006866455078125,12.546483039855957,33,10
2009,128,3.5251829491045688,7.468571138078585,1.0146612500729686,1.0386311699096482,64,115,16.480350494384766,12.546483039855957,64,13
2010,1,2.7322496759932604,2.732249675993261,0.9946936137145772,0.9946936137145781,0,0,2.7372028827667236,2.7372028827667236,1,1
2010,2,2.144226395661398,2.1442263956613985,0.9977568934528416,0.997756893452842,0,0,2.746441125869751,2.7372028827667236,2,2
2010,3,1.504110109705683,1.504110109705683,1.0002207701918489,1.0002207701918484,0,0,2.8874268531799316,2.7372028827667236,3,3
2010,4,1.503088383789039,1.5030883837890405,1.0002424231425204,1.0002424231425213,0,0,2.932645559310913,2.7372028827667236,4,4
2010,8,1.4845993557029982,1.49438968444484,1.0004449005502658,1.000533015995734,1,1,4.032373905181885,2.7372028827667236,7,7
2010,16,1.2830188210117963,1.4476337427518982,1.000314989428489,1.0013055752341966,7,10,4.707304954528809,2.7372028827667236,9,6
2010,32,0.7771025349309801,1.3532928007874525,1.0003479825283232,1.0031647809674007,17,24,5.50360107421875,2.7372028827667236,15,8
2010,64,0.5012393756872002,1.3494656212073053,1.0003639894233223,1.003418574784238,32,55,6.337873458862305,2.7372028827667236,32,9
2010,128,0.060722346548507056,1.3196995104340177,1.000015519101134,1.0042519509192536,63,117,7.178234100341797,2.7372028827667236,65,11
2011,1,9.021904524093637,9.021904524093625,0.9603316983741245,0.9603316983741262,0,0,9.100637435913086,9.100637435913086,1,1
2011,2,7.639832584125304,7.639832584125306,0.9811086390563748,0.9811086390563768,0,0,9.180026054382324,9.100637435913086,2,2
2011,3,6.143548905127423,6.143548905127423,1.005760640201963,1.0057606402019643,0,0,9.379961967468262,9.100637435913086,3,3
2011,4,6.114099740331194,6.114099740331194,1.0062315755213054,1.0062315755213067,0,0,9.38696002960205,9.100637435913086,4,4
2011,8,5.803603488354935,5.803603488354935,1.015511831045163,1.0155118310451638,0,0,10.089202880859375,9.100637435913086,8,8
2011,16,5.6250768237642585,5.715474186091339,1.0178565306320297,1.0189349075823804,2,3,10.932149887084961,9.100637435913086,14,13
2011,32,4.726903584900325,5.533914161454022,1.0191462858098952,1.025617792222679,13,19,11.615785598754883,9.100637435913086,19,13
2011,64,3.551577567933129,5.452955046548049,1.0009955614610053,1.0300362595454922,33,50,12.546427726745605,9.100637435913086,31,14
2011,128,1.9644822269961622,5.351713133975673,1.0019105953933005,1.0352847739973916,67,108,13.170827865600586,9.100637435913086,61,20
2012,1,6.818057236363282,6.818057236363281,0.9689892934582409,0.9689892934582405,0,0,6.883188247680664,6.883188247680664,1,1
2012,2,5.1017944027497135,5.101794402749714,0.9946144395223591,0.9946144395223585,0,0,7.2483625411987305,6.883188247680664,2,2
2012,3,4.777746605305946,4.777746605305946,0.9991065509699597,0.9991065509699587,0,0,7.46139669418335,6.883188247680664,3,3
2012,4,4.26293796117114,4.263371523982587,1.0048908364226188,1.004899422835297,1,1,7.474812030792236,6.883188247680664,3,3
2012,8,4.036575890103165,4.053780587794432,1.009081896770235,1.0090291172420143,1,1,7.723198413848877,6.883188247680664,7,7
2012,16,3.6725364956482682,3.73549180990013,1.013032079954341,1.0132576304905687,5,7,8.01867961883545,6.883188247680664,11,9
2012,32,3.374073051245996,3.6537933707794026,1.0136873977112488,1.0159690647090152,15,18,8.48153018951416,6.883188247680664,17,14
2012,64,2.3275713467536514,3.580493066765677,1.0070611130729148,1.0178356311895969,23,48,9.222182273864746,6.883188247680664,41,16
2012,128,1.3844139798650272,3.569142052148163,1.0023331191044753,1.0189496137765595,64,111,10.00165843963623,6.883188247680664,64,17
2013,1,3.2461529703855123,3.2461529703855145,0.9928660633910453,0.9928660633910472,0,0,3.253667116165161,3.253667116165161,1,1
2013,2,2.5262473655660287,2.5262473655660296,0.9972535602150795,0.9972535602150805,0,0,3.268667697906494,3.253667116165161,2,2
2013,3,2.313995365718269,2.3139953657182692,0.9986432752695986,0.9986432752695997,0,0,3.354163408279419,3.253667116165161,3,3
2013,4,2.036828674575966,2.036828674575966,0.9995143081901678,0.9995143081901691,0,0,3.58893084526062,3.253667116165161,4,4
2013,8,1.8781665064877016,1.8835299421409373,1.000422308305269,1.000409837614895,2,2,3.670180082321167,3.253667116165161,6,6
2013,16,1.4629407164525514,1.6027505631356285,1.0020053775578792,1.001712182665059,5,5,3.863884449005127,3.253667116165161,11,11
2013,32,1.1031714016115055,1.3358609488293645,1.0028892300809689,1.003842000731465,11,18,4.209761619567871,3.253667116165161,21,14
2013,64,0.4254188911530504,1.2792408897965484,1.0004034871933207,1.0044058558286721,29,47,4.860316753387451,3.253667116165161,35,17
2013,128,0.034176699947048514,1.2649321082111453,1.0000439338113354,1.0049644711634558,66,111,5.432600975036621,3.253667116165161,62,17
2014,1,4.930297205858385,4.930297205858385,0.9867166241461108,0.9867166241461108,0,0,4.9465837478637695,4.9465837478637695,1,1
2014,2,3.8753124860901975,3.875312486090198,0.9994505023581015,0.9994505023581011,0,0,5.680953502655029,4.9465837478637695,2,2
2014,3,3.7258762574444724,3.725876257444473,1.0017931328445229,1.0017931328445222,0,0,5.7447686195373535,4.9465837478637695,3,3
2014,4,3.4546386472433737,3.454638647243373,1.0048805132689502,1.0048805132689504,0,0,5.802025318145752,4.9465837478637695,4,4
2014,8,3.101441959684796,3.101441959684795,1.009352142085676,1.0093521420856764,0,0,6.826921463012695,4.9465837478637695,8,8
2014,16,2.7595198559204315,2.8793598820189765,1.011598473143454,1.0135409403667888,3,4,7.429261207580566,4.9465837478637695,13,12
2014,32,2.2156797723202635,2.7820912184304345,1.00929152837702,1.0152694342373052,12,19,7.765906810760498,4.9465837478637695,20,13
2014,64,1.5627405691284257,2.770463370097789,1.003779575933884,1.0155458575310972,29,49,8.311605453491211,4.9465837478637695,35,15
2014,128,0.8991366803170339,2.7330548050381984,1.0003944522254642,1.0163785226026012,63,112,8.986656188964844,4.9465837478637695,65,16
2015,1,3.007477997061953,3.007477997061953,0.9919434198027823,0.9919434198027823,0,0,3.017869472503662,3.017869472503662,1,1
2015,2,2.637666716100169,2.6376667161001683,0.9966755328653276,0.9966755328653272,0,0,3.118053913116455,3.017869472503662,2,2
2015,3,2.613798158999495,2.6137981589994945,0.9969858550791268,0.9969858550791263,0,0,3.3840718269348145,3.017869472503662,3,3
2015,4,2.3603522180451084,2.3603522180451084,0.9997862561920285,0.999786256192028,0,0,3.4164774417877197,3.017869472503662,4,4
2015,8,1.9125395094925253,1.9128189251945864,1.0014473215969268,1.001477136332599,2,2,3.6136252880096436,3.017869472503662,6,6
2015,16,1.6079245282206012,1.8441612802026002,1.0007784188694673,1.0026680405717385,6,7,4.032191276550293,3.017869472503662,10,9
2015,32,1.1756944313031032,1.6271203587549739,1.0026434767692105,1.00438672509716,12,18,4.494792938232422,3.017869472503662,20,14
2015,64,0.674379968492795,1.573236851839748,0.9996037988994793,1.0048240683703238,29,51,4.980128765106201,3.017869472503662,35,13
2015,128,0.060115421871892255,1.5509706554673717,0.9999879723852525,1.0056682361241467,61,115,5.630665302276611,3.017869472503662,67,13
2016,1,11.490801429037509,11.490801429037509,0.9143725630396621,0.9143725630396642,0,0,11.779377937316895,11.779377937316895,1,1
2016,2,9.310336138225821,9.310336138225821,0.9786544625549074,0.9786544625549072,0,0,11.927592277526855,11.779377937316895,2,2
2016,3,8.831341534869976,8.831341534869976,0.9874977056854197,0.9874977056854195,0,0,12.033635139465332,11.779377937316895,3,3
2016,4,8.823430536631422,8.823430536631422,0.987780588869824,0.9877805888698239,0,0,12.035144805908203,11.779377937316895,4,4
2016,8,8.067838376815695,8.125880009769817,1.0060577605813394,1.005298783446149,3,4,13.164535522460938,11.779377937316895,5,4
2016,16,7.335340229706323,7.5958364886259595,1.0261350704763705,1.0215270803880483,5,7,13.689484596252441,11.779377937316895,11,9
2016,32,6.72307232137031,7.556445563793386,1.0331643487156383,1.0237488549191753,15,22,13.957192420959473,11.779377937316895,17,10
2016,64,4.8147297479697615,7.443619933092883,1.024611664697742,1.0311637737277852,30,50,14.298273086547852,11.779377937316895,34,14
2016,128,3.3273242507482506,7.324325968046828,1.0137623361698818,1.033641231048796,66,113,14.6224946975708,11.779377937316895,62,15
2017,1,3.1454004307350303,3.1454004307350316,0.9963285614899287,0.9963285614899312,0,0,3.147460699081421,3.147460699081421,1,1
2017,2,2.716687014195775,2.716687014195776,0.9993256425947982,0.9993256425948003,0,0,3.300466775894165,3.147460699081421,2,2
2017,3,2.5168796823093604,2.51687968230936,1.0010254157322933,1.0010254157322946,0,0,3.463520050048828,3.147460699081421,3,3
2017,4,2.5015631420171975,2.5015631420171967,1.0011849222136424,1.001184922213646,0,0,3.9039406776428223,3.147460699081421,4,4
2017,8,2.310282035361538,2.3683804935955064,1.0021855491031086,1.0020622764872895,2,2,4.12453556060791,3.147460699081421,6,6
2017,16,1.8625269169838068,2.2591465757172586,1.0027543235301541,1.0032177053911866,6,6,4.430311679840088,3.147460699081421,10,10
2017,32,1.0397454196652578,2.228760644298673,1.0002331853575495,1.0032975689428758,14,21,4.7281999588012695,3.147460699081421,18,11
2017,64,0.5923472691651435,2.217670218978275,0.9994958799706888,1.0038045325518485,29,51,5.0603461265563965,3.147460699081421,35,13
2017,128,0.048072132817822404,2.17556178212817,1.0000187307989354,1.005006817431261,62,115,5.532662868499756,3.147460699081421,66,13
2018,1,6.8415086521928,6.841508652192803,0.9693440183455492,0.96934401834555,0,0,6.906313419342041,6.906313419342041,1,1
2018,2,6.478121825782975,6.478121825782974,0.9759766021135818,0.9759766021135816,0,0,7.521960735321045,6.906313419342041,2,2
2018,3,6.301457661843195,6.301457661843195,0.9795896644097972,0.9795896644097972,0,0,7.786484241485596,6.906313419342041,3,3
2018,4,6.170046899245011,6.170046899245011,0.9822447408664038,0.9822447408664036,0,0,8.073925971984863,6.906313419342041,4,4
2018,8,5.8968234215977215,5.910894391534478,0.9864135766327764,0.9868771449576735,2,2,8.710065841674805,6.906313419342041,6,6
2018,16,5.338221382612731,5.898403631270811,0.9882415932502705,0.9877402847541986,6,9,9.071537017822266,6.906313419342041,10,7
2018,32,4.229494947222165,5.611131789993994,0.99682503503968,0.9963340769492594,13,26,9.554319381713867,6.906313419342041,19,6
2018,64,2.880666877502157,5.308891263249571,1.0005939290514374,1.0036024979144587,28,54,9.973402976989746,6.906313419342041,36,10
2018,128,1.7753693887318658,5.278470132564615,0.9971621085830087,1.0048789349801235,67,118,10.371089935302734,6.906313419342041,61,10
2019,1,5.827237960181992,5.827237960181992,0.9820777116456577,0.9820777116456577,0,0,5.8523993492126465,5.8523993492126465,1,1
2019,2,5.053219175593546,5.053219175593545,0.9936882189187812,0.9936882189187808,0,0,6.503077030181885,5.8523993492126465,2,2
2019,3,4.61870493917219,4.618704939172189,0.9983761828742337,0.9983761828742342,0,0,6.83023738861084,5.8523993492126465,3,3
2019,4,4.527719087652973,4.527719087652973,1.0005996512842856,1.000599651284286,0,0,7.19370174407959,5.8523993492126465,4,4
2019,8,3.83102427166876,3.83102427166876,1.013029454238121,1.0130294542381197,0,0,7.372006416320801,5.8523993492126465,8,8
2019,16,3.121332424295438,3.751677827557378,1.0128921544532747,1.0142499982229842,5,6,8.022913932800293,5.8523993492126465,11,10
2019,32,2.645856439984461,3.51422941827385,1.011093296119136,1.0166476637245077,13,20,8.564406394958496,5.8523993492126465,19,12
2019,64,1.6986434135516644,3.458229513948445,1.0063293452845725,1.0186349436659068,25,50,9.277423858642578,5.8523993492126465,39,14
2019,128,0.8494308204279022,3.365774938971065,1.0019950679141592,1.0209258983048484,62,112,9.889981269836426,5.8523993492126465,66,16
2020,1,9.069728724569828,9.06972872456983,0.9587426716444803,0.9587426716444809,0,0,9.150652885437012,9.150652885437012,1,1
2020,2,7.129851311252705,7.1298513112527075,0.9890909543373256,0.9890909543373256,0,0,9.218456268310547,9.150652885437012,2,2
2020,3,6.5656954692282685,6.565695469228267,0.9986160025659595,0.9986160025659583,0,0,9.239494323730469,9.150652885437012,3,3
2020,4,5.897932542156755,5.897932542156756,1.005247989813507,1.0052479898135056,0,0,9.263444900512695,9.150652885437012,4,4
2020,8,5.357585327116989,5.37272415395089,1.0140457856422502,1.0132990756982068,1,2,9.676572799682617,9.150652885437012,7,6
2020,16,4.881066976151123,5.241680773873753,1.018405341718899,1.017608171326771,4,5,10.304588317871094,9.150652885437012,12,11
2020,32,4.217324927176463,5.2106301022510735,1.0205990629185318,1.0191706974671106,12,20,10.7220458984375,9.150652885437012,20,12
2020,64,3.3952206174964865,5.1338216734850075,1.0092918987385135,1.025656657157385,29,47,11.504923820495605,9.150652885437012,35,17
2020,128,2.1905706068182837,5.039943646637466,1.007307344907197,1.0298041508285145,57,109,12.067692756652832,9.150652885437012,71,19
2021,1,9.097189166977492,9.097189166977493,0.9478689658844446,0.9478689658844457,0,0,9.230208396911621,9.230208396911621,1,1
2021,2,8.097360861699407,8.097360861699409,0.9722824352789745,0.9722824352789747,0,0,10.181585311889648,9.230208396911621,2,2
2021,3,7.497998970448615,7.4979989704486165,0.9878805681477996,0.9878805681478011,0,0,10.404035568237305,9.230208396911621,3,3
2021,4,6.8054349650425765,6.805434965042577,0.9993680687477366,0.9993680687477378,0,0,10.595458030700684,9.230208396911621,4,4
2021,8,6.037045177876499,6.05725798513253,1.0157149034079276,1.0166360230383849,2,2,11.399545669555664,9.230208396911621,6,6
2021,16,5.680072966015358,5.846534257592835,1.020252267128988,1.023694359628896,6,9,11.85036849975586,9.230208396911621,10,7
2021,32,4.979774558078086,5.792273435564679,1.0190523298297438,1.0270853137695175,12,21,12.412572860717773,9.230208396911621,20,11
2021,64,3.6689862806305165,5.7788877548691495,1.0103366120930926,1.029194667716152,26,52,13.118335723876953,9.230208396911621,38,12
2021,128,2.0790198921350163,5.57596277742058,1.0064831906479272,1.0378360850072759,66,113,13.721453666687012,9.230208396911621,62,15
2022,1,7.597692392635592,7.597692392635549,0.9659057892176975,0.9659057892176983,0,0,7.66752290725708,7.66752290725708,1,1
2022,2,6.2234111572782025,6.2234111572782025,0.9891235930636879,0.9891235930636877,0,0,7.803215980529785,7.66752290725708,2,2
2022,3,5.826840183613051,5.82684018361305,0.994684365155991,0.9946843651559902,0,0,7.856071472167969,7.66752290725708,3,3
2022,4,5.662103784511779,5.662103784511779,0.9972312158186342,0.9972312158186338,0,0,7.926187515258789,7.66752290725708,4,4
2022,8,4.9828617866699245,4.985479792434734,1.0076432166642442,1.0077261507682729,1,1,8.364802360534668,7.66752290725708,7,7
2022,16,4.66401982741231,4.77176652280279,1.010530826118584,1.0114131202375751,5,6,8.815434455871582,7.66752290725708,11,10
2022,32,4.029180593632397,4.663615423158672,1.0114745586069018,1.014493967735313,16,20,9.477323532104492,7.66752290725708,16,12
2022,64,2.7126792680024927,4.440249590882972,1.0106453639974406,1.0212103449095702,30,49,10.040627479553223,7.66752290725708,34,15
2022,128,1.333174678597078,4.408107650855938,1.00361015552778,1.0223522929212723,59,111,10.674595832824707,7.66752290725708,69,17
2023,1,10.69209415358926,10.692094153589265,0.916470542384146,0.9164705423841475,0,0,10.973638534545898,10.973638534545898,1,1
2023,2,9.682055547496535,9.682055547496539,0.944794554995637,0.9447945549956385,0,0,10.98846435546875,10.973638534545898,2,2
2023,3,8.35254999814401,8.352549998144012,0.9778051554073401,0.9778051554073413,0,0,11.362653732299805,10.973638534545898,3,3
2023,4,7.848857485627759,7.848857485627759,0.9911593837353425,0.9911593837353437,0,0,11.385849952697754,10.973638534545898,4,4
2023,8,7.447494399415832,7.447494399415833,1.0023844246843399,1.0023844246843412,0,0,11.786934852600098,10.973638534545898,8,8
2023,16,6.408907163200255,7.150542651829311,1.0118945429568222,1.011102434250935,4,8,12.380311012268066,10.973638534545898,12,8
2023,32,6.024242612768937,6.715673075072595,1.0237589884450249,1.0303724225565385,14,20,13.119953155517578,10.973638534545898,18,12
2023,64,3.6880680810231765,6.464084004630638,1.0157794885461386,1.0388776157583863,30,52,13.686115264892578,10.973638534545898,34,12
2023,128,2.0927729998238074,6.405184142296685,1.0079990960713197,1.0408453743784107,57,114,14.422994613647461,10.973638534545898,71,14
2024,1,7.313038765097147,7.313038765097146,0.965312724948009,0.9653127249480089,0,0,7.389079570770264,7.389079570770264,1,1
2024,2,6.6881482002929475,6.688148200292944,0.9712010716075392,0.9712010716075379,0,0,7.579652309417725,7.389079570770264,2,2
2024,3,6.170912069332952,6.170912069332952,0.9776082091299765,0.9776082091299758,0,0,7.6750922203063965,7.389079570770264,3,3
2024,4,6.073299201510219,6.170912069332952,0.9774454149706422,0.9776082091299758,1,1,7.927098751068115,7.389079570770264,3,3
2024,8,5.362553896463988,5.603615250789551,0.9960020124479148,0.9939977440711558,1,2,8.634185791015625,7.389079570770264,7,6
2024,16,4.881058781703698,5.313163260239968,0.9996339511302044,1.0031989309010367,5,5,9.048415184020996,7.389079570770264,11,11
2024,32,3.6752591160007144,5.02274501511491,1.0078900869912562,1.0113002666526243,15,17,9.460081100463867,7.389079570770264,17,15
2024,64,2.8148087363289576,4.829053367133356,1.0049329675632466,1.0151506310682767,30,48,9.849791526794434,7.389079570770264,34,16
2024,128,1.4953887274688813,4.732785830522354,0.999764936289333,1.0159789736362863,61,113,10.278748512268066,7.389079570770264,67,15
2025,1,7.841309052630027,7.841309052630031,0.9621208777914109,0.9621208777914125,0,0,7.924217700958252,7.924217700958252,1,1
2025,2,6.389788411065208,6.38978841106521,0.9872050394764532,0.9872050394764547,0,0,8.489778518676758,7.924217700958252,2,2
2025,3,6.339629613006931,6.339629613006933,0.9890380745825119,0.9890380745825138,0,0,8.489916801452637,7.924217700958252,3,3
2025,4,5.977260615145082,5.977260615145082,0.9943391419833275,0.9943391419833291,0,0,8.892792701721191,7.924217700958252,4,4
2025,8,5.334637852022781,5.391647119839108,1.0077029416325893,1.0063039468869728,1,1,9.156509399414062,7.924217700958252,7,7
2025,16,5.073518103019889,5.203392109225429,1.0114115231773977,1.0117694803711148,5,5,9.87949275970459,7.924217700958252,11,11
2025,32,4.568793125854852,5.008230327588123,1.0153531629360775,1.01862465195619,13,22,10.412242889404297,7.924217700958252,19,10
2025,64,3.2591532835808246,4.820208118379487,1.0070357433006003,1.0221967363052125,27,49,11.009446144104004,7.924217700958252,37,15
2025,128,1.609518316397472,4.697361026760171,1.0006822333183,1.0259588954333556,60,112,11.792754173278809,7.924217700958252,68,16
2026,1,5.845880489936894,5.845880489936894,0.9847538017900697,0.9847538017900703,0,0,5.863778114318848,5.863778114318848,1,1
2026,2,4.466763141946184,4.466763141946188,0.9966644325099479,0.9966644325099463,0,0,6.176167964935303,5.863778114318848,2,2
2026,3,4.207385191717628,4.207385191717629,1.0004993054491842,1.0004993054491824,0,0,6.419250011444092,5.863778114318848,3,3
2026,4,4.111323866070583,4.207385191717629,0.9993259080643948,1.0004993054491824,1,1,6.543571472167969,5.863778114318848,3,3
2026,8,3.6119560695874386,3.770332199538846,1.0074841344075556,1.0087852791922995,1,2,6.989001750946045,5.863778114318848,7,6
2026,16,3.2554206657309104,3.4914576482999595,1.0119502019819553,1.0123304593959945,5,7,7.501183032989502,5.863778114318848,11,9
2026,32,2.63951165619135,3.0766077601533,1.0128329723895935,1.0185245202706819,14,19,8.146601676940918,5.863778114318848,18,13
2026,64,1.8335654534706123,2.9700522276433494,1.0049350460153963,1.0189575358440903,31,47,8.720897674560547,5.863778114318848,33,17
2026,128,0.9646944892736921,2.934641214624073,1.0014175091087532,1.020740222936531,58,109,9.326558113098145,5.863778114318848,70,19
2027,1,4.532618998119074,4.532618998119074,0.987874018471551,0.987874018471551,0,0,4.548288345336914,4.548288345336914,1,1
2027,2,4.152528425523461,4.152528425523461,0.9939366945356862,0.9939366945356862,0,0,5.058035850524902,4.548288345336914,2,2
2027,3,4.146271042130942,4.146271042130941,0.994265178824909,0.9942651788249091,0,0,5.075782775878906,4.548288345336914,3,3
2027,4,3.979055608253294,3.9790556082532937,0.9971791451228629,0.9971791451228629,0,0,5.312658786773682,4.548288345336914,4,4
2027,8,3.340377842083154,3.3440919946353698,1.003732814691517,1.0039856208087115,2,2,5.496718406677246,4.548288345336914,6,6
2027,16,2.7013398488628337,3.0130565217452454,1.0047476238602386,1.006664298693753,5,8,5.708643436431885,4.548288345336914,11,8
2027,32,2.200943757573342,2.8971054301514325,1.0042064404075162,1.0085105916440207,14,23,6.111581325531006,4.548288345336914,18,9
2027,64,1.2406357649352056,2.837217127175977,1.0005990699790566,1.009568195779733,29,54,6.549097061157227,4.548288345336914,35,10
2027,128,0.057741569492152,2.8090653595213078,0.9999959544996431,1.009972572833907,64,118,7.034690856933594,4.548288345336914,64,10
2028,1,9.313860967234413,9.313860967234387,0.9473025142522197,0.9473025142522217,0,0,9.449468612670898,9.449468612670898,1,1
2028,2,8.178576565612852,8.178576565612852,0.9731312630864049,0.9731312630864056,0,0,9.988239288330078,9.449468612670898,2,2
2028,3,7.738734134351761,7.738734134351762,0.9809692676911735,0.9809692676911759,0,0,10.027925491333008,9.449468612670898,3,3
2028,4,7.642937851910866,7.642937851910867,0.9843927681804833,0.9843927681804849,0,0,10.133232116699219,9.449468612670898,4,4
2028,8,6.540236459886932,6.569392675842653,1.006417814583974,1.0072272203566797,1,1,10.529336929321289,9.449468612670898,7,7
2028,16,6.121322542921496,6.41000964491248,1.0141728467872357,1.0117235724002145,7,8,10.942960739135742,9.449468612670898,9,8
2028,32,4.947765324559227,6.162797020135574,1.0146664812103758,1.015781586345491,14,20,11.2938814163208,9.449468612670898,18,12
2028,64,3.818840339646394,6.077101590950185,1.0119223138353501,1.0182220313902872,26,51,11.783242225646973,9.449468612670898,38,13
2028,128,2.4742816837069785,5.898415812504738,1.0049480632196581,1.025715460631372,67,111,12.24716567993164,9.449468612670898,61,17
2029,1,9.524657340807215,9.52465734080722,0.9355631912655875,0.93556319126559,0,0,9.721302032470703,9.721302032470703,1,1
2029,2,8.563761102124184,8.563761102124186,0.9593473069060238,0.9593473069060244,0,0,9.871553421020508,9.721302032470703,2,2
2029,3,8.004248344944571,8.004248344944571,0.9742251069695155,0.974225106969516,0,0,10.551531791687012,9.721302032470703,3,3
2029,4,7.781250643576102,7.7812506435761035,0.9816551459470482,0.9816551459470494,0,0,10.939844131469727,9.721302032470703,4,4
2029,8,7.427266541276977,7.430042868810001,0.9936806886885535,0.9932419259579469,1,1,11.440685272216797,9.721302032470703,7,7
2029,16,6.74215044367375,7.399941768344952,0.9968349645897465,0.9957666782060509,5,7,11.969742774963379,9.721302032470703,11,9
2029,32,5.7556987730451,6.699868246712197,1.0150219136643974,1.017147567439483,13,18,12.360095024108887,9.721302032470703,19,14
2029,64,4.042710613196989,6.446728312451578,1.0155861154453123,1.023572130190927,26,49,12.811715126037598,9.721302032470703,38,15
2029,128,2.6977490711767422,6.363687863253913,1.0073401407004747,1.0284619215400084,62,111,13.331460952758789,9.721302032470703,66,17
2030,1,9.712259921610647,9.712259921610652,0.9395681265614694,0.9395681265614718,0,0,9.881757736206055,9.881757736206055,1,1
2030,2,6.914864954681866,6.914864954681864,1.0054097240119346,1.0054097240119373,0,0,10.030460357666016,9.881757736206055,2,2
2030,3,6.303051000782634,6.303051000782632,1.0163554455880703,1.0163554455880728,0,0,10.366570472717285,9.881757736206055,3,3
2030,4,5.603046805670726,5.60304680567072,1.0290669586340946,1.0290669586340968,0,0,10.498798370361328,9.881757736206055,4,4
2030,8,5.481298492633571,5.484559502367695,1.0315077638108299,1.0313063458712919,1,1,10.83469295501709,9.881757736206055,7,7
2030,16,4.793063633715837,4.957669407212437,1.0427708939239264,1.039974012623505,5,7,11.431038856506348,9.881757736206055,11,9
2030,32,4.589302420743856,4.822988917121418,1.0432936504744967,1.0443348059029316,15,21,11.93494701385498,9.881757736206055,17,11
2030,64,3.3133257706593318,4.7955379528313085,1.0244616807255493,1.0462287410133992,26,50,12.775042533874512,9.881757736206055,38,14
2030,128,1.8838778454513392,4.789236066905144,1.0067957431157646,1.0475859694738037,57,112,13.517828941345215,9.881757736206055,71,16
2031,1,9.304319477203459,9.304319477203459,0.9618542306767618,0.961854230676764,0,0,9.370302200317383,9.370302200317383,1,1
2031,2,7.689156654816429,7.689156654816429,0.9868025698237837,0.9868025698237834,0,0,9.610586166381836,9.370302200317383,2,2
2031,3,5.984121422738346,5.984121422738344,1.0148065719804427,1.0148065719804429,0,0,9.847522735595703,9.370302200317383,3,3
2031,4,5.618320894452724,5.618320894452728,1.0205225887066733,1.0205225887066742,0,0,9.867876052856445,9.370302200317383,4,4
2031,8,5.125808748137448,5.12580874813745,1.028299954678402,1.0282999546784013,0,0,10.597596168518066,9.370302200317383,8,8
2031,16,4.972096763944954,4.989194281578796,1.0332947600721147,1.032961160345945,3,3,11.002543449401855,9.370302200317383,13,13
2031,32,4.070926850763385,4.949726027073483,1.0332006657146633,1.0346926803594054,14,19,11.700370788574219,9.370302200317383,18,13
2031,64,3.3311362857934252,4.91945122732181,1.020604303093199,1.0366430631423365,32,47,12.47169303894043,9.370302200317383,32,17
2031,128,2.428798827861608,4.86447339758532,1.0116092582020504,1.0400867381572887,64,111,13.211763381958008,9.370302200317383,64,17
2032,1,6.396886843539282,6.396886843539284,0.9737413815539048,0.9737413815539072,0,0,6.445306777954102,6.445306777954102,1,1
2032,2,5.251344821172151,5.251344821172153,0.9915123257393283,0.99151232573933,0,0,7.297370910644531,6.445306777954102,2,2
2032,3,4.597358492418112,4.597358492418112,1.0024915254928883,1.0024915254928901,0,0,7.478835105895996,6.445306777954102,3,3
2032,4,4.597308810726404,4.597358492418112,1.0024747947429804,1.0024915254928901,1,1,7.715780258178711,6.445306777954102,3,3
2032,8,4.549575867330446,4.597358492418112,1.0013837909066616,1.0024915254928901,3,5,8.11224365234375,6.445306777954102,5,3
2032,16,4.300614415025293,4.545904178939261,1.0063485089178317,1.0059132900386991,6,7,9.303261756896973,6.445306777954102,10,9
2032,32,3.5127007860990593,4.4070091236883595,1.0086324955788895,1.0127773885754443,12,17,9.811592102050781,6.445306777954102,20,15
2032,64,2.6417015633088465,4.1787938317502,1.005496987257434,1.0189060612039067,31,51,10.44048023223877,6.445306777954102,33,13
2032,128,1.5770493302766881,4.171452960590885,1.0006167950135154,1.0190692063496007,62,114,11.237603187561035,6.445306777954102,66,14
2033,1,9.864795441610076,9.864795441610083,0.9512459951812616,0.9512459951812642,0,0,9.9699068069458,9.9699068069458,1,1
2033,2,9.02059441667772,9.02059441667772,0.9760591622897572,0.976059162289759,0,0,11.021194458007812,9.9699068069458,2,2
2033,3,8.501361781905613,8.501361781905615,0.9895149702879513,0.9895149702879533,0,0,11.885214805603027,9.9699068069458,3,3
2033,4,8.50133022644193,8.501330226441912,0.9895737228688897,0.9895737228688919,0,0,12.194758415222168,9.9699068069458,4,4
2033,8,8.103638702636609,8.33024159683341,1.0007929099549124,0.998278950238338,2,2,12.454304695129395,9.9699068069458,6,6
2033,16,7.053182527718911,7.657040721573181,1.0276334156071263,1.0235562789950896,6,9,13.664541244506836,9.9699068069458,10,7
2033,32,5.668174933510869,7.644278462649573,1.0151993567517832,1.0255593585536134,13,25,14.006841659545898,9.9699068069458,19,7
2033,64,4.643861790966379,7.555893653052672,1.0138156945935317,1.031563513366948,30,54,14.74038314819336,9.9699068069458,34,10
2033,128,2.8369940651056997,6.828246503229111,1.0064184659112745,1.0558626559790714,57,115,15.496780395507812,9.9699068069458,71,13
2034,1,2.749495975460564,2.749495975460564,0.995688830284209,0.9956888302842095,0,0,2.752739667892456,2.752739667892456,1,1
2034,2,2.5626357727873956,2.5626357727873956,0.9964775509862047,0.996477550986205,0,0,2.852731466293335,2.752739667892456,2,2
2034,3,2.432991541631374,2.4329915416313743,0.9975920927478945,0.997592092747895,0,0,2.8773834705352783,2.752739667892456,3,3
2034,4,1.863564651104191,1.8786256287381857,1.0014436985742443,1.0012717499132189,1,1,2.888178586959839,2.752739667892456,3,3
2034,8,1.5531754344492608,1.6147387323164115,1.00194020508554,1.0020160399590552,3,3,3.2757184505462646,2.752739667892456,5,5
2034,16,1.3441054945540734,1.61044052652262,1.0012426164335742,1.0021082767606595,7,10,3.5252256393432617,2.752739667892456,9,6
2034,32,0.855966216871916,1.4702309826628464,0.9998806147212994,1.0030480018748487,15,22,3.8099677562713623,2.752739667892456,17,10
2034,64,0.3833805130259332,1.3963213657704545,1.0004162856814998,1.0036102431611726,29,55,4.203667640686035,2.752739667892456,35,9
2034,128,0.022360641574044497,1.3962706370662437,1.0000030550638215,1.003627486008352,62,118,4.72298002243042,2.752739667892456,66,10
2035,1,9.534031644419668,9.534031644419674,0.9390033076219955,0.9390033076219972,0,0,9.708264350891113,9.708264350891113,1,1
2035,2,7.939226553505669,7.93922655350567,0.97901734351897,0.9790173435189706,0,0,10.210079193115234,9.708264350891113,2,2
2035,3,7.931069082907838,7.9310690829078405,0.9795767384702266,0.9795767384702279,0,0,11.092689514160156,9.708264350891113,3,3
2035,4,6.775925002801434,6.784249697555685,1.0021252020540186,1.002332107094003,1,1,11.253567695617676,9.708264350891113,3,3
2035,8,6.620196274782948,6.620894551581615,1.0111436325741543,1.0112474326010428,2,2,12.087919235229492,9.708264350891113,6,6
2035,16,5.668726389760763,6.119050689547573,1.0254196594820515,1.0261542065221856,5,7,12.562479972839355,9.708264350891113,11,9
2035,32,4.775201180751012,6.081579136008324,1.0219697929059806,1.0286955762363472,16,20,13.004775047302246,9.708264350891113,16,12
2035,64,3.514963902863671,5.950363534445648,1.0200924761747463,1.034328180266956,28,50,13.391289710998535,9.708264350891113,36,14
2035,128,2.1880359410580645,5.903837976659713,1.009624566126422,1.0362624705808092,61,111,13.939088821411133,9.708264350891113,67,17
2036,1,6.316440394165085,6.3164403941650855,0.9782150644675984,0.978215064467599,0,0,6.351107120513916,6.351107120513916,1,1
2036,2,5.127209594013424,5.127209594013423,0.9931970232111228,0.9931970232111228,0,0,6.407219409942627,6.351107120513916,2,2
2036,3,4.54561207053609,4.54561207053609,1.0009437838343382,1.0009437838343387,0,0,7.1040425300598145,6.351107120513916,3,3
2036,4,4.483449877769304,4.545612070536089,1.000151199380586,1.0009437838343387,1,1,7.465743064880371,6.351107120513916,3,3
2036,8,3.9729237570051237,4.169874757937059,1.0060442906098008,1.0065710867956108,2,3,7.801296710968018,6.351107120513916,6,5
2036,16,3.4564989958768684,4.062670753573767,1.0069211636002176,1.01034887992482,8,8,8.317277908325195,6.351107120513916,8,8
2036,32,3.0625105932887315,3.869811122802319,1.0061357201581242,1.0135835307788899,19,23,8.787585258483887,6.351107120513916,13,9
2036,64,2.014970802582339,3.6141287000830538,1.004722139903662,1.0167230450563487,28,53,9.508979797363281,6.351107120513916,36,11
2036,128,1.2444659995777876,3.5590139803067364,1.0013973228431556,1.0194391370996043,58,116,10.508496284484863,6.351107120513916,70,12
2037,1,11.415099737068674,11.415099737068681,0.9210161816549064,0.9210161816549081,0,0,11.655017852783203,11.655017852783203,1,1
2037,2,10.318544188011597,10.318544188011598,0.9533495478892544,0.9533495478892553,0,0,11.804335594177246,11.655017852783203,2,2
2037,3,9.087256394699153,9.087256394699153,0.9884956624742063,0.9884956624742078,0,0,11.852860450744629,11.655017852783203,3,3
2037,4,9.036420483440816,9.087256394699153,0.9888287305017849,0.9884956624742078,1,1,11.890349388122559,11.655017852783203,3,3
2037,8,8.550868165238604,8.590457507886251,1.006218761288629,1.0056028163427122,1,2,13.01692008972168,11.655017852783203,7,6
2037,16,8.096730407954613,8.314077807810788,1.0173509905875346,1.017227854209447,6,7,13.737649917602539,11.655017852783203,10,9
2037,32,6.3609301760684485,7.200734545001582,1.0437899208798884,1.048527188043867,14,20,14.470977783203125,11.655017852783203,18,12
2037,64,4.927843996044725,7.005629143593318,1.0395356763775365,1.055330241651561,29,49,15.062132835388184,11.655017852783203,35,15
2037,128,2.856204502320871,6.9687936321163235,1.0133873849305806,1.05941861046562,67,110,15.780834197998047,11.655017852783203,61,18
2038,1,7.34344543626799,7.3434454362679915,0.9649386765948027,0.9649386765948047,0,0,7.419953346252441,7.419953346252441,1,1
2038,2,6.181236238308687,6.1812362383086885,0.9856234046678993,0.985623404667901,0,0,7.501736164093018,7.419953346252441,2,2
2038,3,5.964584288787615,5.9645842887876155,0.9895285350335635,0.9895285350335652,0,0,7.529489994049072,7.419953346252441,3,3
2038,4,5.489137634745658,5.489137634745658,0.99604043841973,0.9960404384197311,0,0,7.638372898101807,7.419953346252441,4,4
2038,8,5.12514529549047,5.12514529549047,1.0044605204708064,1.0044605204708066,0,0,8.305551528930664,7.419953346252441,8,8
2038,16,4.457104063923925,4.806031082840706,1.0121983922617475,1.0123442220836825,4,2,9.156140327453613,7.419953346252441,12,14
2038,32,3.7600488273565005,4.54485740974802,1.0147043058032463,1.0193509729842742,13,20,9.648545265197754,7.419953346252441,19,12
2038,64,2.672804598340705,4.281179388415369,1.0077275589578556,1.0244695976608895,32,48,10.369072914123535,7.419953346252441,32,16
2038,128,1.283828028313535,4.162998847026086,1.0005358528106065,1.026142721271256,66,111,11.04103946685791,7.419953346252441,62,17
2039,1,9.883946903400423,9.883946903400428,0.9331572914491552,0.9331572914491567,0,0,10.081676483154297,10.081676483154297,1,1
2039,2,9.094379368688879,9.094379368688877,0.9510918281684375,0.951091828168437,0,0,10.770295143127441,10.081676483154297,2,2
2039,3,8.894530037030675,8.894530037030673,0.9584815144603764,0.9584815144603758,0,0,11.16993236541748,10.081676483154297,3,3
2039,4,8.175348953563303,8.1753489535633,0.9760739614678213,0.9760739614678213,0,0,11.249677658081055,10.081676483154297,4,4
2039,8,7.708531738964006,7.75672585128989,0.9911243372334316,0.9917365029251153,3,3,11.805498123168945,10.081676483154297,5,5
2039,16,6.015618680557567,6.622056079431007,1.02569158532729,1.020822994605831,6,7,12.147839546203613,10.081676483154297,10,9
2039,32,5.0370738124168835,6.422478419531073,1.0254285263371723,1.0278804377539403,15,20,12.655350685119629,10.081676483154297,17,12
2039,64,3.9150563653042068,6.2877970424262815,1.010691432627725,1.0333745345306398,32,49,13.328360557556152,10.081676483154297,32,15
2039,128,2.180665465845418,5.776751115566765,1.0049796473851378,1.049905214387702,57,111,13.99150276184082,10.081676483154297,71,17
2040,1,13.168767094183249,13.168767094183258,0.9005791314402455,0.9005791314402479,0,0,13.492897987365723,13.492897987365723,1,1
2040,2,12.581827314484274,12.581827314484277,0.9214461406030656,0.9214461406030672,0,0,14.18007755279541,13.492897987365723,2,2
2040,3,11.658943875931145,11.658943875931145,0.9562430460350588,0.95624304603506,0,0,14.591330528259277,13.492897987365723,3,3
2040,4,10.722568741584276,10.722671164240293,0.9853663960701076,0.985354115824126,1,1,15.05211353302002,13.492897987365723,3,3
2040,8,9.753048928902532,9.841632048976097,1.0153288888068748,1.0134055546723042,1,2,15.417428970336914,13.492897987365723,7,6
2040,16,9.558751233306221,9.758239948807462,1.0230661847373028,1.0181013885417796,2,7,15.875287055969238,13.492897987365723,14,9
2040,32,8.118062001523937,9.089418538638727,1.0485737016487235,1.0429140416257152,12,17,16.17814064025879,13.492897987365723,20,15
2040,64,6.54141752925892,9.026456121205511,1.0390366951267311,1.0461214655091131,30,49,16.674345016479492,13.492897987365723,34,15
2040,128,3.925076589586768,8.881888535343256,1.0225726467368974,1.0542878986661228,62,111,17.130678176879883,13.492897987365723,66,17
2041,1,2.5801296448710485,2.580129644871049,0.9983577152226507,0.9983577152226515,0,0,2.5806095600128174,2.5806095600128174,1,1
2041,2,2.4187467678800623,2.4187467678800627,0.998937450082017,0.998937450082017,0,0,2.7849178314208984,2.5806095600128174,2,2
2041,3,2.397490861427064,2.397490861427064,0.9987067736780313,0.998706773678032,0,0,2.90551495552063,2.5806095600128174,3,3
2041,4,2.3958068162413033,2.395806816241303,0.998645429719702,0.9986454297197012,0,0,3.185100793838501,2.5806095600128174,4,4
2041,8,2.292661987501203,2.3079396808016828,0.9997343332274362,0.9996918196921509,3,3,3.374626874923706,2.5806095600128174,5,5
2041,16,2.092180237162316,2.270326871250568,1.001606438953184,1.0001974826262745,5,9,3.5890657901763916,2.5806095600128174,11,7
2041,32,1.148534234490681,2.097200974257385,1.0001297892486163,1.0013340381377598,14,24,3.956414222717285,2.5806095600128174,18,8
2041,64,0.4645784510282353,2.0756930015020103,1.0005118269740512,1.0019844207800732,30,54,4.336665153503418,2.5806095600128174,34,10
2041,128,0.036709702220818256,1.9853674033798572,0.9999878856403219,1.0039252555185305,64,118,4.861528396606445,2.5806095600128174,64,10
2042,1,7.8992866470673135,7.899286647067317,0.9641521754476101,0.9641521754476099,0,0,7.970587730407715,7.970587730407715,1,1
2042,2,6.590044289232036,6.590044289232036,0.9856607083187465,0.9856607083187465,0,0,7.982544898986816,7.970587730407715,2,2
2042,3,5.9896456150740685,5.9896456150740685,0.9951414801815166,0.9951414801815157,0,0,8.271093368530273,7.970587730407715,3,3
2042,4,5.741362217463204,5.741362217463204,0.999369359581792,0.9993693595817912,0,0,8.560935974121094,7.970587730407715,4,4
2042,8,4.7659675598104325,4.765968666107758,1.0148431033137841,1.014841954248777,1,1,8.774993896484375,7.970587730407715,7,7
2042,16,4.372708045197065,4.535516900508001,1.0196888902740815,1.0200967384230546,5,7,9.460655212402344,7.970587730407715,11,9
2042,32,3.775058484802123,4.522479059104957,1.022157521407829,1.0210535106834866,9,20,9.999085426330566,7.970587730407715,23,12
2042,64,2.739979292538174,4.4597774807700485,1.0108163037487579,1.0240057612753328,28,48,10.549001693725586,7.970587730407715,36,16
2042,128,1.6234271068777912,4.410546631730178,1.0004707101532642,1.0273994937170796,61,113,11.40677547454834,7.970587730407715,67,15
2043,1,9.675491673258769,9.675491673258769,0.9462016126396893,0.9462016126396892,0,0,9.813035011291504,9.813035011291504,1,1
2043,2,7.182212162399855,7.182212162399855,1.0016071405903424,1.0016071405903422,0,0,10.48134708404541,9.813035011291504,2,2
2043,3,7.172500857240094,7.1725008572400935,1.002396158149098,1.0023961581490972,0,0,10.787729263305664,9.813035011291504,3,3
2043,4,6.29047678701166,6.290476787011659,1.0233360786289636,1.0233360786289636,0,0,11.065313339233398,9.813035011291504,4,4
2043,8,6.077577953817704,6.083111145336512,1.0287060017447605,1.0289433080649268,2,2,11.214290618896484,9.813035011291504,6,6
2043,16,5.689000648790088,5.732644454559343,1.0382824710548988,1.0381954257050983,6,5,11.481550216674805,9.813035011291504,10,11
2043,32,4.819338223198541,5.47188973712429,1.0419823721158035,1.0422703612654174,16,19,11.950529098510742,9.813035011291504,16,13
2043,64,3.8663022062917314,5.453379211057013,1.0298980408527476,1.044070886806749,31,48,12.416729927062988,9.813035011291504,33,16
2043,128,2.1358340574650847,5.360856800418934,1.0101102345412567,1.0475598111763968,60,114,12.894583702087402,9.813035011291504,68,14
2044,1,11.667498925519643,11.667498925519647,0.9046611460469914,0.9046611460469925,0,0,12.00946044921875,12.00946044921875,1,1
2044,2,10.84571213542842,10.84571213542842,0.9308951226748446,0.9308951226748445,0,0,12.73978042602539,12.00946044921875,2,2
2044,3,10.782521980784882,10.782521980784882,0.9327645638784453,0.932764563878445,0,0,12.968106269836426,12.00946044921875,3,3
2044,4,10.435604814003838,10.435604814003838,0.9450976416784909,0.9450976416784906,0,0,13.515495300292969,12.00946044921875,4,4
2044,8,9.298604238051839,9.573782442423935,0.9741395730346655,0.9714271125300389,1,2,14.059165954589844,12.00946044921875,7,6
2044,16,8.246427507179478,8.608545652872357,1.009256183314652,1.0040329621409463,6,9,14.413947105407715,12.00946044921875,10,7
2044,32,7.404451213548003,8.556793423767509,1.0044716022480369,1.0083243998961606,16,24,15.064596176147461,12.00946044921875,16,8
2044,64,6.356339467595475,8.556711778015181,0.9928770074173474,1.0084194156209079,37,56,15.732156753540039,12.00946044921875,27,8
2044,128,4.0392811920787395,8.50766177058008,1.0004131585755287,1.0115995309422452,61,116,16.286579132080078,12.00946044921875,67,12
2045,1,8.810863394954868,8.810863394954868,0.9564264652681385,0.9564264652681382,0,0,8.904764175415039,8.904764175415039,1,1
2045,2,6.650404295769001,6.650404295769,1.0011092234087038,1.0011092234087036,0,0,9.234041213989258,8.904764175415039,2,2
2045,3,6.216026338019104,6.2160263380191045,1.006960520620657,1.0069605206206569,0,0,9.269121170043945,8.904764175415039,3,3
2045,4,6.190743861518668,6.190743861518669,1.0069735848404,1.0069735848403971,0,0,9.55623722076416,8.904764175415039,4,4
2045,8,5.853572583558749,5.9261645516164565,1.0112487097751939,1.0115637730610105,2,2,10.11468505859375,8.904764175415039,6,6
2045,16,5.330060186653368,5.724385547112168,1.014536772709471,1.0173891375797532,5,8,11.026864051818848,8.904764175415039,11,8
2045,32,4.661618702771124,5.629038336653314,1.0168127350032072,1.0188093403368772,12,19,11.53442668914795,8.904764175415039,20,13
2045,64,3.6705304520118047,5.549406663981804,1.0180048754657216,1.024619174736245,26,50,12.444025039672852,8.904764175415039,38,14
2045,128,2.3381288298408665,5.480899555683167,1.0071790892187187,1.0295075268648644,63,112,13.137914657592773,8.904764175415039,65,16
2046,1,7.271611018029402,7.271611018029406,0.9707849867238617,0.9707849867238647,0,0,7.3255934715271,7.3255934715271,1,1
2046,2,5.632041835130603,5.632041835130602,0.9986139542409057,0.9986139542409065,0,0,7.3537445068359375,7.3255934715271,2,2
2046,3,5.160995338294861,5.160995338294861,1.0045428011036415,1.0045428011036424,0,0,7.390843868255615,7.3255934715271,3,3
2046,4,4.733254934308117,4.733254934308116,1.0101851604717909,1.0101851604717922,0,0,7.648955821990967,7.3255934715271,4,4
2046,8,4.328715049099726,4.328715049099726,1.0147129057814261,1.0147129057814266,0,0,7.855626106262207,7.3255934715271,8,8
2046,16,3.8581701095591248,3.9787103813132365,1.0187794750620096,1.0181111119135817,3,1,8.121278762817383,7.3255934715271,13,15
2046,32,3.1078495493378844,3.7456564340819782,1.0145558277898767,1.0214498383407986,12,19,8.783379554748535,7.3255934715271,20,13
2046,64,2.384577415340124,3.7416109317405155,1.0044511477522877,1.021713442834296,33,48,9.51129150390625,7.3255934715271,31,16
2046,128,1.2562007484752185,3.732206470804645,1.0003521702925897,1.0228590226842478,64,109,10.069652557373047,7.3255934715271,64,19
2047,1,10.835611654423593,10.835611654423596,0.9390802003576141,0.9390802003576157,0,0,10.984529495239258,10.984529495239258,1,1
2047,2,8.65961048028239,8.659610480282392,0.9882522874835986,0.9882522874835996,0,0,11.295692443847656,10.984529495239258,2,2
2047,3,7.835390328820844,7.835390328820844,1.004153967146805,1.0041539671468038,0,0,11.357564926147461,10.984529495239258,3,3
2047,4,7.796276649434214,7.796276649434214,1.0049621236329713,1.0049621236329696,0,0,11.368306159973145,10.984529495239258,4,4
2047,8,6.629640495209231,6.672051651586139,1.032971863471682,1.0330812709237813,1,1,12.491849899291992,10.984529495239258,7,7
2047,16,6.179250636829608,6.299330791175443,1.0448873382303054,1.0473465984233388,4,5,13.140376091003418,10.984529495239258,12,11
2047,32,5.327059299535437,6.292440566254155,1.0416041743549709,1.048321952772148,11,20,14.061254501342773,10.984529495239258,21,12
2047,64,3.475458178929241,6.150222855592908,1.0245437153867023,1.054694809880955,28,50,14.831134796142578,10.984529495239258,36,14
2047,128,2.314222054116438,6.124207008382344,1.0114214785761266,1.0577455993281346,63,112,15.598535537719727,10.984529495239258,65,16
