pnt_id,simplexK,residue,residue_pos,coefsum,coefsum_pos,coef_sparsity,coef_sparsity_pos,maxdist,mindist,n_active,n_active_pos
1024,1,3.64254445498322,3.6425444549832187,0.990312782405494,0.9903127824054949,0,0,3.6548328399658203,3.6548328399658203,1,1
1024,2,2.84582150079563,2.8458215007956293,0.9975116216287734,0.9975116216287736,0,0,3.7755377292633057,3.6548328399658203,2,2
1024,3,2.6999767994109742,2.6999767994109742,0.9987248798806718,0.9987248798806725,0,0,3.840541124343872,3.6548328399658203,3,3
1024,4,2.6680761831288624,2.6680761831288624,0.999248057292625,0.9992480572926254,0,0,4.0099077224731445,3.6548328399658203,4,4
1024,8,2.302306734272822,2.4638513752332636,1.0017519173446887,1.0015597107987557,1,2,4.314056396484375,3.6548328399658203,7,6
1024,16,1.9054973850653545,2.2160989492923475,1.0044396166612346,1.0037312110383492,6,8,4.580868721008301,3.6548328399658203,10,8
1024,32,1.6043320361751208,2.1099523859665776,1.0050831213452875,1.0060407944225631,12,23,4.925359725952148,3.6548328399658203,20,9
1024,64,1.2466348244083698,2.0578989206893437,1.0020702115375224,1.0071572933507478,27,54,5.317025661468506,3.6548328399658203,37,10
1024,128,0.2794385898534083,2.047459317760479,0.9997203887955917,1.0078183058006165,63,117,5.876754283905029,3.6548328399658203,65,11
1025,1,10.826572965143255,10.826572965143257,0.9318789907587438,0.9318789907587454,0,0,11.014955520629883,11.014955520629883,1,1
1025,2,8.830245785417915,8.830245785417912,0.9728220024399319,0.9728220024399336,0,0,11.2816162109375,11.014955520629883,2,2
1025,3,8.378360460724526,8.378360460724526,0.9800022302396268,0.9800022302396274,0,0,11.300028800964355,11.014955520629883,3,3
1025,4,7.711983050053174,7.711983050053175,0.9917023824006037,0.9917023824006055,0,0,11.542519569396973,11.014955520629883,4,4
1025,8,7.21083587296499,7.254054916361784,1.0050849290270738,1.0048896127366658,1,1,11.728863716125488,11.014955520629883,7,7
1025,16,6.945946232990551,7.070958260984463,1.0121436579987106,1.0117126190122454,4,8,12.273507118225098,11.014955520629883,12,8
1025,32,5.950962395954214,6.781066390478218,1.0201800485406305,1.0220027421866642,15,22,12.637642860412598,11.014955520629883,17,10
1025,64,4.7205706079641505,6.567302900944072,1.0195716314675491,1.0289869662040805,27,50,13.077476501464844,11.014955520629883,37,14
1025,128,2.7301565256800058,6.33426339625,1.0030740915376228,1.0392501648654382,63,112,13.572590827941895,11.014955520629883,65,16
1026,1,11.260605993269158,11.260605993269158,0.9335170721462209,0.9335170721462215,0,0,11.43915843963623,11.43915843963623,1,1
1026,2,9.09873456784572,9.09873456784572,0.9870056956018534,0.9870056956018529,0,0,11.47768783569336,11.43915843963623,2,2
1026,3,8.491089899286385,8.491089899286385,0.9987306115088006,0.9987306115087997,0,0,11.483964920043945,11.43915843963623,3,3
1026,4,8.459141219527094,8.459141219527092,0.9997820627237521,0.9997820627237511,0,0,11.539045333862305,11.43915843963623,4,4
1026,8,6.8723981684942785,6.8749244820608615,1.0283915888509205,1.0283946203420764,1,1,12.00993537902832,11.43915843963623,7,7
1026,16,6.532803874849302,6.790245609209376,1.0339747537658797,1.0320347009578446,3,6,12.483512878417969,11.43915843963623,13,10
1026,32,5.796073722321331,6.605549992109976,1.0366713185103467,1.0397128982842223,12,20,13.04840087890625,11.43915843963623,20,12
1026,64,4.393538073925394,6.372275173512288,1.0291740235476823,1.0490376782658795,31,52,13.510427474975586,11.43915843963623,33,12
1026,128,2.554059391828735,6.31206939880886,1.0086208499795621,1.0514311453250413,65,113,14.02988052368164,11.43915843963623,63,15
1027,1,12.264512757359924,12.264512757359928,0.9163322893664354,0.9163322893664386,0,0,12.517911911010742,12.517911911010742,1,1
1027,2,10.005445221631902,10.005445221631904,0.9772754230361567,0.9772754230361577,0,0,12.544744491577148,12.517911911010742,2,2
1027,3,8.960927649084317,8.960927649084317,1.000376118705233,1.0003761187052331,0,0,12.555595397949219,12.517911911010742,3,3
1027,4,8.221869112290356,8.221869112290356,1.0185506259688166,1.0185506259688188,0,0,12.603389739990234,12.517911911010742,4,4
1027,8,8.010830984755557,8.05873908297255,1.0244954633665755,1.0249687155108465,1,1,13.436327934265137,12.517911911010742,7,7
1027,16,7.113693891481633,7.693381371143134,1.0445711509142768,1.0385735950143271,5,5,13.825118064880371,12.517911911010742,11,11
1027,32,6.568360895600669,7.406595815844392,1.051978488546582,1.0487922515805495,13,19,14.426895141601562,12.517911911010742,19,13
1027,64,5.128484447244716,7.173856133388005,1.038195198207285,1.059524904935866,32,50,14.978487968444824,12.517911911010742,32,14
1027,128,3.369849338863192,7.128059608897278,1.0146559348823954,1.06282726230054,63,110,15.842888832092285,12.517911911010742,65,18
1028,1,4.854199204176514,4.854199204176508,0.9838231034803573,0.983823103480359,0,0,4.878977298736572,4.878977298736572,1,1
1028,2,4.384991890216904,4.384991890216904,0.9894605569985175,0.9894605569985182,0,0,5.8173065185546875,4.878977298736572,2,2
1028,3,4.371374677324404,4.3713746773244,0.9902589912307671,0.9902589912307683,0,0,5.964219093322754,4.878977298736572,3,3
1028,4,3.961233084395494,4.004647841943558,0.9935932695274264,0.9942737153442123,1,1,6.065433979034424,4.878977298736572,3,3
1028,8,3.4043154490283514,3.5284789149382263,0.9989103713416398,0.9999543452428443,2,2,6.296245098114014,4.878977298736572,6,6
1028,16,2.6751473377155204,3.274248216329795,1.0029717216163148,1.0030293658633667,6,8,6.538920879364014,4.878977298736572,10,8
1028,32,2.104491919617314,2.981688984902266,1.0089841430174031,1.0110955306210319,15,22,7.336990833282471,4.878977298736572,17,10
1028,64,1.4373543731949634,2.893934248070865,1.002462628656926,1.012661283809385,34,48,7.9452290534973145,4.878977298736572,30,16
1028,128,0.8002450631347611,2.8611616853272483,1.0001900806783355,1.014435485049817,66,109,8.756491661071777,4.878977298736572,62,19
1029,1,11.938725104291239,11.938725104291242,0.9098638253134738,0.9098638253134754,0,0,12.23322868347168,12.23322868347168,1,1
1029,2,10.850964900838585,10.850964900838585,0.9519038848036183,0.951903884803619,0,0,13.880398750305176,12.23322868347168,2,2
1029,3,10.432482090957048,10.432482090957048,0.9665711468992682,0.9665711468992693,0,0,13.886225700378418,12.23322868347168,3,3
1029,4,10.322349001915889,10.322349001915892,0.9712395774982228,0.9712395774982239,0,0,14.039133071899414,12.23322868347168,4,4
1029,8,9.882676460105452,9.882676460105452,0.9976595158527983,0.997659515852799,0,0,14.736519813537598,12.23322868347168,8,8
1029,16,9.586438069750264,9.691622827224611,1.0038109020913444,1.0061521514805616,4,4,15.10365104675293,12.23322868347168,12,12
1029,32,8.521607940801431,9.664501915659296,1.0087948745377604,1.0082633913218015,14,19,15.652283668518066,12.23322868347168,18,13
1029,64,5.991660111915236,8.97264954628568,1.0288661451378274,1.0354094826386167,29,51,16.08216667175293,12.23322868347168,35,13
1029,128,3.6289112527953047,8.738276136756149,1.0180526508836172,1.0365389479865261,66,113,16.576602935791016,12.23322868347168,62,15
1030,1,9.80945041571135,9.80945041571132,0.9484695663075536,0.9484695663075577,0,0,9.925606727600098,9.925606727600098,1,1
1030,2,8.562319391492496,8.562319391492496,0.9841141242969358,0.9841141242969376,0,0,11.495134353637695,9.925606727600098,2,2
1030,3,8.556172921407605,8.556172921407606,0.9845504673067119,0.9845504673067142,0,0,11.556346893310547,9.925606727600098,3,3
1030,4,7.821909995630268,7.851247530806663,1.0022867889470044,1.0021719267302784,1,1,11.700887680053711,9.925606727600098,3,3
1030,8,6.632632767991139,6.6530119519510365,1.0255526240786517,1.0252904887215895,2,2,11.993385314941406,9.925606727600098,6,6
1030,16,5.987954064970192,6.247519019214493,1.039744888429613,1.0374853222007367,6,8,12.576750755310059,9.925606727600098,10,8
1030,32,5.453681632436409,6.216867751010163,1.0404235073454118,1.0397339814157482,11,20,13.347692489624023,9.925606727600098,21,12
1030,64,4.242316886211044,6.1691871618089404,1.0274630890142986,1.0442953579993626,28,49,14.134367942810059,9.925606727600098,36,15
1030,128,2.919392168725944,6.132064209800771,1.0151346150417342,1.0479323967588163,58,113,14.81706714630127,9.925606727600098,70,15
1031,1,9.116002665185626,9.116002665185626,0.959941728394158,0.9599417283941608,0,0,9.191747665405273,9.191747665405273,1,1
1031,2,7.169681359167773,7.169681359167772,1.001057651844968,1.001057651844971,0,0,10.167966842651367,9.191747665405273,2,2
1031,3,6.144938652321594,6.144938652321594,1.0136528257796669,1.0136528257796673,0,0,10.269947052001953,9.191747665405273,3,3
1031,4,6.144914054451019,6.144938652321594,1.0136411781023102,1.0136528257796673,1,1,10.36845874786377,9.191747665405273,3,3
1031,8,5.878399538214767,5.916213974076533,1.0200880866094808,1.0197294525393406,1,2,10.576286315917969,9.191747665405273,7,6
1031,16,5.326040575465973,5.697312345726654,1.0258857671959607,1.0232159249213324,3,7,11.188085556030273,9.191747665405273,13,9
1031,32,4.993805473441698,5.661949112986861,1.026942809051355,1.0253213318294039,11,23,12.047445297241211,9.191747665405273,21,9
1031,64,3.6009708577164563,5.161975065363838,1.0166423491192162,1.0350153237367965,31,52,12.568131446838379,9.191747665405273,33,12
1031,128,2.1349392640360363,5.131361634023245,1.004893864725687,1.0383298276479944,63,112,13.271985054016113,9.191747665405273,65,16
1032,1,5.993346416938841,5.993346416938824,0.9745691591257433,0.9745691591257455,0,0,6.0427985191345215,6.0427985191345215,1,1
1032,2,4.708854858177808,4.708854858177789,0.9920272623211595,0.9920272623211617,0,0,6.804559707641602,6.0427985191345215,2,2
1032,3,4.418083996390958,4.418083996390958,0.9974865831615431,0.997486583161545,0,0,7.058340072631836,6.0427985191345215,3,3
1032,4,4.382650839954125,4.382650839954125,0.998099491478276,0.9980994914782783,0,0,7.2039384841918945,6.0427985191345215,4,4
1032,8,4.287411349713019,4.36611266427125,0.9989484204824147,0.9988899066527089,1,2,8.340266227722168,6.0427985191345215,7,6
1032,16,3.989712100913368,4.119726455638516,1.0021875680523644,1.003471357971534,8,9,8.50473690032959,6.0427985191345215,8,7
1032,32,3.4631841664361884,3.906927908455642,1.0074433945808776,1.0088249093534871,15,25,9.177273750305176,6.0427985191345215,17,7
1032,64,2.2020627488302633,3.900601480630439,0.9984011121755608,1.0092429702186774,28,55,9.693965911865234,6.0427985191345215,36,9
1032,128,1.2301706592101385,3.7127611467145645,1.0039282659892739,1.0190051893487864,61,113,10.445091247558594,6.0427985191345215,67,15
1033,1,8.110020001171847,8.110020001171849,0.9629108355550297,0.9629108355550315,0,0,8.186776161193848,8.186776161193848,1,1
1033,2,6.039654435457034,6.039654435457033,1.0010503997665585,1.0010503997665592,0,0,9.152969360351562,8.186776161193848,2,2
1033,3,5.692805415254741,5.69280541525474,1.007684412670017,1.0076844126700177,0,0,9.811628341674805,8.186776161193848,3,3
1033,4,5.543530802055411,5.54353080205541,1.0096695970510188,1.009669597051019,0,0,9.941822052001953,8.186776161193848,4,4
1033,8,5.481026221627134,5.481044440140655,1.0109676788106603,1.010995762740003,1,1,10.421096801757812,8.186776161193848,7,7
1033,16,4.720644916444133,4.969918537749802,1.0216270875649347,1.0263782579150555,4,7,11.021716117858887,8.186776161193848,12,9
1033,32,4.17090010831772,4.865459643432077,1.0223407047671866,1.0291882256737295,11,21,11.355623245239258,8.186776161193848,21,11
1033,64,3.186309189861105,4.815080227905759,1.0200364730206457,1.0322662288593363,30,50,11.737862586975098,8.186776161193848,34,14
1033,128,2.0103117809695306,4.7898843670423314,1.007217505564252,1.033312209383703,66,114,12.055819511413574,8.186776161193848,62,14
1034,1,11.925664965177317,11.925664965177319,0.9183625872702237,0.9183625872702254,0,0,12.167827606201172,12.167827606201172,1,1
1034,2,9.158153113560257,9.158153113560257,0.9855316856162182,0.985531685616218,0,0,12.209238052368164,12.167827606201172,2,2
1034,3,8.811871771645807,8.811871771645807,0.9915961087904368,0.9915961087904375,0,0,12.306107521057129,12.167827606201172,3,3
1034,4,8.449309543183722,8.44930954318372,0.9978981499330979,0.997898149933098,0,0,12.419380187988281,12.167827606201172,4,4
1034,8,7.939249767553924,7.939249767553924,1.0103261621974111,1.0103261621974113,0,0,12.571121215820312,12.167827606201172,8,8
1034,16,6.814406734877757,6.966514737721054,1.0351444030108699,1.0324998058276524,7,8,12.798114776611328,12.167827606201172,9,8
1034,32,6.1961756749723245,6.859837721596046,1.0447203253905346,1.037157263884949,14,19,13.147988319396973,12.167827606201172,18,13
1034,64,5.153183388828254,6.685380737232595,1.0456103325591635,1.0439777561825738,28,48,13.490558624267578,12.167827606201172,36,16
1034,128,3.402880035238187,6.435317618930364,1.0212694433559517,1.053419071490564,61,106,13.876928329467773,12.167827606201172,67,22
1035,1,10.645026995667356,10.645026995667356,0.9147042653521161,0.914704265352119,0,0,10.936116218566895,10.936116218566895,1,1
1035,2,9.968979792152924,9.968979792152924,0.939828455462818,0.9398284554628201,0,0,12.782524108886719,10.936116218566895,2,2
1035,3,8.968229893759949,8.968229893759949,0.9757216659281772,0.9757216659281789,0,0,12.940643310546875,10.936116218566895,3,3
1035,4,8.815783326138597,8.815783326138597,0.9857712022747509,0.9857712022747506,0,0,13.094331741333008,10.936116218566895,4,4
1035,8,7.857259062043987,7.8741152744757805,1.0141157265790124,1.0133410009886525,2,2,13.44948673248291,10.936116218566895,6,6
1035,16,7.197239685084293,7.522949365198943,1.0186716598613321,1.020808571418741,6,7,14.257830619812012,10.936116218566895,10,9
1035,32,6.508820451021005,7.3953070761683914,1.0275527226877972,1.0304228238427364,12,19,14.851446151733398,10.936116218566895,20,13
1035,64,4.725257658168791,7.120745535484507,1.0246324397845885,1.0472924832855337,28,45,15.605156898498535,10.936116218566895,36,19
1035,128,3.191745770341895,6.918500468648761,1.0113365916708117,1.0555134235884345,63,109,16.55861473083496,10.936116218566895,65,19
1036,1,12.408190150329755,12.408190150329755,0.8752538741516802,0.8752538741516812,0,0,12.96338176727295,12.96338176727295,1,1
1036,2,11.382661611232052,11.382661611232054,0.9177700854508338,0.9177700854508335,0,0,13.993098258972168,12.96338176727295,2,2
1036,3,11.33103997916739,11.331039979167388,0.9205527770151813,0.9205527770151809,0,0,14.022024154663086,12.96338176727295,3,3
1036,4,11.08743786024707,11.087437860247068,0.9276007918972855,0.9276007918972854,0,0,14.036849975585938,12.96338176727295,4,4
1036,8,10.305416812315343,10.52237180206942,0.9505670604841276,0.9495869764847893,2,2,14.280619621276855,12.96338176727295,6,6
1036,16,10.077463267255183,10.52237180206942,0.9533194943782597,0.9495869764847893,7,10,14.486824989318848,12.96338176727295,9,6
1036,32,9.111503049731796,10.380323888649643,0.9690210097208201,0.9575670920282429,14,20,14.803804397583008,12.96338176727295,18,12
1036,64,7.373870857646028,9.983129300028908,1.002599601410893,0.9762972361440247,27,51,15.087320327758789,12.96338176727295,37,13
1036,128,4.934388636321581,9.551559555489305,1.0041716355729815,0.9949859926305584,59,113,15.428129196166992,12.96338176727295,69,15
1037,1,6.152536271561706,6.152536271561707,0.9767629215393182,0.9767629215393194,0,0,6.192471027374268,6.192471027374268,1,1
1037,2,5.666437199804603,5.666437199804603,0.9830619146198687,0.9830619146198685,0,0,6.875309467315674,6.192471027374268,2,2
1037,3,4.762768630295767,4.762768630295767,0.9956283060187985,0.9956283060187974,0,0,6.912391662597656,6.192471027374268,3,3
1037,4,4.603299973947518,4.603299973947518,0.9986092329506235,0.9986092329506229,0,0,7.212658882141113,6.192471027374268,4,4
1037,8,4.323451368096928,4.323451368096928,1.0046583041555932,1.0046583041555923,0,0,7.647978782653809,6.192471027374268,8,8
1037,16,3.428162957461989,3.6310432467482756,1.0148814199199054,1.0150639365206566,4,7,7.9630866050720215,6.192471027374268,12,9
1037,32,3.004201691335191,3.439289883800396,1.016720957274406,1.0186957000068606,11,20,8.50359058380127,6.192471027374268,21,12
1037,64,2.2921322646622317,3.439289883800396,1.0069494748183498,1.0186957000068606,28,52,9.425357818603516,6.192471027374268,36,12
1037,128,1.1057086766190845,3.4193966781822485,0.9976815912738932,1.0197074553054497,59,117,10.187575340270996,6.192471027374268,69,11
1038,1,8.857031753614207,8.857031753614207,0.9540298680900611,0.9540298680900634,0,0,8.960227012634277,8.960227012634277,1,1
1038,2,7.116635090716166,7.116635090716166,0.9877418629106505,0.9877418629106514,0,0,9.411827087402344,8.960227012634277,2,2
1038,3,6.803134044613438,6.803134044613438,0.9947259953913565,0.9947259953913575,0,0,9.458282470703125,8.960227012634277,3,3
1038,4,6.702231447579216,6.702231447579216,0.9975266583125871,0.9975266583125886,0,0,9.503701210021973,8.960227012634277,4,4
1038,8,6.226522344305964,6.3366580568406246,1.0042093911180103,1.0036803761087043,2,2,10.371869087219238,8.960227012634277,6,6
1038,16,5.728929389753731,6.06096863900303,1.0142059518326016,1.0096959405635269,5,8,10.893333435058594,8.960227012634277,11,8
1038,32,4.997707049342177,5.8772280202486,1.0199261905813857,1.0187684548950973,12,21,11.524543762207031,8.960227012634277,20,11
1038,64,3.7731091241927297,5.824815587424481,1.0094488708038185,1.0209786322812402,33,54,12.144251823425293,8.960227012634277,31,10
1038,128,2.455450738259962,5.745287055929465,1.004002781466223,1.0257519181081332,66,116,12.796533584594727,8.960227012634277,62,12
1039,1,10.619969150186936,10.619969150186938,0.9126116032101345,0.9126116032101351,0,0,10.939518928527832,10.939518928527832,1,1
1039,2,9.92296629584063,9.92296629584063,0.9381678136328147,0.9381678136328149,0,0,11.466195106506348,10.939518928527832,2,2
1039,3,9.562991877400414,9.563193659729192,0.9517251851790336,0.9516981488683769,1,1,12.076584815979004,10.939518928527832,2,2
1039,4,9.368148257447235,9.373839575287528,0.9598692774847167,0.9595373888510401,1,1,12.287208557128906,10.939518928527832,3,3
1039,8,8.754752424685247,8.89301763971093,0.9804998298271479,0.9790930758537608,2,2,13.030781745910645,10.939518928527832,6,6
1039,16,8.024581077934464,8.436359631792206,0.9959441897168123,0.9982767778725875,8,9,13.457639694213867,10.939518928527832,8,7
1039,32,6.854079242319824,8.05613743390321,1.0076682483463721,1.013255197669308,15,23,14.213530540466309,10.939518928527832,17,9
1039,64,4.782583472854358,7.857746372806399,1.0097623703334748,1.02335563050779,37,52,15.125907897949219,10.939518928527832,27,12
1039,128,2.522656788413312,7.836870062245303,1.0040551830798252,1.0255953380070735,65,115,16.079431533813477,10.939518928527832,63,13
1040,1,6.881460410371485,6.881460410371485,0.9719485703661488,0.97194857036615,0,0,6.930429458618164,6.930429458618164,1,1
1040,2,6.175182131899263,6.175182131899257,0.9822371061886321,0.9822371061886337,0,0,7.334271430969238,6.930429458618164,2,2
1040,3,6.110431245944846,6.110431245944847,0.9847368450063059,0.9847368450063066,0,0,8.314149856567383,6.930429458618164,3,3
1040,4,5.736787555664484,5.736787555664484,0.9920451823629475,0.992045182362948,0,0,8.490962028503418,6.930429458618164,4,4
1040,8,5.465740173833921,5.488126883617083,1.0009505104971392,1.000736189321226,1,1,9.115387916564941,6.930429458618164,7,7
1040,16,4.50562217880691,4.860978679963975,1.0129431764532542,1.0155125418125612,3,8,10.672311782836914,6.930429458618164,13,8
1040,32,3.8564076738953434,4.624522999651345,1.0127899227047552,1.0226962404259738,13,19,11.764839172363281,6.930429458618164,19,13
1040,64,2.7779908472968895,4.578542946108565,1.0077307253749035,1.0260181982269008,32,50,12.551752090454102,6.930429458618164,32,14
1040,128,1.8066568274805086,4.520162459285392,1.0017088805951588,1.0296125716032256,57,113,13.478206634521484,6.930429458618164,71,15
1041,1,6.9694009564545425,6.9694009564545425,0.9670288613624499,0.9670288613624503,0,0,7.041313648223877,7.041313648223877,1,1
1041,2,6.062566561640205,6.062566561640206,0.9824148144775039,0.982414814477503,0,0,7.250157833099365,7.041313648223877,2,2
1041,3,5.7008739555729315,5.700873955572931,0.9894853142762137,0.9894853142762132,0,0,7.799689292907715,7.041313648223877,3,3
1041,4,5.458844666686236,5.458852966876191,0.9933506518820896,0.9933444450398292,1,1,8.07225227355957,7.041313648223877,3,3
1041,8,4.09428926036693,4.094355275035538,1.0145542487246706,1.0145662826444117,2,2,8.253212928771973,7.041313648223877,6,6
1041,16,3.5803048403475404,3.662551540196886,1.020839091147639,1.0211423086231464,5,6,8.63865852355957,7.041313648223877,11,10
1041,32,3.403617716359226,3.6467361912260934,1.021856376373951,1.0217154818315235,9,14,8.958647727966309,7.041313648223877,23,18
1041,64,2.559908751740507,3.5797160801653822,1.011734407923842,1.0236634002970755,27,47,9.354416847229004,7.041313648223877,37,17
1041,128,1.4228580791971808,3.5551781438667,1.0029507553035049,1.0252985751513006,59,109,9.861193656921387,7.041313648223877,69,19
1042,1,6.594095532407586,6.594095532407588,0.9715749883900076,0.971574988390009,0,0,6.651260852813721,6.651260852813721,1,1
1042,2,5.913732430561851,5.91373243056185,0.9887675062260464,0.9887675062260477,0,0,8.909690856933594,6.651260852813721,2,2
1042,3,5.90339720363828,5.90339720363828,0.9897643401283682,0.9897643401283692,0,0,9.464838981628418,6.651260852813721,3,3
1042,4,5.793156533733731,5.804905836137791,0.9928309924609096,0.9931164630736942,1,1,9.502764701843262,6.651260852813721,3,3
1042,8,5.563198865769949,5.743944432700736,0.9916848104119549,0.99660012165007,4,3,10.197402954101562,6.651260852813721,4,5
1042,16,4.963740719783573,5.398239272369991,0.9973426902185537,1.0064785969382297,8,9,11.00143051147461,6.651260852813721,8,7
1042,32,3.876341469704063,5.267721732849685,1.0018619916686005,1.0129913943369138,14,23,11.422566413879395,6.651260852813721,18,9
1042,64,2.8273130122869,5.096356605231313,1.0023808099110707,1.0158372552711887,30,54,12.035999298095703,6.651260852813721,34,10
1042,128,1.5672963794985004,4.936143234491857,1.000972321259344,1.0242427735037951,57,113,12.502387046813965,6.651260852813721,71,15
1043,1,9.29347122860442,9.293471228604407,0.9523022530266385,0.9523022530266417,0,0,9.406606674194336,9.406606674194336,1,1
1043,2,9.208095718096105,9.208095718096107,0.9559566325185532,0.9559566325185558,0,0,10.712483406066895,9.406606674194336,2,2
1043,3,8.22553089716943,8.225530897169428,0.9867464804600345,0.9867464804600362,0,0,11.381937980651855,9.406606674194336,3,3
1043,4,7.8465859911239235,7.846585991123924,1.0003941985002995,1.0003941985003002,0,0,11.420536994934082,9.406606674194336,4,4
1043,8,7.539550857193164,7.539550857193163,1.0138023831936915,1.0138023831936942,0,0,12.201253890991211,9.406606674194336,8,8
1043,16,6.555405425228316,6.665282620658559,1.038315312882414,1.0387309962661575,5,3,12.793808937072754,9.406606674194336,11,13
1043,32,5.958258057564244,6.509547782363177,1.036171958636198,1.04331540942047,13,18,13.132817268371582,9.406606674194336,19,14
1043,64,4.631060780670933,6.335593727455872,1.0286582183762796,1.0487631958331673,28,47,13.510515213012695,9.406606674194336,36,17
1043,128,2.691807892109903,6.252762151074693,1.0061322086643767,1.0535393377524063,67,107,14.026301383972168,9.406606674194336,61,21
1044,1,10.319043646059814,10.319043646059798,0.9304744880398501,0.9304744880398527,0,0,10.525344848632812,10.525344848632812,1,1
1044,2,9.170775582556843,9.170775582556843,0.9560888317673091,0.9560888317673103,0,0,10.698219299316406,10.525344848632812,2,2
1044,3,9.063428857632468,9.063428857632468,0.9598581494663456,0.9598581494663468,0,0,10.800052642822266,10.525344848632812,3,3
1044,4,8.886864535638848,8.886864535638848,0.9664952590170044,0.9664952590170051,0,0,11.556571960449219,10.525344848632812,4,4
1044,8,8.797572615934723,8.797572615934723,0.9727572175657698,0.9727572175657704,0,0,12.009775161743164,10.525344848632812,8,8
1044,16,7.612942785010792,8.272905404257465,0.9945690249104115,0.993578847174126,5,6,12.319003105163574,10.525344848632812,11,10
1044,32,6.4290142089768345,7.767406386271464,1.00999404063099,1.0092525149775926,12,19,12.806488990783691,10.525344848632812,20,13
1044,64,5.218434566393054,7.4283885558495095,1.0111833027854837,1.0236681973616117,30,54,13.187393188476562,10.525344848632812,34,10
1044,128,2.8205512228464933,7.348443643714026,1.0019064341998623,1.0272054168103892,63,114,13.740962028503418,10.525344848632812,65,14
1045,1,11.065458695390715,11.065458695390715,0.9150593301777037,0.9150593301777048,0,0,11.347514152526855,11.347514152526855,1,1
1045,2,10.493118259599227,10.493118259599225,0.9401832719780994,0.9401832719780994,0,0,13.248486518859863,11.347514152526855,2,2
1045,3,9.421678414628351,9.421678414628351,0.9768564786335006,0.9768564786335001,0,0,13.335480690002441,11.347514152526855,3,3
1045,4,8.997714491011019,8.997714491011019,0.991760440234762,0.9917604402347612,0,0,13.583587646484375,11.347514152526855,4,4
1045,8,8.866428923813348,8.909654915810133,0.9970709629086657,0.9961333849494783,2,2,13.728594779968262,11.347514152526855,6,6
1045,16,7.9929060755544565,8.39164505099439,1.0266660384555784,1.018645067301152,6,9,13.992025375366211,11.347514152526855,10,7
1045,32,7.171726299223183,8.297036192164342,1.0226565815793203,1.0233386949232253,11,21,14.876575469970703,11.347514152526855,21,11
1045,64,5.396575346360621,8.072879203946451,1.0158652930131948,1.0334767301660197,28,52,15.400259017944336,11.347514152526855,36,12
1045,128,3.051903873491538,7.755403417358926,1.00608933094334,1.0406793667234062,58,108,15.992491722106934,11.347514152526855,70,20
1046,1,8.324553556926087,8.32455355692607,0.9586616532859792,0.9586616532859812,0,0,8.417280197143555,8.417280197143555,1,1
1046,2,6.547476193883737,6.547476193883738,0.9909327051491827,0.990932705149183,0,0,8.539740562438965,8.417280197143555,2,2
1046,3,6.54745283017605,6.54745283017605,0.9909738374247441,0.9909738374247442,0,0,8.847966194152832,8.417280197143555,3,3
1046,4,6.433538965020292,6.445003765199447,0.9935544806622361,0.9941377954090305,1,1,8.874090194702148,8.417280197143555,3,3
1046,8,5.371493578643509,5.432340578026076,1.0105983571054806,1.0118435849282847,2,2,9.33895206451416,8.417280197143555,6,6
1046,16,4.889876924874943,5.18357789915549,1.0155275048365886,1.0198695286499992,5,6,10.110157012939453,8.417280197143555,11,10
1046,32,4.358860506756049,5.146269631959989,1.0234623538158136,1.0234618421978312,12,16,10.590606689453125,8.417280197143555,20,16
1046,64,3.3670746625657753,5.034154885892063,1.0127271323215228,1.0265098926001137,30,49,11.341742515563965,8.417280197143555,34,15
1046,128,1.9396650482665616,4.998257729049938,1.00494029845044,1.029580613734572,59,111,12.072999000549316,8.417280197143555,69,17
1047,1,9.447767833380244,9.447767833380247,0.935167585847179,0.9351675858471802,0,0,9.64597225189209,9.64597225189209,1,1
1047,2,8.601748289042666,8.601748289042664,0.9649868983728388,0.9649868983728394,0,0,11.6862211227417,9.64597225189209,2,2
1047,3,8.134389553246917,8.134389553246919,0.9810144302674693,0.9810144302674703,0,0,11.975069999694824,9.64597225189209,3,3
1047,4,7.929980846838128,7.929980846838129,0.987455445575709,0.9874554455757091,0,0,12.577176094055176,9.64597225189209,4,4
1047,8,7.8111656683576856,7.8246750584813425,0.9936232975641324,0.9939704832495817,1,1,12.92966079711914,9.64597225189209,7,7
1047,16,7.427418167437466,7.605869173666738,1.001454857712325,1.005155099138177,7,7,13.455708503723145,9.64597225189209,9,9
1047,32,6.133255370888487,6.875977315525206,1.0224993857007996,1.0269047724442488,16,23,14.144368171691895,9.64597225189209,16,9
1047,64,4.5680359125419105,6.726450689939696,1.019279091967683,1.0349044568822323,31,49,15.043395042419434,9.64597225189209,33,15
1047,128,2.8168535208184817,6.7102885243524755,1.0033875512557093,1.0372084967656119,66,111,15.828824043273926,9.64597225189209,62,17
1048,1,12.484674188253546,12.484674188253551,0.9125623312781876,0.9125623312781898,0,0,12.754691123962402,12.754691123962402,1,1
1048,2,11.4862395512372,11.486239551237201,0.9425330115443991,0.9425330115444002,0,0,12.831853866577148,12.754691123962402,2,2
1048,3,9.367175602318426,9.367175602318428,0.9980560624526416,0.9980560624526417,0,0,12.953669548034668,12.754691123962402,3,3
1048,4,8.470199730363834,8.470199730363834,1.0146394632944054,1.014639463294406,0,0,12.98120403289795,12.754691123962402,4,4
1048,8,8.161950461673529,8.16558140395252,1.0254077613037031,1.0253968358055243,1,2,13.756599426269531,12.754691123962402,7,6
1048,16,7.882489069258065,8.010468613867367,1.0292761612031094,1.030105667359111,7,8,14.16879940032959,12.754691123962402,9,8
1048,32,7.094185732808156,7.935199053849533,1.0326373594764857,1.0336522265005474,14,21,14.644878387451172,12.754691123962402,18,11
1048,64,5.044737052069026,7.7622859283941645,1.017510372525621,1.0397842771637278,26,52,15.225431442260742,12.754691123962402,38,12
1048,128,3.3733974825268405,7.678764248223666,1.0128029085336945,1.043282779101844,63,114,15.755157470703125,12.754691123962402,65,14
1049,1,7.2652853292211,7.265285329221101,0.9751112815308096,0.9751112815308121,0,0,7.303761005401611,7.303761005401611,1,1
1049,2,6.1707044892204514,6.170704489220452,0.9867794068148936,0.9867794068148932,0,0,7.778510093688965,7.303761005401611,2,2
1049,3,5.606120644071067,5.606120644071067,1.0024807502150628,1.0024807502150619,0,0,8.456393241882324,7.303761005401611,3,3
1049,4,5.152762955349399,5.152762955349398,1.0076161633892111,1.0076161633892118,0,0,8.538334846496582,7.303761005401611,4,4
1049,8,4.467560411283037,4.488824981610068,1.0202389051229503,1.0200903380219395,1,2,8.972591400146484,7.303761005401611,7,6
1049,16,3.6904812238705396,3.810031480393578,1.025533714529767,1.0267125197090552,5,5,9.56866455078125,7.303761005401611,11,11
1049,32,3.363804346754221,3.749944904805571,1.02186003115817,1.0270538098400341,9,19,10.281787872314453,7.303761005401611,23,13
1049,64,2.401100500330554,3.7006601542520317,1.0108859153301084,1.0294861653894267,29,49,11.009163856506348,7.303761005401611,35,15
1049,128,1.273384407227835,3.695872607795821,1.0031289959453056,1.0305002305288817,65,110,11.939533233642578,7.303761005401611,63,18
1050,1,9.386208368895923,9.386208368895922,0.9475631410453034,0.9475631410453048,0,0,9.514019012451172,9.514019012451172,1,1
1050,2,8.383448659133336,8.383448659133336,0.9755109527283845,0.9755109527283856,0,0,10.511744499206543,9.514019012451172,2,2
1050,3,8.190456639478274,8.190456639478274,0.9800884367579288,0.9800884367579299,0,0,10.708795547485352,9.514019012451172,3,3
1050,4,8.002370156280662,8.002370156280662,0.9834553545379772,0.9834553545379776,0,0,11.076224327087402,9.514019012451172,4,4
1050,8,6.6790601378291985,6.786917846230638,1.012612330929848,1.0108707146251774,1,2,11.180883407592773,9.514019012451172,7,6
1050,16,6.164739203724934,6.503298706265951,1.0226944528334645,1.0201702809218882,5,7,11.809416770935059,9.514019012451172,11,9
1050,32,5.451208295250634,6.38208984318106,1.019939493275208,1.0233946309549553,13,19,12.536992073059082,9.514019012451172,19,13
1050,64,4.036818136630894,6.1948524100055,1.0127548613415063,1.0353854896430161,29,48,13.472888946533203,9.514019012451172,35,16
1050,128,2.193192169721966,6.171799624827989,1.0023366823735445,1.0387741444504768,59,109,14.460074424743652,9.514019012451172,69,19
1051,1,13.248889235381531,13.248889235381531,0.8815194324196163,0.8815194324196169,0,0,13.713953018188477,13.713953018188477,1,1
1051,2,11.266566271406091,11.266566271406093,0.9530957033952935,0.9530957033952949,0,0,14.667990684509277,13.713953018188477,2,2
1051,3,10.826332426278746,10.826332426278746,0.9678664645323685,0.9678664645323698,0,0,14.924633979797363,13.713953018188477,3,3
1051,4,9.812191234454689,9.81219123445469,1.0006170883283039,1.000617088328305,0,0,15.008852005004883,13.713953018188477,4,4
1051,8,9.672823126408053,9.699585503143929,1.0086233872615105,1.0077200384569902,1,1,15.15718936920166,13.713953018188477,7,7
1051,16,9.27066092882121,9.590844444514799,1.0207374085571976,1.0102057366946937,5,6,15.349892616271973,13.713953018188477,11,10
1051,32,8.738001168163,9.182187412812754,1.0343130109398309,1.0256966549451407,12,20,15.577180862426758,13.713953018188477,20,12
1051,64,7.809589049307345,9.156264717677793,1.0285236135825486,1.0255778125667412,25,49,15.759306907653809,13.713953018188477,39,15
1051,128,5.626071882252181,9.123140535911991,1.013677766161576,1.0277496406016233,66,112,15.9264554977417,13.713953018188477,62,16
1052,1,9.929284964134354,9.929284964134336,0.9325669147019751,0.9325669147019782,0,0,10.12971019744873,10.12971019744873,1,1
1052,2,8.032651992760977,8.032651992760977,0.9798924495859447,0.979892449585947,0,0,10.31443977355957,10.12971019744873,2,2
1052,3,7.565692919907214,7.565692919907216,0.9889202012696027,0.9889202012696048,0,0,10.638862609863281,10.12971019744873,3,3
1052,4,7.243850998663672,7.243850998663673,0.9961553042852073,0.9961553042852093,0,0,10.806421279907227,10.12971019744873,4,4
1052,8,7.0305182436146145,7.03432531176041,1.002590231923482,1.0026790259080705,1,1,11.220314025878906,10.12971019744873,7,7
1052,16,6.195033009710705,6.364820865893497,1.0230989725103998,1.021172511030375,5,5,11.96873950958252,10.12971019744873,11,11
1052,32,5.403552804885465,6.257321250413848,1.0260305100573435,1.0272273109299062,17,16,12.451091766357422,10.12971019744873,15,16
1052,64,3.975398083538107,6.119355598698114,1.0099415688710214,1.034429602678026,28,48,13.204629898071289,10.12971019744873,36,16
1052,128,2.4703652397131277,6.118168775549008,1.0007266501331675,1.0347248939841556,71,111,13.916216850280762,10.12971019744873,57,17
1053,1,8.24603071353472,8.246030713534719,0.9590014422649894,0.9590014422649924,0,0,8.334378242492676,8.334378242492676,1,1
1053,2,7.142138771203488,7.142138771203485,0.9830264251007297,0.9830264251007308,0,0,8.872270584106445,8.334378242492676,2,2
1053,3,6.0354804522712655,6.035480452271266,1.005432632287912,1.005432632287913,0,0,9.024166107177734,8.334378242492676,3,3
1053,4,5.999551040521313,5.999551040521313,1.006658879965453,1.006658879965453,0,0,9.359542846679688,8.334378242492676,4,4
1053,8,4.6020885125747455,4.6020885125747455,1.0292378445403672,1.0292378445403676,0,0,9.876380920410156,8.334378242492676,8,8
1053,16,4.153341247273203,4.232260323547613,1.035210642994545,1.0367446066252637,2,2,10.49439525604248,8.334378242492676,14,14
1053,32,3.6905991128769275,4.219530562068498,1.0275657841057757,1.0369285030817532,14,15,11.144220352172852,8.334378242492676,18,17
1053,64,3.169176441210697,4.1850811209745675,1.013421255497216,1.0390883761121588,36,49,12.005472183227539,8.334378242492676,28,15
1053,128,2.238416892421985,4.18351293465617,1.004466527974876,1.0396879370900634,62,111,12.944174766540527,8.334378242492676,66,17
1054,1,9.619737120800393,9.619737120800393,0.9452595201773777,0.9452595201773795,0,0,9.760180473327637,9.760180473327637,1,1
1054,2,8.231535064050126,8.231535064050128,0.9776668547766243,0.9776668547766246,0,0,9.872196197509766,9.760180473327637,2,2
1054,3,7.055714751804385,7.055714751804385,0.9989003214331934,0.9989003214331931,0,0,10.062101364135742,9.760180473327637,3,3
1054,4,7.016667426476823,7.016667426476824,0.9999934627169844,0.999993462716984,0,0,10.313474655151367,9.760180473327637,4,4
1054,8,6.384366384874209,6.483715526592112,1.0095402668087807,1.0097140286415995,3,3,10.779479026794434,9.760180473327637,5,5
1054,16,6.114471904046849,6.279946249687452,1.0182966743446122,1.0169766163506653,5,8,11.01161003112793,9.760180473327637,11,8
1054,32,5.337642490998049,6.141355798090336,1.0239441961537832,1.0207708214029951,14,22,11.314384460449219,9.760180473327637,18,10
1054,64,4.215533794753735,5.753675519853597,1.0205795175739312,1.0285329009488655,29,49,11.696940422058105,9.760180473327637,35,15
1054,128,2.1862333867143695,5.5042087506623645,1.0059025569204942,1.0341240704065773,57,109,12.133073806762695,9.760180473327637,71,19
1055,1,9.878577133914073,9.878577133914076,0.9391704152627944,0.9391704152627963,0,0,10.0438871383667,10.0438871383667,1,1
1055,2,8.987513932143575,8.987513932143575,0.9650895320636037,0.965089532063605,0,0,10.439425468444824,10.0438871383667,2,2
1055,3,8.316772557271703,8.316772557271703,0.9803945152992679,0.9803945152992688,0,0,10.664179801940918,10.0438871383667,3,3
1055,4,7.7541138018414895,7.754113801841491,0.9972993836366859,0.9972993836366878,0,0,11.337198257446289,10.0438871383667,4,4
1055,8,6.876604754119518,6.876604754119519,1.0194071794876185,1.0194071794876183,0,0,11.473764419555664,10.0438871383667,8,8
1055,16,6.046104715303925,6.538086909274302,1.025369041101177,1.0287605660433452,5,7,11.988998413085938,10.0438871383667,11,9
1055,32,5.335562650601406,6.298378605710458,1.0231092805648385,1.037667726093813,14,18,12.406257629394531,10.0438871383667,18,14
1055,64,4.030899067145817,5.852026651618117,1.0197574198695694,1.0437324372121923,33,49,13.065669059753418,10.0438871383667,31,15
1055,128,2.6267190451670204,5.797158679775837,1.0078344388313412,1.0470489012778077,57,109,13.822898864746094,10.0438871383667,71,19
1056,1,10.497420302318652,10.49742030231866,0.9295183867767519,0.9295183867767557,0,0,10.701725006103516,10.701725006103516,1,1
1056,2,9.573740140766926,9.573740140766931,0.9560522873369937,0.9560522873369968,0,0,11.117871284484863,10.701725006103516,2,2
1056,3,7.805222828578738,7.8052228285787395,0.995366621254767,0.9953666212547679,0,0,11.141145706176758,10.701725006103516,3,3
1056,4,7.394237988510082,7.394237988510082,1.0034928481064238,1.0034928481064256,0,0,11.621288299560547,10.701725006103516,4,4
1056,8,7.151375121698426,7.215656765504224,1.011672579508685,1.0111895388091043,2,2,12.731060981750488,10.701725006103516,6,6
1056,16,6.7192465392205705,7.010517779181365,1.02114455651489,1.020141132550864,6,7,13.204538345336914,10.701725006103516,10,9
1056,32,6.182150214438,6.907617491937923,1.0279190803265297,1.0253790299274277,14,23,13.70206069946289,10.701725006103516,18,9
1056,64,4.575612094141438,6.7971701333412575,1.014161734959918,1.0322824178530468,28,51,14.448201179504395,10.701725006103516,36,13
1056,128,2.8965746606023552,6.782127280965309,1.0055912375183143,1.0333847406826162,61,114,15.31331729888916,10.701725006103516,67,14
1057,1,6.8623841854126635,6.8623841854126635,0.9726571820368227,0.9726571820368235,0,0,6.911874771118164,6.911874771118164,1,1
1057,2,6.356566447892111,6.356566447892111,0.982701304218831,0.9827013042188317,0,0,7.40586519241333,6.911874771118164,2,2
1057,3,5.71409165182197,5.714091651821969,0.9899940453056355,0.9899940453056361,0,0,7.451539993286133,6.911874771118164,3,3
1057,4,5.421491428953407,5.421491428953406,0.9947384720339247,0.9947384720339247,0,0,7.689498424530029,6.911874771118164,4,4
1057,8,4.887409068480166,4.887409068480165,1.0052213442476585,1.0052213442476583,0,0,7.903805255889893,6.911874771118164,8,8
1057,16,4.412806180391303,4.8003697206175255,1.0070230284793493,1.0067186684440121,6,6,8.667689323425293,6.911874771118164,10,10
1057,32,3.6212318831227894,4.610565126706812,1.0072380016901255,1.0108633761710455,11,19,9.335600852966309,6.911874771118164,21,13
1057,64,2.510952385409075,4.509432477778841,1.0025431942950784,1.0136284564899558,34,48,9.79915714263916,6.911874771118164,30,16
1057,128,1.206828952649683,4.431175707520748,1.0005221210233752,1.0184841248643155,70,111,10.457091331481934,6.911874771118164,58,17
1058,1,9.365892488018018,9.365892488018018,0.9436470017128934,0.9436470017128944,0,0,9.519890785217285,9.519890785217285,1,1
1058,2,8.464858440516556,8.464858440516556,0.962029168889508,0.9620291688895082,0,0,9.688215255737305,9.519890785217285,2,2
1058,3,8.244020252371962,8.24402025237196,0.9672640491781136,0.9672640491781134,0,0,9.788108825683594,9.519890785217285,3,3
1058,4,7.1183590424988,7.129979937719203,0.9928309339380432,0.9925455857506098,1,1,10.066621780395508,9.519890785217285,3,3
1058,8,6.507552774597854,6.710972474138635,0.9978137990388025,0.9988423112737336,3,3,10.831076622009277,9.519890785217285,5,5
1058,16,6.289741520802052,6.677585597919753,1.0018343441031736,1.0010162903406299,5,9,11.10600471496582,9.519890785217285,11,7
1058,32,5.36029477881223,6.5227879190568965,1.0059359162069819,1.006695404324759,13,22,11.433828353881836,9.519890785217285,19,10
1058,64,4.0579972385539085,6.256773679561982,1.0071613072273573,1.014145824130264,28,55,12.24081039428711,9.519890785217285,36,9
1058,128,2.28970309259253,6.118512256799769,1.0031001963400508,1.0221091856272868,57,115,13.03219985961914,9.519890785217285,71,13
1059,1,9.154472549210231,9.154472549210233,0.9586603420420019,0.9586603420420031,0,0,9.236556053161621,9.236556053161621,1,1
1059,2,7.432956324295763,7.432956324295762,0.995435560118735,0.9954355601187357,0,0,10.048280715942383,9.236556053161621,2,2
1059,3,6.728823972077466,6.728823972077466,1.0073170094474542,1.007317009447454,0,0,10.287428855895996,9.236556053161621,3,3
1059,4,6.616784783235,6.616784783235,1.0091088641699868,1.009108864169986,0,0,10.375789642333984,9.236556053161621,4,4
1059,8,5.908347138962532,5.908347138962532,1.0226745942457054,1.0226745942457054,0,0,10.713014602661133,9.236556053161621,8,8
1059,16,5.177261278105689,5.594160933708237,1.030322324611281,1.0315715409655282,6,8,11.568355560302734,9.236556053161621,10,8
1059,32,4.728292415919585,5.362827152752706,1.0325756185403758,1.0391613090662404,12,21,12.651098251342773,9.236556053161621,20,11
1059,64,3.2912468626491824,5.333262048966245,1.0166489473282947,1.0418763737804488,28,48,13.298466682434082,9.236556053161621,36,16
1059,128,2.235026727613615,5.209632261000306,1.0068863114032918,1.0497081942680824,64,112,14.061049461364746,9.236556053161621,64,16
1060,1,8.7258051390228,8.7258051390228,0.9458918720036698,0.9458918720036715,0,0,8.876896858215332,8.876896858215332,1,1
1060,2,7.09700352851153,7.097003528511531,0.980827406213394,0.9808274062133955,0,0,8.90017032623291,8.876896858215332,2,2
1060,3,6.7730330054747805,6.7730330054747805,0.9862674270083636,0.9862674270083638,0,0,8.961761474609375,8.876896858215332,3,3
1060,4,6.726743698959257,6.726743698959256,0.9872312657682276,0.9872312657682273,0,0,9.071898460388184,8.876896858215332,4,4
1060,8,6.581109099073441,6.5811090990734415,0.9903141988612622,0.9903141988612596,0,0,9.268121719360352,8.876896858215332,8,8
1060,16,5.843158722413023,5.918093146644195,1.0046152565976585,1.0042397857437608,4,6,9.579253196716309,8.876896858215332,12,10
1060,32,4.981826074230062,5.36426862734334,1.0167523085110641,1.0170546691529327,13,20,10.12653923034668,8.876896858215332,19,12
1060,64,3.6883769127214516,5.287857446400448,1.0043104839745056,1.020976966988546,31,49,10.879312515258789,8.876896858215332,33,15
1060,128,2.4401296074068677,5.269508453690805,0.9960480847343129,1.0217247047314926,67,111,11.642080307006836,8.876896858215332,61,17
1061,1,8.057593237893878,8.05759323789388,0.969279813388062,0.9692798133880659,0,0,8.108025550842285,8.108025550842285,1,1
1061,2,6.626992450137784,6.626992450137785,0.9973723096934015,0.9973723096934045,0,0,9.499831199645996,8.108025550842285,2,2
1061,3,5.8443547011340975,5.8443547011340975,1.0128904570879755,1.0128904570879778,0,0,9.665513038635254,8.108025550842285,3,3
1061,4,5.517155704257758,5.517155704257755,1.0202880043801612,1.0202880043801636,0,0,9.779227256774902,8.108025550842285,4,4
1061,8,5.152350366540195,5.163341012390292,1.0248504071695015,1.0248146354552272,1,1,10.089994430541992,8.108025550842285,7,7
1061,16,4.883886516600785,5.102132613755006,1.0278330451078352,1.0266483964893487,4,6,10.6358060836792,8.108025550842285,12,10
1061,32,4.315893288987402,4.8071377981607295,1.0313296844999584,1.0338923817787236,12,21,11.231230735778809,8.108025550842285,20,11
1061,64,3.464004532320028,4.79248772965675,1.0148426689750134,1.0354766663138353,34,50,12.066523551940918,8.108025550842285,30,14
1061,128,2.196714217210906,4.72841285675012,1.0042229501595827,1.0392439950886745,61,111,12.80515193939209,8.108025550842285,67,17
1062,1,6.115284582241141,6.115284582241142,0.9756807860634739,0.975680786063475,0,0,6.1602911949157715,6.1602911949157715,1,1
1062,2,4.51658328617527,4.516583286175269,0.9968204437456529,0.9968204437456542,0,0,6.276843547821045,6.1602911949157715,2,2
1062,3,4.169293751634946,4.169293751634946,1.0003255882084854,1.0003255882084858,0,0,6.323965549468994,6.1602911949157715,3,3
1062,4,4.143399961763556,4.169293751634946,1.00019294144875,1.0003255882084858,1,1,6.396018981933594,6.1602911949157715,3,3
1062,8,3.3331654900239562,3.352387547063586,1.0081081060826629,1.0081077143243842,1,2,6.779317855834961,6.1602911949157715,7,6
1062,16,2.749723228211845,3.053839426735569,1.0117326736167285,1.0118657042145918,6,7,7.276636600494385,6.1602911949157715,10,9
1062,32,2.3449761398818896,2.983942994130044,1.0100599382032944,1.0117112386849425,12,23,8.08161735534668,6.1602911949157715,20,9
1062,64,1.6031245612383562,2.9484493816764568,1.0012126174299842,1.0133306387249532,32,53,8.947566986083984,6.1602911949157715,32,11
1062,128,0.8673092162037,2.9484493816764568,0.9992097479833797,1.0133306387249532,61,117,9.903268814086914,6.1602911949157715,67,11
1063,1,11.519856461383874,11.51985646138388,0.920510372257331,0.9205103722573337,0,0,11.753373146057129,11.753373146057129,1,1
1063,2,9.1700450504481,9.170045050448099,0.9887718000925148,0.9887718000925176,0,0,12.164995193481445,11.753373146057129,2,2
1063,3,9.02475609805144,9.024756098051443,0.9924610050529692,0.9924610050529717,0,0,12.326455116271973,11.753373146057129,3,3
1063,4,8.236325122628815,8.244530751870887,1.0077983854551813,1.0077863887298146,1,1,12.397394180297852,11.753373146057129,3,3
1063,8,8.095288118804314,8.115338384226638,1.015363890031967,1.0168130835374092,2,2,13.4927396774292,11.753373146057129,6,6
1063,16,7.02226587769356,7.480170535680527,1.0297820993242743,1.0394103865406854,5,6,14.197246551513672,11.753373146057129,11,10
1063,32,6.380849399447729,7.31584740264359,1.0288691551008906,1.0476759712676507,17,20,15.151543617248535,11.753373146057129,15,12
1063,64,5.198464944470098,7.16733472924741,1.0244346196467315,1.055146607174541,35,46,15.748332977294922,11.753373146057129,29,18
1063,128,3.211302754405066,7.118972407049328,1.005844718290056,1.0580550249916367,65,111,16.48148536682129,11.753373146057129,63,17
1064,1,8.751620685484983,8.75162068548499,0.9509743112463778,0.9509743112463813,0,0,8.873580932617188,8.873580932617188,1,1
1064,2,6.645390099454272,6.645390099454266,0.9917766691319768,0.99177666913198,0,0,9.312336921691895,8.873580932617188,2,2
1064,3,6.412044434302822,6.412044434302824,0.9991158285451024,0.9991158285451045,0,0,10.27924919128418,8.873580932617188,3,3
1064,4,5.857025451467728,5.857025451467727,1.009205207994016,1.009205207994017,0,0,10.321681022644043,8.873580932617188,4,4
1064,8,5.7622575592918,5.830604845449541,1.008971785354875,1.0111772151690674,2,2,11.069808959960938,8.873580932617188,6,6
1064,16,5.046201540820845,5.626903267744529,1.0170677426790435,1.0196102494427142,8,7,11.618232727050781,8.873580932617188,8,9
1064,32,3.9323836224964315,5.23755960456889,1.0158490591107936,1.0315821498903626,16,23,12.609867095947266,8.873580932617188,16,9
1064,64,3.1590401141716957,5.11113436966446,1.012996892053816,1.0355513229229165,28,53,13.417437553405762,8.873580932617188,36,11
1064,128,1.9073351261986597,5.095401976076213,1.0034221788736846,1.0376874653134778,59,115,14.351690292358398,8.873580932617188,69,13
1065,1,9.872053376257867,9.872053376257867,0.9418538354780326,0.9418538354780361,0,0,10.021763801574707,10.021763801574707,1,1
1065,2,9.387994742208438,9.38799474220844,0.9571575438107638,0.9571575438107666,0,0,11.143425941467285,10.021763801574707,2,2
1065,3,8.816252321740475,8.816252321740476,0.9694280930521425,0.9694280930521444,0,0,11.33083724975586,10.021763801574707,3,3
1065,4,8.242773180398242,8.242773180398245,0.9872575752050611,0.9872575752050625,0,0,11.340254783630371,10.021763801574707,4,4
1065,8,7.620492097116879,7.6204920971168795,1.001832005000667,1.0018320050006677,0,0,11.578667640686035,10.021763801574707,8,8
1065,16,6.715832174658873,7.027753125891406,1.0146506962407007,1.017374988364306,7,7,12.289031028747559,10.021763801574707,9,9
1065,32,5.955939239336173,7.0044028383108925,1.012642776240147,1.020142385120408,13,19,12.784525871276855,10.021763801574707,19,13
1065,64,4.8823031294614205,6.909649935298231,1.0145948540293719,1.0256360953200936,27,46,13.34987735748291,10.021763801574707,37,18
1065,128,3.110965459240508,6.694207770460747,1.009651902112716,1.0398473549449203,58,109,13.985685348510742,10.021763801574707,70,19
1066,1,2.9401311248452724,2.9401311248452724,0.9943482930693142,0.994348293069315,0,0,2.9453604221343994,2.9453604221343994,1,1
1066,2,2.570353938881368,2.570353938881368,0.9966970477203008,0.9966970477203012,0,0,3.0755350589752197,2.9453604221343994,2,2
1066,3,2.3459123198801244,2.345912319880125,0.9971774075840592,0.9971774075840592,0,0,3.2795510292053223,2.9453604221343994,3,3
1066,4,2.3456865652371635,2.345686565237164,0.9971810203816722,0.9971810203816726,0,0,3.352001905441284,2.9453604221343994,4,4
1066,8,2.2503235389991842,2.318237387565667,0.9970058690395207,0.9972739925313637,3,3,3.9151792526245117,2.9453604221343994,5,5
1066,16,1.7219228452891369,1.9434538012535352,1.002020554730839,1.0019691405800144,3,8,4.269716262817383,2.9453604221343994,13,8
1066,32,0.9641891432651846,1.791269893821421,1.0004475044225232,1.0042638525971253,15,22,4.661388874053955,2.9453604221343994,17,10
1066,64,0.6275412000360415,1.791269893821421,0.9991490288566296,1.0042638525971253,30,54,5.219769477844238,2.9453604221343994,34,10
1066,128,0.08085595951574938,1.791269893821421,0.9986093910306655,1.0042638525971253,66,118,5.983343601226807,2.9453604221343994,62,10
1067,1,5.025151066689264,5.025151066689264,0.9847206922602261,0.9847206922602264,0,0,5.046409606933594,5.046409606933594,1,1
1067,2,4.228481327362921,4.228481327362921,0.9939133637896069,0.9939133637896069,0,0,5.783788681030273,5.046409606933594,2,2
1067,3,3.4807216541265853,3.4807216541265844,1.0014297838311625,1.0014297838311617,0,0,5.8682756423950195,5.046409606933594,3,3
1067,4,3.4704412166104355,3.4704412166104355,1.0016046619325167,1.0016046619325158,0,0,5.9898481369018555,5.046409606933594,4,4
1067,8,2.840106856673991,2.956469225143602,1.0080094770144756,1.0088883216764533,1,1,6.6495490074157715,5.046409606933594,7,7
1067,16,2.544810890928033,2.8122800942382433,1.0104141642435425,1.0107944389025418,5,6,7.145038604736328,5.046409606933594,11,10
1067,32,2.1282556814140157,2.74851392065352,1.008957205384006,1.0121355900257498,15,20,7.786071300506592,5.046409606933594,17,12
1067,64,1.4831564908019255,2.669865218630267,1.0019986702398385,1.014693493750837,29,51,8.564750671386719,5.046409606933594,35,13
1067,128,0.8550431267173583,2.651546954519389,0.9988199714884353,1.0158897928640127,63,114,9.325545310974121,5.046409606933594,65,14
1068,1,13.704143037257369,13.704143037257372,0.8814866558927481,0.8814866558927511,0,0,14.15835952758789,14.15835952758789,1,1
1068,2,11.236858521535922,11.236858521535924,0.9616990290925702,0.9616990290925707,0,0,14.778925895690918,14.15835952758789,2,2
1068,3,11.087325375194153,11.087325375194153,0.967562142691324,0.9675621426913252,0,0,14.784839630126953,14.15835952758789,3,3
1068,4,11.087200461494444,11.087200461494444,0.9675562694629931,0.967556269462993,0,0,15.00699234008789,14.15835952758789,4,4
1068,8,9.828653688086561,9.970084907803217,1.01760314109183,1.0126960239865601,2,2,15.777295112609863,14.15835952758789,6,6
1068,16,9.25545234822004,9.503466890763157,1.0389413924298538,1.0377835717199515,5,5,17.435693740844727,14.15835952758789,11,11
1068,32,8.227503226848508,9.426779576860628,1.0305042273777167,1.046281784993503,13,18,18.05183982849121,14.15835952758789,19,14
1068,64,6.579772025989112,9.194213507247076,1.0287163873525704,1.0545053088019278,28,46,18.811721801757812,14.15835952758789,36,18
1068,128,4.8035710931052815,9.176549752519438,1.0020732397937486,1.0566966618046136,57,112,19.6090145111084,14.15835952758789,71,16
1069,1,6.564913258597241,6.56491325859724,0.9691178827390471,0.9691178827390476,0,0,6.630791187286377,6.630791187286377,1,1
1069,2,5.922330145448931,5.922330145448932,0.981190381475284,0.9811903814752849,0,0,7.458371639251709,6.630791187286377,2,2
1069,3,5.68865210831625,5.688652108316249,0.9857876701593076,0.9857876701593071,0,0,7.909015655517578,6.630791187286377,3,3
1069,4,5.613534515107439,5.613534515107439,0.9871307987813908,0.9871307987813904,0,0,7.911125659942627,6.630791187286377,4,4
1069,8,5.163042988360416,5.229740014104718,0.9945358903124228,0.9936789793584279,2,3,8.131230354309082,6.630791187286377,6,5
1069,16,4.7740556100438925,4.953780626863437,0.9996229151697044,0.9993426134440712,7,7,8.721715927124023,6.630791187286377,9,9
1069,32,3.516917398165662,4.548088596678054,1.0041217444820754,1.0064259314738948,13,18,9.277955055236816,6.630791187286377,19,14
1069,64,2.310295638173715,4.39311190206668,1.0035892211733182,1.0114931808026202,31,49,9.963395118713379,6.630791187286377,33,15
1069,128,1.1139520424327194,4.379403791949504,0.9979372177914776,1.0131883536424748,65,108,10.647529602050781,6.630791187286377,63,20
1070,1,9.189828587824914,9.189828587824916,0.9609501430133036,0.9609501430133057,0,0,9.261881828308105,9.261881828308105,1,1
1070,2,7.495299716465562,7.495299716465562,0.9932129543498354,0.9932129543498371,0,0,9.558279991149902,9.261881828308105,2,2
1070,3,7.081504332018396,7.081504332018396,0.9985830023879807,0.9985830023879805,0,0,9.843905448913574,9.261881828308105,3,3
1070,4,6.786651790808532,6.786651790808532,1.0026894971092308,1.0026894971092308,0,0,10.280217170715332,9.261881828308105,4,4
1070,8,6.32087233477195,6.320872334771951,1.01412238214696,1.0141223821469607,0,0,10.857375144958496,9.261881828308105,8,8
1070,16,5.897522583085103,6.058263593429745,1.021698431450868,1.0221879874195863,4,4,11.402200698852539,9.261881828308105,12,12
1070,32,4.960209833295942,6.006527956632696,1.0287822998176785,1.0252361040720857,13,18,11.858851432800293,9.261881828308105,19,14
1070,64,3.716022035908258,5.826633676679815,1.023526494891975,1.0307874140238211,33,50,12.444628715515137,9.261881828308105,31,14
1070,128,2.391365556299297,5.780219389664963,1.007856743435621,1.0345249239767105,60,113,13.153325080871582,9.261881828308105,68,15
1071,1,8.972552673411075,8.972552673411077,0.9471555058744007,0.9471555058744023,0,0,9.107272148132324,9.107272148132324,1,1
1071,2,8.242841612571267,8.242841612571265,0.9653337461946784,0.9653337461946789,0,0,9.28696346282959,9.107272148132324,2,2
1071,3,7.0260093292164765,7.0260093292164765,0.9906152677521489,0.99061526775215,0,0,9.354880332946777,9.107272148132324,3,3
1071,4,6.271487242678185,6.271487242678185,1.0028692505159578,1.0028692505159582,0,0,9.5557222366333,9.107272148132324,4,4
1071,8,5.78656773405731,5.847846557575469,1.009892550182648,1.0100986781694687,2,2,9.773398399353027,9.107272148132324,6,6
1071,16,5.613089584208523,5.629706645033748,1.014304139855379,1.013796041693075,5,8,10.18199348449707,9.107272148132324,11,8
1071,32,5.0444053372777775,5.468856971171729,1.0228805857305452,1.020032331898578,14,21,10.671419143676758,9.107272148132324,18,11
1071,64,4.018027962288162,5.38267694512271,1.0204031683196328,1.0230052825645992,27,51,11.19182014465332,9.107272148132324,37,13
1071,128,2.533912448794944,5.348140683976554,1.0053350495973405,1.025490471359492,62,110,11.89828872680664,9.107272148132324,66,18
1072,1,13.139794491240348,13.13979449124035,0.8890035622745762,0.8890035622745797,0,0,13.53250503540039,13.53250503540039,1,1
1072,2,11.61313441561208,11.613134415612082,0.9396177573236622,0.9396177573236639,0,0,13.913813591003418,13.53250503540039,2,2
1072,3,11.192250551038684,11.192250551038683,0.9513517746151567,0.9513517746151577,0,0,13.938109397888184,13.53250503540039,3,3
1072,4,10.633266291278701,10.633266291278701,0.9651829367628145,0.9651829367628164,0,0,14.113290786743164,13.53250503540039,4,4
1072,8,10.262756834960095,10.26618099221268,0.9812159954116237,0.9811770481647676,1,1,14.569121360778809,13.53250503540039,7,7
1072,16,9.266798145662486,9.502170616926426,1.0127716494059014,1.009850844454361,5,7,15.333535194396973,13.53250503540039,11,9
1072,32,8.065822909826476,9.500760389455019,1.0217824918712415,1.010392536798453,13,20,16.027238845825195,13.53250503540039,19,12
1072,64,6.1041170176243575,9.453425716724173,1.01438909551304,1.0148300762422975,29,54,16.54685401916504,13.53250503540039,35,10
1072,128,3.5884462516008675,9.33601767744547,1.008994760795176,1.0224397641326401,57,113,17.205570220947266,13.53250503540039,71,15
1073,1,7.849520246043752,7.849520246043754,0.9675312580095685,0.9675312580095706,0,0,7.9091973304748535,7.9091973304748535,1,1
1073,2,6.184733041463923,6.184733041463924,0.9959542889134262,0.9959542889134276,0,0,8.272186279296875,7.9091973304748535,2,2
1073,3,5.90862238013087,5.908622380130871,1.0012381023324308,1.001238102332432,0,0,8.302700996398926,7.9091973304748535,3,3
1073,4,5.860571383630887,5.860571383630886,1.0029569071367435,1.0029569071367441,0,0,8.98542308807373,7.9091973304748535,4,4
1073,8,5.5554339583010535,5.586464431785296,1.008224650041159,1.0088677460527664,2,3,9.301778793334961,7.9091973304748535,6,5
1073,16,4.691031680655098,5.28157390150916,1.0176175404704701,1.0146902448809652,3,8,9.724441528320312,7.9091973304748535,13,8
1073,32,3.9915186866728662,4.9408050720107175,1.0226202424285975,1.024463490938464,12,21,10.271891593933105,7.9091973304748535,20,11
1073,64,2.909226217656611,4.926150166951533,1.0132474346845788,1.0253236556240088,30,50,10.75284194946289,7.9091973304748535,34,14
1073,128,1.7468848700749073,4.79181076533065,1.0013880881768484,1.0287860781923175,56,116,11.78395938873291,7.9091973304748535,72,12
1074,1,10.926714117556028,10.926714117556028,0.9387261923986554,0.9387261923986577,0,0,11.072102546691895,11.072102546691895,1,1
1074,2,9.1774896445901,9.1774896445901,0.9831114647208795,0.9831114647208812,0,0,11.742512702941895,11.072102546691895,2,2
1074,3,8.573843183290132,8.573843183290133,0.9968256102969472,0.9968256102969478,0,0,12.1295747756958,11.072102546691895,3,3
1074,4,7.675363132358934,7.675363132358933,1.0150420182851183,1.015042018285119,0,0,12.278242111206055,11.072102546691895,4,4
1074,8,7.060962061790702,7.060962061790702,1.0322389681372375,1.0322389681372373,0,0,12.517873764038086,11.072102546691895,8,8
1074,16,6.605241980173566,6.738677762720252,1.0347600715304888,1.0363832442355483,4,6,12.96340274810791,11.072102546691895,12,10
1074,32,5.7726087771692285,6.367618160554918,1.0505813120849345,1.0461208965702544,15,19,13.68150520324707,11.072102546691895,17,13
1074,64,4.600984439515883,6.2863628218618395,1.038454534041494,1.0515873455197409,28,49,14.44074535369873,11.072102546691895,36,15
1074,128,2.9065266905287173,6.15429369230991,1.009627102697434,1.0568429385165947,55,111,15.20765495300293,11.072102546691895,73,17
1075,1,11.007419096611454,11.00741909661144,0.9259946208457154,0.9259946208457173,0,0,11.231459617614746,11.231459617614746,1,1
1075,2,9.527576371029111,9.527576371029113,0.9637018754014444,0.9637018754014447,0,0,11.481118202209473,11.231459617614746,2,2
1075,3,8.767570465209138,8.76757046520914,0.98097377949069,0.980973779490691,0,0,11.937627792358398,11.231459617614746,3,3
1075,4,8.435450664614201,8.4354506646142,0.9905541984724708,0.990554198472472,0,0,12.324504852294922,11.231459617614746,4,4
1075,8,7.667833826327178,7.685477626263691,1.0042434557601925,1.0045930225004716,2,2,12.727845191955566,11.231459617614746,6,6
1075,16,6.936826665479287,7.262470540487297,1.0281810326365248,1.0205736918644774,7,8,13.52204704284668,11.231459617614746,9,8
1075,32,6.205018285118436,7.166973838549533,1.0280433112782448,1.0236950554372304,16,22,13.799300193786621,11.231459617614746,16,10
1075,64,4.610984775153609,7.075817274547314,1.0236198442661293,1.0283667770770106,29,50,14.327552795410156,11.231459617614746,35,14
1075,128,2.665080815464412,6.962845850279904,1.0086020549417192,1.0355708356154851,67,113,14.760374069213867,11.231459617614746,61,15
1076,1,12.238151952731243,12.238151952731243,0.9181870098944465,0.9181870098944508,0,0,12.482537269592285,12.482537269592285,1,1
1076,2,10.910638018277847,10.910638018277849,0.955125479335628,0.9551254793356301,0,0,12.513962745666504,12.482537269592285,2,2
1076,3,9.855937107328288,9.855937107328288,0.9812093275756107,0.9812093275756115,0,0,12.636985778808594,12.482537269592285,3,3
1076,4,9.607996027611946,9.607996027611946,0.9883187112170595,0.9883187112170597,0,0,12.865386962890625,12.482537269592285,4,4
1076,8,8.606543159399203,8.607676829993787,1.0188087475068395,1.0189135143292263,2,2,13.928101539611816,12.482537269592285,6,6
1076,16,7.523929663499139,8.045531224343849,1.0429962060828002,1.0391223462679622,3,7,15.075499534606934,12.482537269592285,13,9
1076,32,6.1223443107789155,7.8032915658830495,1.0346936327556442,1.0546067863955275,13,17,15.68048095703125,12.482537269592285,19,15
1076,64,5.381596675006677,7.674038813721653,1.0309128692324527,1.0625421240233481,32,46,16.354293823242188,12.482537269592285,32,18
1076,128,3.5334879445186678,7.609088034385036,1.0124812725834902,1.065105200353298,63,108,17.255163192749023,12.482537269592285,65,20
1077,1,7.110041059159325,7.110041059159326,0.9745356017968719,0.9745356017968726,0,0,7.1516876220703125,7.1516876220703125,1,1
1077,2,5.670564832607024,5.670564832607023,0.9935290125322536,0.993529012532254,0,0,7.458487033843994,7.1516876220703125,2,2
1077,3,5.539699761257711,5.539699761257711,0.9954929299732371,0.9954929299732371,0,0,7.674141883850098,7.1516876220703125,3,3
1077,4,5.225078378405918,5.225078378405919,0.9991234377399774,0.9991234377399775,0,0,7.749889850616455,7.1516876220703125,4,4
1077,8,4.5309148457975414,4.532663980317212,1.007136096300031,1.0070715277375528,1,1,8.069697380065918,7.1516876220703125,7,7
1077,16,3.686656162558095,4.2626553558054905,1.0101911602625138,1.010903264718455,7,11,8.423803329467773,7.1516876220703125,9,5
1077,32,3.316224755743158,4.206111957880556,1.0088434613063724,1.0125131315474207,15,23,8.958703994750977,7.1516876220703125,17,9
1077,64,2.2509378215182947,4.055961953107102,1.0048357115991453,1.017960376161993,29,53,9.530240058898926,7.1516876220703125,35,11
1077,128,0.8811581807038452,3.9856960663471592,0.9996199766590133,1.0204108949362536,59,113,10.086860656738281,7.1516876220703125,69,15
1078,1,9.754097769346917,9.75409776934692,0.9452884979814248,0.9452884979814262,0,0,9.885852813720703,9.885852813720703,1,1
1078,2,8.340564896120284,8.340564896120284,0.9786981887355273,0.9786981887355279,0,0,9.981523513793945,9.885852813720703,2,2
1078,3,7.02979839864147,7.029798398641471,1.002215063281091,1.0022150632810916,0,0,10.296416282653809,9.885852813720703,3,3
1078,4,6.953874886148449,6.9538748861484505,1.0042862062329296,1.0042862062329307,0,0,10.411746978759766,9.885852813720703,4,4
1078,8,6.466119391565397,6.582364581518022,1.0139053514818785,1.0137272786832576,1,1,11.263466835021973,9.885852813720703,7,7
1078,16,5.767711105465006,6.443456898169206,1.0198438249370732,1.0198881414867114,7,7,11.88017463684082,9.885852813720703,9,9
1078,32,4.913543489051139,6.37192748167812,1.0155321853880461,1.0241927642244186,17,20,12.502906799316406,9.885852813720703,15,12
1078,64,3.476515517369449,6.1028899073533,1.0144869243578731,1.0358139223250475,27,45,12.952795028686523,9.885852813720703,37,19
1078,128,2.592095053860351,6.063021139039128,1.0072099221803774,1.0386707608077532,68,107,13.944005966186523,9.885852813720703,60,21
1079,1,7.714009014682392,7.714009014682393,0.9623496198382595,0.9623496198382616,0,0,7.797106742858887,7.797106742858887,1,1
1079,2,6.977582014434043,6.977582014434042,0.9756833614877443,0.9756833614877451,0,0,8.244017601013184,7.797106742858887,2,2
1079,3,6.919341018569128,6.919341018569129,0.9766749724729633,0.9766749724729642,0,0,8.260946273803711,7.797106742858887,3,3
1079,4,6.451580605884192,6.461927470856551,0.9858060793134802,0.9855426391186977,1,1,8.295548439025879,7.797106742858887,3,3
1079,8,6.287490024336368,6.318804505639474,0.9895601765586277,0.9886999363786851,1,1,8.384468078613281,7.797106742858887,7,7
1079,16,5.887737923994689,6.09170965208976,0.9983936964264417,0.9954097280667036,5,4,9.055375099182129,7.797106742858887,11,12
1079,32,3.930023639114071,5.10852993838085,1.0118144394220596,1.016312988896913,12,20,9.45755672454834,7.797106742858887,20,12
1079,64,2.876926400664146,4.825676288656652,1.007236106754212,1.022522069143792,33,52,9.8825101852417,7.797106742858887,31,12
1079,128,1.5966072492612182,4.7121763889392385,1.0025192003991106,1.0271514824471395,60,112,10.61865520477295,7.797106742858887,68,16
1080,1,7.772259648163894,7.772259648163895,0.9629017003192688,0.9629017003192721,0,0,7.852299213409424,7.852299213409424,1,1
1080,2,6.313244567235896,6.313244567235897,0.9838629326747645,0.9838629326747661,0,0,8.188249588012695,7.852299213409424,2,2
1080,3,6.059195430671938,6.059195430671938,0.9909700060107285,0.9909700060107304,0,0,9.832301139831543,7.852299213409424,3,3
1080,4,6.045561543117203,6.059195430671938,0.9901592942320886,0.9909700060107304,1,1,10.140219688415527,7.852299213409424,3,3
1080,8,5.2978585357614,5.315587624398921,1.014992561432512,1.0159872689122356,1,1,11.04134464263916,7.852299213409424,7,7
1080,16,5.046237795440841,5.315107361306237,1.0093736432307803,1.0161856562475458,7,8,11.604207992553711,7.852299213409424,9,8
1080,32,4.238830560133399,5.300707133678315,1.009129769037127,1.0175096606052847,17,22,12.004026412963867,7.852299213409424,15,10
1080,64,3.6143396666502112,5.0392447057873415,1.0107771805278585,1.0263903491795958,30,53,12.634758949279785,7.852299213409424,34,11
1080,128,1.9401717392218865,5.036527122395678,1.0025294638272304,1.0264225044998145,61,116,13.295241355895996,7.852299213409424,67,12
1081,1,9.973590089937584,9.973590089937586,0.9401707849865819,0.9401707849865821,0,0,10.136720657348633,10.136720657348633,1,1
1081,2,9.590957912891863,9.590957912891863,0.9563393033781936,0.9563393033781933,0,0,11.188860893249512,10.136720657348633,2,2
1081,3,8.879631369701485,8.879631369701483,0.976175855012965,0.976175855012964,0,0,11.371386528015137,10.136720657348633,3,3
1081,4,7.163086646980532,7.163086646980532,1.0144992483142672,1.0144992483142676,0,0,11.526087760925293,10.136720657348633,4,4
1081,8,6.550080274468544,6.590336683067538,1.0290589499982772,1.0300961384059497,2,2,11.861273765563965,10.136720657348633,6,6
1081,16,6.284977390217676,6.452404538968034,1.0311382713511614,1.034427238674889,5,5,12.201033592224121,10.136720657348633,11,11
1081,32,5.483008014016075,6.115939353083065,1.03512356683121,1.0416978898781464,14,19,12.834524154663086,10.136720657348633,18,13
1081,64,4.439925681952424,6.088721338093429,1.029325024004763,1.0434596988020217,34,50,13.192520141601562,10.136720657348633,30,14
1081,128,2.8486799682981503,6.002478830599254,1.0112121356363708,1.0475374794224226,63,111,13.65069580078125,10.136720657348633,65,17
1082,1,10.569933426944305,10.56993342694431,0.9285475095998957,0.9285475095998983,0,0,10.785210609436035,10.785210609436035,1,1
1082,2,9.410229478490642,9.410229478490644,0.9607026983445377,0.9607026983445399,0,0,10.976825714111328,10.785210609436035,2,2
1082,3,9.233088369683097,9.2330883696831,0.9660168824711388,0.9660168824711405,0,0,11.23287296295166,10.785210609436035,3,3
1082,4,8.793204462015922,8.793204462015922,0.9775238185198443,0.9775238185198462,0,0,11.523514747619629,10.785210609436035,4,4
1082,8,7.322751175124339,7.323193169591533,1.014859847212644,1.0148498235167631,1,1,11.792680740356445,10.785210609436035,7,7
1082,16,6.012327323224254,7.028871529329278,1.0283774907833374,1.0223727220171472,5,6,12.80411434173584,10.785210609436035,11,10
1082,32,4.9601773888684,6.997801251744539,1.0205173431609196,1.0258720391647858,13,19,13.77947998046875,10.785210609436035,19,13
1082,64,4.0152368170528305,6.608147389907491,1.0170336662903912,1.0417295999591527,33,48,14.481075286865234,10.785210609436035,31,16
1082,128,2.4780339888882414,6.601893186262743,1.0030547248734594,1.0433128697336183,62,111,15.393451690673828,10.785210609436035,66,17
1083,1,6.431298344444965,6.431298344444965,0.9812865708779444,0.9812865708779476,0,0,6.455951690673828,6.455951690673828,1,1
1083,2,5.636033214080648,5.636033214080646,0.9927066404807704,0.9927066404807725,0,0,6.903849124908447,6.455951690673828,2,2
1083,3,5.397054187699615,5.397054187699616,0.9957346036498771,0.9957346036498786,0,0,7.309764385223389,6.455951690673828,3,3
1083,4,4.26052978419544,4.275083172699356,1.0089096379047646,1.008735201699496,1,1,7.551209926605225,6.455951690673828,3,3
1083,8,3.853609788012524,3.8539966194325497,1.0167794814941082,1.0167824272554256,1,1,7.899984836578369,6.455951690673828,7,7
1083,16,3.7984689090755017,3.8481494275974923,1.0165166960524743,1.0169783260750387,5,6,8.673314094543457,6.455951690673828,11,10
1083,32,3.300770271614034,3.809898070994913,1.0119764248842964,1.0203265300841684,13,18,9.404501914978027,6.455951690673828,19,14
1083,64,2.4906268135493335,3.7591750635098817,1.003413859662269,1.0221718540358813,31,50,10.120184898376465,6.455951690673828,33,14
1083,128,1.540748839700545,3.752947722977675,0.9987323661885252,1.0224600828118384,65,113,11.054319381713867,6.455951690673828,63,15
1084,1,4.50640618994138,4.506406189941374,0.9850957365775314,0.9850957365775328,0,0,4.529622554779053,4.529622554779053,1,1
1084,2,3.7245156202376926,3.7245156202376934,0.9923130535813869,0.992313053581388,0,0,4.671816825866699,4.529622554779053,2,2
1084,3,3.646600158469916,3.6466001584699184,0.993430292154956,0.9934302921549576,0,0,4.705039024353027,4.529622554779053,3,3
1084,4,3.518801594684796,3.518801594684796,0.9951105024914727,0.9951105024914733,0,0,4.708481788635254,4.529622554779053,4,4
1084,8,3.4490721641379922,3.4856766136747845,0.9961600004719959,0.9958240230596218,3,3,4.864211559295654,4.529622554779053,5,5
1084,16,3.1328045076013247,3.200351231531515,0.9993464546171793,0.9983180080641024,6,8,5.101932048797607,4.529622554779053,10,8
1084,32,2.5777877546662697,3.024045418087338,1.0011484264912234,1.0008686027298137,13,22,5.456146240234375,4.529622554779053,19,10
1084,64,1.895680013726832,2.9660803828166338,0.9995074711923357,1.0023847235570922,29,47,5.989241600036621,4.529622554779053,35,17
1084,128,0.7126994746276264,2.8579350564642083,0.9992710532245646,1.0050586594799635,64,112,6.602298736572266,4.529622554779053,64,16
1085,1,8.739147536980024,8.739147536980024,0.9534117966006697,0.9534117966006715,0,0,8.849197387695312,8.849197387695312,1,1
1085,2,6.315625673682667,6.315625673682665,1.0013132768676865,1.0013132768676867,0,0,9.134549140930176,8.849197387695312,2,2
1085,3,6.073918102232112,6.073918102232112,1.0035873283519294,1.0035873283519297,0,0,9.409805297851562,8.849197387695312,3,3
1085,4,5.950308546640597,5.950308546640597,1.0069441932173557,1.0069441932173548,0,0,9.977798461914062,8.849197387695312,4,4
1085,8,5.023412715245578,5.028240086978961,1.024266421580375,1.0238918708829372,1,1,10.25850772857666,8.849197387695312,7,7
1085,16,4.7029705091404646,4.775375197423912,1.0304143621614414,1.0297003327986645,2,5,10.655362129211426,8.849197387695312,14,11
1085,32,3.9995058098544556,4.64108209459468,1.0283509323147382,1.0320822231795403,12,20,11.405854225158691,8.849197387695312,20,12
1085,64,2.9361065090055987,4.634973933181044,1.0081856680381833,1.0330465031612,34,50,12.261456489562988,8.849197387695312,30,14
1085,128,1.7235019072705893,4.611954618355314,1.0036475206333548,1.033827583898466,65,114,12.85672664642334,8.849197387695312,63,14
1086,1,2.42710525539687,2.4271052553968695,0.9952898030874029,0.9952898030874032,0,0,2.431490898132324,2.431490898132324,1,1
1086,2,2.0604847517250855,2.060484751725085,0.997413165005451,0.997413165005451,0,0,2.786789655685425,2.431490898132324,2,2
1086,3,1.838148133925973,1.8381481339259733,0.9984301845360781,0.998430184536079,0,0,2.9096791744232178,2.431490898132324,3,3
1086,4,1.6514214232733282,1.6514214232733282,0.999544694921906,0.999544694921906,0,0,3.0436882972717285,2.431490898132324,4,4
1086,8,1.4459626293306416,1.4701601903288917,1.0000565930203587,1.000191376714278,2,3,3.456270933151245,2.431490898132324,6,5
1086,16,1.3025318053170194,1.4045979485146596,1.0012424479689739,1.0012270039488915,4,8,3.6469733715057373,2.431490898132324,12,8
1086,32,0.9422037120748523,1.2930150765735813,1.0010170853540261,1.0029289095682687,14,21,3.948084592819214,2.431490898132324,18,11
1086,64,0.5454765031621363,1.2168878389622804,0.9997734781155694,1.0032642608820659,28,47,4.257627010345459,2.431490898132324,36,17
1086,128,0.06644916540279584,1.2149372888870307,0.9981009000199409,1.003392978020139,63,111,4.742608070373535,2.431490898132324,65,17
1087,1,7.8182986277378035,7.818298627737805,0.9497537573732892,0.9497537573732919,0,0,7.963634014129639,7.963634014129639,1,1
1087,2,6.740444743198748,6.740444743198749,0.9750259607310495,0.9750259607310512,0,0,7.984161853790283,7.963634014129639,2,2
1087,3,6.720961814866286,6.720961814866286,0.9763527213142068,0.9763527213142085,0,0,8.747000694274902,7.963634014129639,3,3
1087,4,5.87811067930288,5.87811067930288,0.9940030230781545,0.9940030230781565,0,0,8.988500595092773,7.963634014129639,4,4
1087,8,5.78095241680943,5.7943827672759864,0.9977008189790644,0.9977262167546181,1,1,9.623854637145996,7.963634014129639,7,7
1087,16,5.010836664507949,5.413966843147995,1.0121504019195753,1.0064505829079817,7,8,10.491767883300781,7.963634014129639,9,8
1087,32,4.332374390134297,5.1207935378174545,1.0106443591297316,1.0191775020026421,12,19,12.035900115966797,7.963634014129639,20,13
1087,64,3.4452976226584986,5.078831463127458,1.0032621078026303,1.0233729146677277,29,48,13.019511222839355,7.963634014129639,35,16
1087,128,2.3948419866809094,5.078238248190449,0.999288228729918,1.023779162551672,60,111,14.064735412597656,7.963634014129639,68,17
1088,1,6.742783554991948,6.742783554991948,0.962489454382088,0.9624894543820897,0,0,6.837401866912842,6.837401866912842,1,1
1088,2,5.657486257953065,5.657486257953066,0.9850603947137087,0.9850603947137093,0,0,7.585468769073486,6.837401866912842,2,2
1088,3,5.211722349243928,5.211722349243929,0.9931113585172386,0.9931113585172389,0,0,7.693877696990967,6.837401866912842,3,3
1088,4,4.916790832621338,4.916790832621338,0.9967194458799495,0.9967194458799498,0,0,7.9101409912109375,6.837401866912842,4,4
1088,8,4.641326300742147,4.73101290731455,0.9997592702911138,1.0001426662194797,2,1,8.171102523803711,6.837401866912842,6,7
1088,16,3.7992725946274315,4.4654426688489295,1.00419202736453,1.0058097113696074,8,9,8.746326446533203,6.837401866912842,8,7
1088,32,3.4638836899535814,4.463919019654837,1.0021070251121027,1.00615055133682,15,24,9.06735610961914,6.837401866912842,17,8
1088,64,2.564373788741797,4.424564513017305,0.9951352015475612,1.0082425267574866,29,54,9.676299095153809,6.837401866912842,35,10
1088,128,1.4365393925660086,4.20155066835648,0.9990505553810585,1.0146120759822743,63,116,10.39148998260498,6.837401866912842,65,12
1089,1,7.193447669991246,7.193447669991249,0.9685844351096458,0.968584435109648,0,0,7.256543159484863,7.256543159484863,1,1
1089,2,6.300112208499589,6.3001122084995895,0.9811081911165421,0.9811081911165442,0,0,7.263066291809082,7.256543159484863,2,2
1089,3,5.607302582490555,5.607302582490555,0.9925104589528431,0.9925104589528446,0,0,7.3978166580200195,7.256543159484863,3,3
1089,4,5.607282732171714,5.607302582490554,0.9925023294615277,0.9925104589528446,1,1,7.751550197601318,7.256543159484863,3,3
1089,8,5.2167513984732485,5.312901176866954,1.0015504005634057,0.999822806089132,1,2,8.624823570251465,7.256543159484863,7,6
1089,16,4.547040402045814,5.050548572798117,1.009683457212375,1.006513140127657,4,8,9.014872550964355,7.256543159484863,12,8
1089,32,3.820565099123767,5.006685755664322,1.0071109329217227,1.0087366201610104,15,22,9.49531078338623,7.256543159484863,17,10
1089,64,2.89975263687491,4.927239740468518,1.0025380954750305,1.0107360669266658,27,54,9.944256782531738,7.256543159484863,37,10
1089,128,2.055009903670473,4.848751231919733,1.0036194991715894,1.016014415135631,54,115,10.577361106872559,7.256543159484863,74,13
1090,1,6.260594759786097,6.260594759786099,0.9756845599033106,0.9756845599033125,0,0,6.303696155548096,6.303696155548096,1,1
1090,2,4.136389254472652,4.136389254472652,1.0029233140686906,1.0029233140686915,0,0,6.36356782913208,6.303696155548096,2,2
1090,3,3.910756826819265,3.910756826819265,1.0047627002259434,1.0047627002259434,0,0,6.378758907318115,6.303696155548096,3,3
1090,4,3.88376812153517,3.88376812153517,1.0050923796526845,1.0050923796526856,0,0,6.396899223327637,6.303696155548096,4,4
1090,8,3.378051745507311,3.378051745507311,1.0118703331481327,1.0118703331481331,0,0,6.99362325668335,6.303696155548096,8,8
1090,16,3.311866053133491,3.3705719336006843,1.011319469646302,1.012223977272676,6,6,7.360271453857422,6.303696155548096,10,10
1090,32,2.73773059644637,3.0144065682111787,1.0161335421642819,1.0179262030245582,12,19,8.024190902709961,6.303696155548096,20,13
1090,64,1.9479507762137795,2.9879463257758085,1.005503966066155,1.018465440539948,31,49,8.761272430419922,6.303696155548096,33,15
1090,128,1.1632338948590366,2.979167436593636,1.0006013932492404,1.019393473081689,62,110,9.487135887145996,6.303696155548096,66,18
1091,1,10.179618875408265,10.179618875408265,0.9295948948308848,0.9295948948308856,0,0,10.404755592346191,10.404755592346191,1,1
1091,2,8.717234224922334,8.717234224922336,0.9582627855229113,0.9582627855229128,0,0,10.878597259521484,10.404755592346191,2,2
1091,3,8.023241258447296,8.023241258447296,0.9796852248004833,0.9796852248004843,0,0,10.936169624328613,10.404755592346191,3,3
1091,4,7.578156078689606,7.596577934660685,0.9876499665813758,0.9864219873730267,1,1,10.944785118103027,10.404755592346191,3,3
1091,8,7.288141235721505,7.42784874953945,0.9927052937776938,0.9884245057083565,1,2,11.073731422424316,10.404755592346191,7,6
1091,16,6.938750480293222,7.420170007309054,1.0012707571188306,0.9893309319457742,5,9,11.327071189880371,10.404755592346191,11,7
1091,32,6.198768874353862,7.345203134313198,1.0052859068406228,0.9923425013642198,14,25,11.478901863098145,10.404755592346191,18,7
1091,64,4.67125722374588,7.05503929784882,1.0109460959962102,1.0010008254270313,29,53,11.727862358093262,10.404755592346191,35,11
1091,128,2.6757101506691927,7.043181813780333,0.9992439536343638,1.001348571192416,60,115,11.954265594482422,10.404755592346191,68,13
1092,1,7.047083792762243,7.047083792762244,0.9803910760282698,0.9803910760282715,0,0,7.0710062980651855,7.0710062980651855,1,1
1092,2,6.542090903595877,6.542090903595877,0.9907148160752131,0.990714816075214,0,0,8.6485595703125,7.0710062980651855,2,2
1092,3,6.28526973057006,6.28526973057006,0.9972188832863231,0.9972188832863241,0,0,8.954813003540039,7.0710062980651855,3,3
1092,4,6.163469632733056,6.163469632733056,1.0013470792205472,1.0013470792205488,0,0,9.705257415771484,7.0710062980651855,4,4
1092,8,5.33808412040017,5.3403877108255955,1.0165174873336562,1.016451486196857,1,1,10.365274429321289,7.0710062980651855,7,7
1092,16,5.12260158158288,5.268561256422474,1.01756128472195,1.0192098993499465,5,7,10.65672779083252,7.0710062980651855,11,9
1092,32,4.431865496748832,5.07465885048223,1.0142272386909332,1.0216643629397928,13,21,11.449645042419434,7.0710062980651855,19,11
1092,64,3.2920300527280624,4.985077222545021,1.0076152118787933,1.0248172464503231,30,52,12.396350860595703,7.0710062980651855,34,12
1092,128,2.1080547723312804,4.903926178232646,1.0018053110349023,1.0294544575687574,64,112,13.4240140914917,7.0710062980651855,64,16
1093,1,8.946600515192772,8.946600515192774,0.9544561092031499,0.9544561092031518,0,0,9.050289154052734,9.050289154052734,1,1
1093,2,8.184996890426115,8.184996890426117,0.9665722204358083,0.9665722204358087,0,0,9.067618370056152,9.050289154052734,2,2
1093,3,7.060946972361357,7.060946972361357,0.9874383320483047,0.9874383320483047,0,0,9.17833137512207,9.050289154052734,3,3
1093,4,6.548921487594751,6.548921487594751,0.9998201177383435,0.9998201177383436,0,0,9.532623291015625,9.050289154052734,4,4
1093,8,5.692056318643278,5.7005625837990115,1.0144685654599928,1.0142083167838658,2,2,9.891529083251953,9.050289154052734,6,6
1093,16,4.776766541681242,5.4845359786993075,1.016692526532822,1.017933413756203,7,8,11.173982620239258,9.050289154052734,9,8
1093,32,4.111447293208464,5.29788450989681,1.0138369159895855,1.026939928258921,16,20,11.907727241516113,9.050289154052734,16,12
1093,64,2.865531280672235,5.12408835420665,1.0109216525563989,1.035090270911222,35,50,13.589395523071289,9.050289154052734,29,14
1093,128,1.6814834993767263,5.078091505721354,1.0039000822174984,1.0385181211832122,64,112,14.665209770202637,9.050289154052734,64,16
1094,1,8.314727093353765,8.314727093353756,0.963207579882658,0.9632075798826608,0,0,8.386857032775879,8.386857032775879,1,1
1094,2,6.896464279824578,6.8964642798245785,0.9881619719252253,0.9881619719252254,0,0,8.833333969116211,8.386857032775879,2,2
1094,3,6.666332934191249,6.66633293419125,0.9932135521993191,0.9932135521993192,0,0,9.130199432373047,8.386857032775879,3,3
1094,4,6.661040143029636,6.661040143029635,0.9933550347333966,0.9933550347333957,0,0,9.558793067932129,8.386857032775879,4,4
1094,8,5.534484106314033,5.579309925717655,1.0132495757050037,1.012450379048084,1,2,10.104891777038574,8.386857032775879,7,6
1094,16,5.401806706751434,5.530114031045902,1.0175024762318903,1.0142696405978846,5,7,10.827095985412598,8.386857032775879,11,9
1094,32,4.595250130389936,5.398684120352214,1.0185591990586214,1.020841896417792,13,19,11.481817245483398,8.386857032775879,19,13
1094,64,3.559071110768047,5.335980418437363,1.0072997057307713,1.025937234215371,31,49,12.194116592407227,8.386857032775879,33,15
1094,128,2.2191309331767837,5.22629500028232,1.0066273071192484,1.0329613087772698,60,109,13.028407096862793,8.386857032775879,68,19
1095,1,10.438694233797834,10.438694233797836,0.941205603770351,0.9412056037703526,0,0,10.58247184753418,10.58247184753418,1,1
1095,2,8.39202221876307,8.39202221876307,0.9843067618421047,0.9843067618421069,0,0,10.740422248840332,10.58247184753418,2,2
1095,3,8.148566149680745,8.148566149680747,0.9895972363021149,0.9895972363021163,0,0,11.397035598754883,10.58247184753418,3,3
1095,4,8.13790663483512,8.148566149680747,0.9895956308416399,0.9895972363021163,1,1,11.604852676391602,10.58247184753418,3,3
1095,8,7.514358505811533,7.598045049155037,1.0099288357980798,1.0081035168383004,2,2,12.328378677368164,10.58247184753418,6,6
1095,16,6.771918620749939,7.4063548421017975,1.0156713788098604,1.0148753234416283,7,8,12.683534622192383,10.58247184753418,9,8
1095,32,6.484724227322458,7.308550233057728,1.0182191086999894,1.0215200430964637,16,21,13.48111629486084,10.58247184753418,16,11
1095,64,4.873028764976867,7.063797609023191,1.0178968768710392,1.0340901757756744,25,49,14.232695579528809,10.58247184753418,39,15
1095,128,3.2446085742069823,6.855801465416421,1.0044075945110205,1.0477317786114781,67,109,15.022483825683594,10.58247184753418,61,19
1096,1,8.330152222419736,8.330152222419727,0.9653350430406522,0.9653350430406553,0,0,8.393678665161133,8.393678665161133,1,1
1096,2,7.316813755687359,7.316813755687359,0.9835673089611803,0.9835673089611814,0,0,8.396581649780273,8.393678665161133,2,2
1096,3,6.783194164403391,6.783194164403392,0.9935359986197587,0.9935359986197587,0,0,8.700189590454102,8.393678665161133,3,3
1096,4,6.779461737048003,6.779461737048002,0.9937131928739041,0.9937131928739048,0,0,8.95400333404541,8.393678665161133,4,4
1096,8,6.0005779657180724,6.052807163506128,1.00457625603099,1.0045134929472495,1,2,9.152915954589844,8.393678665161133,7,6
1096,16,4.643949602216009,5.366175844862654,1.0209719790568412,1.015913639884837,8,8,9.603046417236328,8.393678665161133,8,8
1096,32,4.382724559639095,5.27759227147688,1.0200014933956023,1.019642571016728,15,19,10.035289764404297,8.393678665161133,17,13
1096,64,3.3976178875564362,5.263233653490313,1.008470225626347,1.0209233855727649,31,49,10.691841125488281,8.393678665161133,33,15
1096,128,2.260317615264768,5.203991617880173,1.0029919182803455,1.0245554696915968,69,110,11.454322814941406,8.393678665161133,59,18
1097,1,10.405023004407642,10.405023004407639,0.932036120251364,0.9320361202513671,0,0,10.60096263885498,10.60096263885498,1,1
1097,2,9.458491070074126,9.458491070074126,0.9628160774221097,0.962816077422112,0,0,11.497122764587402,10.60096263885498,2,2
1097,3,8.928061828131003,8.928061828131003,0.9771186066927139,0.9771186066927153,0,0,11.738276481628418,10.60096263885498,3,3
1097,4,8.764519219560302,8.764519219560304,0.9819954800339449,0.9819954800339462,0,0,12.22429370880127,10.60096263885498,4,4
1097,8,8.401714486893958,8.561954659778149,0.98803815629072,0.9925054222710731,2,2,12.797982215881348,10.60096263885498,6,6
1097,16,7.287938025898738,8.123663052197148,1.0127450447812931,1.0092097556857194,6,9,13.745997428894043,10.60096263885498,10,7
1097,32,5.900470755681836,7.915380062455588,1.005764104028897,1.016314650879195,18,25,14.329678535461426,10.60096263885498,14,7
1097,64,4.234724238866041,7.874414575908705,1.0121566338818706,1.0214907080991447,33,53,15.01396369934082,10.60096263885498,31,11
1097,128,2.710159048319935,7.666423270045294,1.0022340820901743,1.037051001249965,61,118,16.133787155151367,10.60096263885498,67,10
1098,1,7.510516013933465,7.510516013933459,0.9614696182937759,0.9614696182937789,0,0,7.596221923828125,7.596221923828125,1,1
1098,2,6.412858559442013,6.412858559442013,0.9811441616309883,0.98114416163099,0,0,7.932455062866211,7.596221923828125,2,2
1098,3,6.3954590428374365,6.395459042837438,0.9821946354976837,0.982194635497686,0,0,9.123528480529785,7.596221923828125,3,3
1098,4,6.039628966429126,6.045145076413664,0.9907986095607264,0.9909870408364605,1,1,9.214235305786133,7.596221923828125,3,3
1098,8,5.39453688114609,5.472693589001008,1.0035153089297322,1.0044338778281614,2,2,9.774768829345703,7.596221923828125,6,6
1098,16,4.850917708475284,5.140522753767293,1.012917257377231,1.0123381739424546,4,5,10.442710876464844,7.596221923828125,12,11
1098,32,3.7513105373664835,4.99689061940156,1.0033743925813585,1.017888981218339,12,20,11.337772369384766,7.596221923828125,20,12
1098,64,3.2135300096537893,4.7456093713697385,1.0056398502116033,1.0272117800628058,29,51,12.069563865661621,7.596221923828125,35,13
1098,128,1.9347619598794061,4.745148504455627,1.0024179911271458,1.027445573185473,59,114,12.878726959228516,7.596221923828125,69,14
1099,1,14.523729773225927,14.523729773225927,0.8450996042092017,0.8450996042092035,0,0,15.224998474121094,15.224998474121094,1,1
1099,2,13.327497820083021,13.327497820083023,0.8924291362808254,0.8924291362808263,0,0,15.496443748474121,15.224998474121094,2,2
1099,3,11.857258691578773,11.857258691578773,0.9470733823226329,0.9470733823226338,0,0,15.772799491882324,15.224998474121094,3,3
1099,4,11.307436061762385,11.32242877140859,0.9656998302053842,0.9650728463027565,1,1,15.843534469604492,15.224998474121094,3,3
1099,8,11.010882172389943,11.147790643859018,0.9754269902084223,0.972413174242762,2,2,16.037776947021484,15.224998474121094,6,6
1099,16,10.284517946239237,10.880143366469888,0.9988730278068596,0.9846590303718874,4,8,16.323749542236328,15.224998474121094,12,8
1099,32,9.22062543925828,10.21545490006999,1.0262214735922615,1.0113422785662332,14,23,16.68704605102539,15.224998474121094,18,9
1099,64,6.92442074015555,10.09794174009171,1.0315515577159875,1.014669504819276,27,52,17.058975219726562,15.224998474121094,37,12
1099,128,4.731368039484919,9.985213601276069,1.0138296340165538,1.0198242434523357,68,115,17.583158493041992,15.224998474121094,60,13
1100,1,6.875059581955063,6.875059581955064,0.9776734044036837,0.9776734044036842,0,0,6.9070281982421875,6.9070281982421875,1,1
1100,2,6.568288755785827,6.568288755785827,0.9848104871232024,0.9848104871232026,0,0,7.822391033172607,6.9070281982421875,2,2
1100,3,6.348684417712057,6.348684417712057,0.9883696028019957,0.9883696028019957,0,0,8.924005508422852,6.9070281982421875,3,3
1100,4,5.29492534874396,5.295030539362577,1.0046447013892614,1.0046396020629687,1,1,8.980213165283203,6.9070281982421875,3,3
1100,8,4.859642371127604,4.953569508101101,1.0113144614345215,1.0106025915982895,3,4,9.224505424499512,6.9070281982421875,5,4
1100,16,4.51697924141509,4.883341813077729,1.0108263254340655,1.011611094313012,7,10,9.906533241271973,6.9070281982421875,9,6
1100,32,3.5649301502505812,4.585366634020029,1.0235509409613814,1.0210983805580534,14,21,10.496822357177734,6.9070281982421875,18,11
1100,64,2.546738072982544,4.540005429435609,1.009876241602702,1.022467617041841,31,51,11.010170936584473,6.9070281982421875,33,13
1100,128,1.4721281836394084,4.368319826627708,1.0009295474597646,1.0272892212372517,63,116,11.596197128295898,6.9070281982421875,65,12
1101,1,7.080318311914863,7.080318311914865,0.975415336543474,0.9754153365434756,0,0,7.11921501159668,7.11921501159668,1,1
1101,2,5.890980358606344,5.890980358606345,0.9911739872836749,0.9911739872836766,0,0,7.137287616729736,7.11921501159668,2,2
1101,3,5.552168275313387,5.552168275313387,0.9956439685127356,0.9956439685127365,0,0,7.358266830444336,7.11921501159668,3,3
1101,4,5.5082364259055625,5.508236425905563,0.9960798224945979,0.9960798224945984,0,0,7.368670463562012,7.11921501159668,4,4
1101,8,5.147351623979618,5.147394674415605,1.0007549525525743,1.000741653271063,1,1,8.166193962097168,7.11921501159668,7,7
1101,16,4.883755538948754,5.043843006148748,1.0036122968572783,1.0045100817331039,5,4,8.927777290344238,7.11921501159668,11,12
1101,32,3.63907342549262,4.812934215470005,1.0113445855635228,1.0120418664121118,12,22,9.559026718139648,7.11921501159668,20,10
1101,64,2.596099706570589,4.55528955695259,1.0056663892016742,1.0159049450302358,33,50,10.143778800964355,7.11921501159668,31,14
1101,128,1.1607557524162626,4.429350416979373,1.0000229590083896,1.0188814722459862,64,111,10.813673973083496,7.11921501159668,64,17
1102,1,10.821424216908627,10.82142421690863,0.9216427787727043,0.9216427787727056,0,0,11.071844100952148,11.071844100952148,1,1
1102,2,10.25705121063292,10.25705121063292,0.9423270224080558,0.9423270224080562,0,0,11.499543190002441,11.071844100952148,2,2
1102,3,10.13348643948554,10.13348643948554,0.9489034407487267,0.9489034407487269,0,0,12.382417678833008,11.071844100952148,3,3
1102,4,9.26088725586489,9.263623674832566,0.9699702256545231,0.9703525818185437,1,1,12.465388298034668,11.071844100952148,3,3
1102,8,8.016967853564477,8.024430602948563,1.0047067449198017,1.005047844068472,1,1,13.032881736755371,11.071844100952148,7,7
1102,16,7.315944848755778,7.495832462417673,1.0221505693887156,1.0238748784315377,3,5,13.726716041564941,11.071844100952148,13,11
1102,32,6.22573470664547,7.045882708007994,1.0279633473320442,1.0377205915241037,13,18,14.408154487609863,11.071844100952148,19,14
1102,64,4.913943325119795,6.955293758807731,1.024389919457518,1.0422677067954587,32,47,14.828316688537598,11.071844100952148,32,17
1102,128,2.795027842886314,6.928425619899851,1.0017302586051176,1.0448146934675684,62,109,15.404247283935547,11.071844100952148,66,19
1103,1,10.069836986944786,10.069836986944782,0.940432472267247,0.9404324722672484,0,0,10.227910041809082,10.227910041809082,1,1
1103,2,8.441639029811183,8.441639029811185,0.975357718431,0.9753577184310012,0,0,10.414076805114746,10.227910041809082,2,2
1103,3,6.511136069033517,6.511136069033518,1.0157693359711706,1.0157693359711706,0,0,10.72617244720459,10.227910041809082,3,3
1103,4,6.494620227799431,6.494789789186708,1.0167806656730103,1.0167112685272734,1,1,11.116655349731445,10.227910041809082,3,3
1103,8,6.105751877252086,6.122762272520184,1.0252958326696289,1.0258222123890386,2,1,11.451689720153809,10.227910041809082,6,7
1103,16,5.948421518793098,6.091615126452921,1.0291953457460625,1.0279022194759113,6,7,12.534810066223145,10.227910041809082,10,9
1103,32,4.9198461434134515,5.981247270220744,1.0258252991447183,1.0317461229199365,17,22,13.106928825378418,10.227910041809082,15,10
1103,64,3.8738781199180696,5.924100083147579,1.0147492155123505,1.0358121032757364,32,54,13.820130348205566,10.227910041809082,32,10
1103,128,2.426690477804084,5.850067185815863,1.0088375967453898,1.041611059688527,65,116,14.874066352844238,10.227910041809082,63,12
1104,1,7.2124816288730935,7.2124816288730935,0.9705753247783867,0.9705753247783889,0,0,7.267680644989014,7.267680644989014,1,1
1104,2,6.695173079024926,6.695173079024926,0.9824002915634785,0.9824002915634802,0,0,7.991873264312744,7.267680644989014,2,2
1104,3,6.145419945406393,6.145419945406393,0.9931547686599151,0.9931547686599167,0,0,8.077001571655273,7.267680644989014,3,3
1104,4,5.875659265297474,5.875659265297474,0.9989433377807249,0.9989433377807251,0,0,8.082795143127441,7.267680644989014,4,4
1104,8,5.002040117264207,5.010154956239882,1.0107230308333823,1.0110640916309197,1,1,9.11426830291748,7.267680644989014,7,7
1104,16,4.462760056324608,4.655492158744735,1.0226425506583472,1.021704119323571,6,7,9.754185676574707,7.267680644989014,10,9
1104,32,3.856231365314531,4.600119909458705,1.013906420660694,1.0237452070940587,15,23,10.519405364990234,7.267680644989014,17,9
1104,64,2.900662113322277,4.589554994078676,1.009571972264298,1.024523868016885,30,52,11.177458763122559,7.267680644989014,34,12
1104,128,1.772191564648807,4.523398007110911,1.0026979299196366,1.0285926964384846,58,113,11.924540519714355,7.267680644989014,70,15
1105,1,9.504052241742112,9.504052241742095,0.9428128136302982,0.9428128136303006,0,0,9.653481483459473,9.653481483459473,1,1
1105,2,8.634557130099603,8.634557130099605,0.961560679833753,0.9615606798337553,0,0,9.773161888122559,9.653481483459473,2,2
1105,3,7.185209470284435,7.185209470284436,0.9945688471593336,0.9945688471593346,0,0,10.70278263092041,9.653481483459473,3,3
1105,4,7.160689838064926,7.160689838064927,0.9956461724777398,0.9956461724777401,0,0,11.245139122009277,9.653481483459473,4,4
1105,8,6.542704618774225,6.820952452868977,1.003213210372246,1.0062535148076392,3,2,11.911845207214355,9.653481483459473,5,6
1105,16,6.26219489442923,6.71159175533035,1.0136452688998832,1.0142426579791959,6,6,12.504881858825684,9.653481483459473,10,10
1105,32,5.176345613956493,6.143355066709596,1.0281384451860207,1.0335118133669359,15,23,13.26449966430664,9.653481483459473,17,9
1105,64,3.906492948080616,5.969894045293149,1.0206730936832225,1.0411477278316381,31,50,14.16201400756836,9.653481483459473,33,14
1105,128,2.6409334999487215,5.904748246392169,1.0054533563516599,1.0464336743165,68,111,14.995110511779785,9.653481483459473,60,17
1106,1,11.636119018546443,11.636119018546442,0.9053894595470889,0.9053894595470903,0,0,11.975462913513184,11.975462913513184,1,1
1106,2,9.334710570880016,9.334710570880016,0.9705092072010952,0.9705092072010955,0,0,12.469576835632324,11.975462913513184,2,2
1106,3,8.98633388652085,8.98633388652085,0.9822848447030037,0.9822848447030044,0,0,12.968880653381348,11.975462913513184,3,3
1106,4,8.749133061178517,8.749133061178519,0.9927473220418895,0.9927473220418899,0,0,13.346395492553711,11.975462913513184,4,4
1106,8,8.659020415082082,8.666338965263176,0.9989324113702169,0.9990512605111124,1,1,14.152264595031738,11.975462913513184,7,7
1106,16,7.836220942963314,8.615809587884797,1.0078214573324646,1.0020093353761543,5,7,14.771724700927734,11.975462913513184,11,9
1106,32,6.945411055093768,8.560549950411852,1.0156359548666818,1.0070352816718846,13,22,15.254732131958008,11.975462913513184,19,10
1106,64,5.416477550799748,8.27713543384479,1.014353119175689,1.0235252190037853,29,50,15.736672401428223,11.975462913513184,35,14
1106,128,3.2076007405255726,8.210568858336092,0.9986351926704123,1.0269067300145378,63,114,16.26776123046875,11.975462913513184,65,14
1107,1,6.151220971092892,6.151220971092888,0.9756945178528199,0.9756945178528229,0,0,6.194725513458252,6.194725513458252,1,1
1107,2,4.927509674470391,4.927509674470391,0.9936860348677701,0.9936860348677715,0,0,6.460887908935547,6.194725513458252,2,2
1107,3,4.926173172003056,4.926173172003057,0.993686536894787,0.9936865368947887,0,0,7.233589172363281,6.194725513458252,3,3
1107,4,4.722264016273288,4.723642291750732,0.996955454721536,0.9969128470371591,1,1,7.265013694763184,6.194725513458252,3,3
1107,8,4.495869741702905,4.534660228070204,1.0017297996371526,1.0010476679111275,1,2,7.851685047149658,6.194725513458252,7,6
1107,16,4.240597129994594,4.477059402281842,1.003043716038084,1.0036317512080628,6,7,8.316423416137695,6.194725513458252,10,9
1107,32,3.3375923819651074,4.470472836707224,1.0015628881598957,1.0039745811329714,13,21,9.174537658691406,6.194725513458252,19,11
1107,64,2.481725753054228,4.37195883952368,1.0064096640155271,1.0103550218515598,35,50,10.0507173538208,6.194725513458252,29,14
1107,128,1.4668993792464944,4.34870823911377,1.0023235281080747,1.0124666600739605,67,110,10.853446960449219,6.194725513458252,61,18
1108,1,11.017568763117593,11.017568763117593,0.9262742624192222,0.9262742624192242,0,0,11.227437019348145,11.227437019348145,1,1
1108,2,8.478414216207284,8.478414216207284,0.991219890005733,0.9912198900057336,0,0,11.524103164672852,11.227437019348145,2,2
1108,3,8.03317942871713,8.03317942871713,0.99873537114948,0.9987353711494811,0,0,11.747934341430664,11.227437019348145,3,3
1108,4,8.026988488937523,8.026988488937523,0.9984738754298043,0.9984738754298029,0,0,11.75507926940918,11.227437019348145,4,4
1108,8,7.1354611766846885,7.160256245973106,1.0142406224647935,1.0130453757183284,1,1,11.990283966064453,11.227437019348145,7,7
1108,16,6.863981810417639,7.021794273666024,1.01930731896912,1.01767218860974,5,7,12.409961700439453,11.227437019348145,11,9
1108,32,5.9620733211703465,6.718630404736458,1.0316086836058447,1.0247712732220238,16,20,12.908760070800781,11.227437019348145,16,12
1108,64,5.052621217687453,6.2543821673285045,1.0350217777299688,1.0384720912278618,29,51,13.308252334594727,11.227437019348145,35,13
1108,128,3.384218519775483,6.16807750082369,1.0192521041523386,1.0427927171715363,62,110,13.676645278930664,11.227437019348145,66,18
1109,1,7.102691697523547,7.1026916975235475,0.9730331974748017,0.9730331974748048,0,0,7.1481733322143555,7.1481733322143555,1,1
1109,2,6.1862916909160965,6.1862916909160965,0.9890655797730892,0.9890655797730916,0,0,7.752499103546143,7.1481733322143555,2,2
1109,3,5.930046292961665,5.930046292961665,0.9936627637601322,0.9936627637601343,0,0,8.283864974975586,7.1481733322143555,3,3
1109,4,5.829862449018481,5.829862449018482,0.9969038345232621,0.9969038345232649,0,0,8.68001651763916,7.1481733322143555,4,4
1109,8,5.0945378665114065,5.127969043315886,1.0113209582011784,1.0128072149687148,1,1,9.441305160522461,7.1481733322143555,7,7
1109,16,4.757504057223852,4.856103362175109,1.0157888616308868,1.0197128388946641,6,6,10.018486022949219,7.1481733322143555,10,10
1109,32,3.7392694123289814,4.594822614637457,1.0184462047568825,1.027803765959029,12,21,10.742104530334473,7.1481733322143555,20,11
1109,64,2.765763719508309,4.513266695127964,1.0091893475571228,1.03136316846353,32,50,11.318031311035156,7.1481733322143555,32,14
1109,128,1.845151297525229,4.487031285439071,1.0043459422830499,1.0322904537559168,62,111,12.189285278320312,7.1481733322143555,66,17
1110,1,5.248968675136763,5.248968675136763,0.9942306200123188,0.9942306200123203,0,0,5.251927375793457,5.251927375793457,1,1
1110,2,4.476035606684139,4.476035606684139,0.9991757804592374,0.9991757804592378,0,0,5.332435607910156,5.251927375793457,2,2
1110,3,4.2086348639646225,4.2086348639646225,1.0018191286356093,1.0018191286356104,0,0,5.375586986541748,5.251927375793457,3,3
1110,4,3.813808687115012,3.8138086871150114,1.0037063092801122,1.0037063092801135,0,0,5.533804416656494,5.251927375793457,4,4
1110,8,3.5205321451575116,3.5307655751020093,1.0059067364949024,1.0059620585485385,2,2,5.846245765686035,5.251927375793457,6,6
1110,16,2.7595014513082052,2.8350223411002635,1.013987763015637,1.01355386747914,6,7,6.317659854888916,5.251927375793457,10,9
1110,32,2.333922396588554,2.617265370455471,1.0137456251329855,1.0158891528821552,14,18,7.0997467041015625,5.251927375793457,18,14
1110,64,1.3516183729018225,2.5864373239265785,1.0026288658224227,1.0169173076970681,30,50,7.996106147766113,5.251927375793457,34,14
1110,128,0.6538366048831145,2.5796143756465555,0.9992943162541744,1.0173201059544377,61,114,9.017219543457031,5.251927375793457,67,14
1111,1,5.9167397842063885,5.9167397842063885,0.9760148228899287,0.9760148228899292,0,0,5.961867809295654,5.961867809295654,1,1
1111,2,5.550007977221642,5.550007977221643,0.9840882269690776,0.9840882269690783,0,0,6.978344917297363,5.961867809295654,2,2
1111,3,4.711952876908948,4.711952876908949,0.9974693220467539,0.9974693220467543,0,0,7.479437351226807,5.961867809295654,3,3
1111,4,4.651733401211778,4.651733401211777,0.9989261853735347,0.9989261853735353,0,0,7.5700907707214355,5.961867809295654,4,4
1111,8,4.375186562332839,4.457464439574691,1.0017341483512754,1.0018924919025147,3,3,7.8431878089904785,5.961867809295654,5,5
1111,16,3.900542538919238,4.113633530441401,1.0098465865147588,1.0085533116562124,5,9,8.25472640991211,5.961867809295654,11,7
1111,32,3.0141750066093653,3.772561967610698,1.0135281226383057,1.0135540354548147,14,22,8.740382194519043,5.961867809295654,18,10
1111,64,2.2975667833574263,3.545255487116128,1.0086292642904193,1.0209431729851703,32,50,9.250919342041016,5.961867809295654,32,14
1111,128,1.2826117092867357,3.4518098810642104,1.0029376281571394,1.023666296834927,67,112,9.905097961425781,5.961867809295654,61,16
1112,1,7.624034185315746,7.624034185315746,0.9610146584325939,0.9610146584325955,0,0,7.713711261749268,7.713711261749268,1,1
1112,2,5.767606567922845,5.767606567922845,0.9919809382470409,0.9919809382470413,0,0,8.268501281738281,7.713711261749268,2,2
1112,3,5.667284495153995,5.667284495153995,0.9946257694902837,0.9946257694902841,0,0,8.806849479675293,7.713711261749268,3,3
1112,4,5.464100548428703,5.464100548428703,0.9991189694677453,0.9991189694677447,0,0,8.880855560302734,7.713711261749268,4,4
1112,8,4.6914781754953205,4.731233265100514,1.0125389864581895,1.0129332216217308,2,2,9.889467239379883,7.713711261749268,6,6
1112,16,4.3161220228095285,4.443924682310089,1.0202470705989168,1.0220680386433525,3,5,10.48207950592041,7.713711261749268,13,11
1112,32,3.684678560913218,4.274277675241757,1.0214557458902649,1.0262712365552766,12,20,11.190702438354492,7.713711261749268,20,12
1112,64,2.719053416440915,4.271858496636076,1.0084109634180307,1.0268367172682462,27,51,11.882003784179688,7.713711261749268,37,13
1112,128,1.6877760717473844,4.245384496988709,1.001290384796052,1.0297256650014401,61,112,12.811134338378906,7.713711261749268,67,16
1113,1,10.644480734802135,10.644480734802139,0.9319636813712554,0.9319636813712582,0,0,10.83106517791748,10.83106517791748,1,1
1113,2,8.221951570192887,8.221951570192887,0.9919485101392791,0.9919485101392802,0,0,11.077049255371094,10.83106517791748,2,2
1113,3,8.053576185684854,8.053576185684854,0.9944984749584316,0.9944984749584337,0,0,11.630988121032715,10.83106517791748,3,3
1113,4,8.019215850742178,8.019215850742178,0.9954437117065564,0.995443711706558,0,0,11.644120216369629,10.83106517791748,4,4
1113,8,7.352731243101522,7.563390570322616,1.005677878068354,1.0032972638403925,1,2,12.277381896972656,10.83106517791748,7,6
1113,16,6.525564421300256,7.118552620341245,1.0253631112393116,1.0207184768734119,5,8,13.17970085144043,10.83106517791748,11,8
1113,32,5.79855547650425,7.055259783505049,1.0204222542687469,1.0254771307546435,12,20,13.915410041809082,10.83106517791748,20,12
1113,64,4.4394133762772885,6.75789981870944,1.0283399938842355,1.0391778867622956,30,52,14.319694519042969,10.83106517791748,34,12
1113,128,3.0553178959924328,6.671535812035581,1.0142292746857156,1.0462965443532748,66,113,15.147921562194824,10.83106517791748,62,15
1114,1,10.891512064798027,10.891512064798032,0.9306583566330665,0.9306583566330696,0,0,11.086596488952637,11.086596488952637,1,1
1114,2,9.564544982448787,9.564544982448789,0.9637488154000652,0.9637488154000673,0,0,11.328620910644531,11.086596488952637,2,2
1114,3,9.563546256176632,9.563546256176634,0.9638071213023702,0.9638071213023718,0,0,11.552490234375,11.086596488952637,3,3
1114,4,9.517794262685843,9.520338590653548,0.96445249430248,0.9644819602719455,1,1,11.575617790222168,11.086596488952637,3,3
1114,8,8.203997865944517,8.334688932847355,0.9971841122889793,0.9938041172846783,2,2,11.722749710083008,11.086596488952637,6,6
1114,16,7.798621736596443,8.071577917572732,1.0052411265185606,1.0044009218937389,7,8,12.531681060791016,11.086596488952637,9,8
1114,32,6.840176518229173,7.943480746190625,1.008561518865083,1.0092794216050835,12,23,13.031055450439453,11.086596488952637,20,9
1114,64,5.762892743719527,7.782562732240984,1.0116048701465763,1.0169688041840872,32,52,13.617060661315918,11.086596488952637,32,12
1114,128,3.24030228130694,6.807221583474717,1.011050990666466,1.0483981490654957,60,110,14.432063102722168,11.086596488952637,68,18
1115,1,6.859724782102292,6.859724782102294,0.9811998473291448,0.9811998473291462,0,0,6.882774829864502,6.882774829864502,1,1
1115,2,5.949838690638585,5.949838690638585,0.9953750238176478,0.9953750238176485,0,0,8.335733413696289,6.882774829864502,2,2
1115,3,5.650212000690436,5.650212000690436,1.0015777393789715,1.0015777393789724,0,0,9.189492225646973,6.882774829864502,3,3
1115,4,5.328554259887406,5.328554259887405,1.0069767374694791,1.0069767374694807,0,0,9.229454040527344,6.882774829864502,4,4
1115,8,4.97028519092584,5.075118717965017,1.0102585796189165,1.0136919243702487,2,3,9.93952465057373,6.882774829864502,6,5
1115,16,4.56093780929001,4.796906010623678,1.014998213161672,1.0186730648821622,7,8,10.278923034667969,6.882774829864502,9,8
1115,32,4.011481058154541,4.748542369827273,1.0148283725206269,1.0216939195523802,13,19,11.027607917785645,6.882774829864502,19,13
1115,64,3.194588431531474,4.735848698440358,1.0056006844710823,1.022902503231806,30,49,11.838163375854492,6.882774829864502,34,15
1115,128,1.7788649756555404,4.723529618840673,0.9977321324649973,1.0233985450249141,62,112,12.430834770202637,6.882774829864502,66,16
1116,1,7.80418269562223,7.80418269562223,0.9647118905803356,0.9647118905803377,0,0,7.877285957336426,7.877285957336426,1,1
1116,2,6.695054753213273,6.695054753213273,0.9830760746620844,0.9830760746620864,0,0,8.162862777709961,7.877285957336426,2,2
1116,3,6.615081821525482,6.615081821525481,0.9859746414790467,0.9859746414790478,0,0,8.992876052856445,7.877285957336426,3,3
1116,4,6.292523677706481,6.292523677706481,0.99638966635585,0.9963896663558508,0,0,9.064940452575684,7.877285957336426,4,4
1116,8,5.894412154883472,5.904724824587965,1.00660873291196,1.0069910925331618,1,2,9.558619499206543,7.877285957336426,7,6
1116,16,5.0480213676573165,5.235399110901654,1.0186022749615447,1.018510935764256,4,7,10.040484428405762,7.877285957336426,12,9
1116,32,4.232989195775448,5.218802117416618,1.0140535919647096,1.0200059525088958,12,20,10.61825942993164,7.877285957336426,20,12
1116,64,3.053860878765974,5.07428478253664,1.0068745389771105,1.0261108252911046,30,48,11.121247291564941,7.877285957336426,34,16
1116,128,1.9344208124249551,5.052979215112261,0.9980984707560081,1.0269692794227745,63,109,11.741231918334961,7.877285957336426,65,19
1117,1,7.533138867477312,7.533138867477314,0.9642324067585945,0.9642324067585958,0,0,7.608943939208984,7.608943939208984,1,1
1117,2,6.03828395359321,6.03828395359321,0.9950792741495186,0.9950792741495188,0,0,8.493175506591797,7.608943939208984,2,2
1117,3,6.016776533620349,6.016776533620349,0.9958056669862494,0.995805666986249,0,0,8.807859420776367,7.608943939208984,3,3
1117,4,5.6443926527896755,5.644392652789676,1.002258287020239,1.0022582870202394,0,0,8.973276138305664,7.608943939208984,4,4
1117,8,5.363445445615258,5.372123367522118,1.0074220111421,1.0077625606445921,3,3,9.691530227661133,7.608943939208984,5,5
1117,16,4.96787083197785,5.2839479482897564,1.01420204124768,1.0101919204248353,6,10,10.271921157836914,7.608943939208984,10,6
1117,32,4.069936253784694,5.174832507242076,1.0133782506587412,1.0149596577945834,13,21,10.868583679199219,7.608943939208984,19,11
1117,64,2.972487717765397,5.088365768609235,1.0126178607423246,1.0184003048833032,29,52,11.54855728149414,7.608943939208984,35,12
1117,128,1.3778269602683604,4.919629203904212,1.0015246353665361,1.0244186280804797,59,118,12.377169609069824,7.608943939208984,69,10
1118,1,6.434816960990835,6.434816960990836,0.9811018557203542,0.9811018557203554,0,0,6.46011209487915,6.46011209487915,1,1
1118,2,5.913551001690212,5.913551001690212,0.9899687254771588,0.9899687254771591,0,0,7.023897171020508,6.46011209487915,2,2
1118,3,5.042774447698811,5.042774447698811,1.0015573103726882,1.0015573103726887,0,0,7.4669060707092285,6.46011209487915,3,3
1118,4,4.9384617515201015,4.9384617515201015,1.0028311360578592,1.0028311360578595,0,0,7.645668029785156,6.46011209487915,4,4
1118,8,4.727977187029167,4.728021235743005,1.0060469504709468,1.006029012126663,1,1,7.816467761993408,6.46011209487915,7,7
1118,16,4.250499229923355,4.3442942353003335,1.010765629999077,1.012596128448863,4,5,8.294260025024414,6.46011209487915,12,11
1118,32,3.735948343864077,4.192958979883653,1.0104218638378109,1.017163662467902,13,22,9.050565719604492,6.46011209487915,19,10
1118,64,2.3858742949020737,4.137480875133392,1.0025046175663679,1.0189933654627488,28,50,9.691539764404297,6.46011209487915,36,14
1118,128,1.1493533180278133,4.101191170616699,1.0004068612760366,1.0213826408683766,65,114,10.476886749267578,6.46011209487915,63,14
1119,1,6.049364490480029,6.04936449048003,0.9800788314279402,0.9800788314279423,0,0,6.078701019287109,6.078701019287109,1,1
1119,2,5.454754891898123,5.454754891898124,0.9894557746713063,0.9894557746713075,0,0,7.4406609535217285,6.078701019287109,2,2
1119,3,5.272511604242223,5.272511604242223,0.9922356970797688,0.9922356970797699,0,0,7.52872371673584,6.078701019287109,3,3
1119,4,5.120354258519447,5.120354258519446,0.995936143555915,0.9959361435559161,0,0,7.574616432189941,6.078701019287109,4,4
1119,8,4.386879208952636,4.401606509027497,1.0050168534986215,1.005188707430015,1,3,8.23540210723877,6.078701019287109,7,5
1119,16,3.9612595362363643,4.272250903268088,1.0078405484559994,1.0088296860253991,5,6,8.837109565734863,6.078701019287109,11,10
1119,32,3.500560977375424,4.03560956417289,1.008846418310082,1.013650265218137,15,25,9.416048049926758,6.078701019287109,17,7
1119,64,2.6325130042081604,3.9924278643924755,1.005017109065972,1.016813168853091,33,51,10.126761436462402,6.078701019287109,31,13
1119,128,1.349312815918254,3.965718366796769,0.9984046988072641,1.0183563630816415,65,112,10.757426261901855,6.078701019287109,63,16
1120,1,6.938724931830475,6.938724931830476,0.9661561348395018,0.9661561348395036,0,0,7.014077186584473,7.014077186584473,1,1
1120,2,6.375898477183188,6.375898477183188,0.9787083948545638,0.9787083948545645,0,0,7.373258590698242,7.014077186584473,2,2
1120,3,5.566010791188546,5.566010791188546,0.9937535374690385,0.9937535374690394,0,0,7.6956257820129395,7.014077186584473,3,3
1120,4,5.3879312066380605,5.387931206638061,0.9961082248536426,0.9961082248536428,0,0,7.758519649505615,7.014077186584473,4,4
1120,8,4.542165532484885,4.542165532484884,1.0038446301948334,1.0038446301948352,0,0,8.260368347167969,7.014077186584473,8,8
1120,16,4.2864819904984675,4.377378991513897,1.0080668545433462,1.0081493437895377,6,5,9.048938751220703,7.014077186584473,10,11
1120,32,3.5684172889402235,4.183576188632576,1.0028531988757976,1.0115881434534066,14,19,9.757018089294434,7.014077186584473,18,13
1120,64,2.594715161633414,4.048871429118274,1.0022777971553103,1.0173922868291656,28,46,10.615571022033691,7.014077186584473,36,18
1120,128,1.5271500848166375,3.8852799395033344,1.0010321248374932,1.0223730336117745,53,109,11.513681411743164,7.014077186584473,75,19
1121,1,11.191272046786802,11.191272046786805,0.9296898241832379,0.9296898241832394,0,0,11.382190704345703,11.382190704345703,1,1
1121,2,10.252882911245388,10.252882911245388,0.9614567294130212,0.9614567294130216,0,0,12.181402206420898,11.382190704345703,2,2
1121,3,10.021113456600338,10.021113456600338,0.9674502182538153,0.9674502182538155,0,0,12.580904960632324,11.382190704345703,3,3
1121,4,9.675238344346287,9.675238344346283,0.9766170874171463,0.9766170874171471,0,0,12.872828483581543,11.382190704345703,4,4
1121,8,8.71648183409506,8.736126230505336,1.010464678756341,1.0100711767911559,1,1,14.263665199279785,11.382190704345703,7,7
1121,16,8.32925306920344,8.536694197704382,1.0228345205815714,1.0243522764692228,5,6,14.618249893188477,11.382190704345703,11,10
1121,32,6.5260989951204245,7.707278744188743,1.0508924471597818,1.0553618053231588,11,18,15.079094886779785,11.382190704345703,21,14
1121,64,5.330690436427856,7.546696081184213,1.053462541867332,1.0650595237714313,29,47,15.770695686340332,11.382190704345703,35,17
1121,128,3.19925254585742,7.283158032513847,1.0189580675303989,1.072223566827346,59,105,16.30636978149414,11.382190704345703,69,23
1122,1,15.364258327051791,15.364258327051791,0.8468948248441048,0.8468948248441067,0,0,16.02953338623047,16.02953338623047,1,1
1122,2,13.829046571311364,13.829046571311366,0.9106839311063799,0.910683931106381,0,0,16.67096710205078,16.02953338623047,2,2
1122,3,12.845781914388567,12.845781914388558,0.9415994852504137,0.9415994852504158,0,0,16.731887817382812,16.02953338623047,3,3
1122,4,12.287872891913016,12.287872891913016,0.9607931985209024,0.9607931985209051,0,0,16.745683670043945,16.02953338623047,4,4
1122,8,11.074097949907168,11.11176474089208,1.0012138365480916,1.0016461744918101,1,1,17.26703453063965,16.02953338623047,7,7
1122,16,9.981152678908552,10.204272150211288,1.0536825734785726,1.0443556261416773,5,5,17.5380916595459,16.02953338623047,11,11
1122,32,8.903264435193847,10.012576943421095,1.0611911364244437,1.053755266685929,14,18,18.008543014526367,16.02953338623047,18,14
1122,64,7.5827913251208,9.942305540888922,1.0575140674554389,1.0589875204532204,27,49,18.485525131225586,16.02953338623047,37,15
1122,128,5.1362172666961525,9.915986999144753,1.0229951071465082,1.0625284216446202,60,112,18.954483032226562,16.02953338623047,68,16
1123,1,6.770010659551567,6.770010659551568,0.9709959822557561,0.9709959822557583,0,0,6.8255534172058105,6.8255534172058105,1,1
1123,2,6.57679431390694,6.576794313906939,0.9778507823908273,0.9778507823908292,0,0,8.296720504760742,6.8255534172058105,2,2
1123,3,6.249410727964071,6.249410727964071,0.987382366607339,0.9873823666073397,0,0,8.452448844909668,6.8255534172058105,3,3
1123,4,5.571395045018254,5.571395045018254,0.9962331298953093,0.9962331298953121,0,0,8.696110725402832,6.8255534172058105,4,4
1123,8,5.102989349726973,5.181582806422981,1.002642290052205,1.0036297789615547,3,4,8.962188720703125,6.8255534172058105,5,4
1123,16,4.532893218781937,4.668093183532936,1.0113419365955565,1.01383235422705,7,8,9.311098098754883,6.8255534172058105,9,8
1123,32,3.6814347309468407,4.524579091482432,1.0119069065834796,1.019565811261103,14,21,10.016595840454102,6.8255534172058105,18,11
1123,64,3.1665501110930583,4.475886640742454,1.0095034218124752,1.0218180129297645,27,54,10.741958618164062,6.8255534172058105,37,10
1123,128,1.7028925511007504,4.474826550260159,1.0000434035879908,1.022224840748281,61,115,11.466890335083008,6.8255534172058105,67,13
1124,1,9.470344656186205,9.470344656186207,0.9404785870306298,0.940478587030632,0,0,9.633305549621582,9.633305549621582,1,1
1124,2,7.311132450781528,7.311132450781528,0.9857686105544818,0.9857686105544832,0,0,10.091304779052734,9.633305549621582,2,2
1124,3,7.132305417108954,7.132305417108954,0.9912384589591359,0.9912384589591369,0,0,10.665669441223145,9.633305549621582,3,3
1124,4,7.080147379761785,7.080147379761785,0.9931611770596658,0.9931611770596664,0,0,10.7001371383667,9.633305549621582,4,4
1124,8,6.535475710130711,6.557013426902009,1.0088310038987713,1.0084437652616893,1,1,11.23068904876709,9.633305549621582,7,7
1124,16,5.9275182935477835,6.142508670142657,1.0246923448772787,1.0212951511387258,6,8,11.858243942260742,9.633305549621582,10,8
1124,32,4.981365795844717,5.949837671651154,1.0330959359302105,1.0273206472401881,14,24,12.528546333312988,9.633305549621582,18,8
1124,64,3.9224172163982405,5.821599504384522,1.016963703778122,1.0352765976676288,31,52,13.220718383789062,9.633305549621582,33,12
1124,128,2.4328734754626815,5.799055434509517,1.000846202644529,1.0387014414083744,64,112,13.975994110107422,9.633305549621582,64,16
1125,1,7.431435173567819,7.431435173567818,0.9652443594373092,0.9652443594373107,0,0,7.5046234130859375,7.5046234130859375,1,1
1125,2,6.092599113088133,6.0925991130881325,0.9878611817005325,0.9878611817005338,0,0,7.788086891174316,7.5046234130859375,2,2
1125,3,5.6602837352972015,5.6602837352972015,0.9939724744828783,0.993972474482879,0,0,7.836058139801025,7.5046234130859375,3,3
1125,4,5.605464596173076,5.605464596173076,0.9946379310406039,0.9946379310406048,0,0,7.888647556304932,7.5046234130859375,4,4
1125,8,4.776910101918643,4.798804254693202,1.0068987993485372,1.0073817940093903,1,1,8.37822151184082,7.5046234130859375,7,7
1125,16,4.290363904903317,4.449519041759159,1.0167864301010017,1.0144700190715976,5,8,8.996553421020508,7.5046234130859375,11,8
1125,32,3.692420346498333,4.308907908433137,1.0152149464749156,1.0164446016769093,12,21,9.59326457977295,7.5046234130859375,20,11
1125,64,2.6739090782507233,4.252139221779884,1.0054198660505618,1.0200253005846922,29,49,10.265876770019531,7.5046234130859375,35,15
1125,128,1.5106747405712135,4.221749661363718,0.9995360394009636,1.0211885687327953,63,111,10.83782958984375,7.5046234130859375,65,17
1126,1,8.092149107485884,8.092149107485888,0.964064549126387,0.9640645491263883,0,0,8.163734436035156,8.163734436035156,1,1
1126,2,6.8797196615998155,6.879719661599815,0.9887814080127884,0.9887814080127884,0,0,8.921906471252441,8.163734436035156,2,2
1126,3,6.099409654875616,6.099409654875616,1.0003595416956252,1.0003595416956252,0,0,8.9246826171875,8.163734436035156,3,3
1126,4,6.0524600369857255,6.0524600369857255,1.0014439463027307,1.00144394630273,0,0,8.938331604003906,8.163734436035156,4,4
1126,8,5.574662041163089,5.5758298337816505,1.015142396835123,1.0151553133999704,1,1,10.13135814666748,8.163734436035156,7,7
1126,16,4.9645868882232485,5.410700258970024,1.0142846858709014,1.0169950590187324,7,8,10.497281074523926,8.163734436035156,9,8
1126,32,4.387527022835256,5.246443415014551,1.0145419194599474,1.0219032470750327,13,22,11.247751235961914,8.163734436035156,19,10
1126,64,3.1852058800329357,5.218294864964723,1.0059826472516817,1.0236103737531683,33,52,11.914408683776855,8.163734436035156,31,12
1126,128,1.7470811261181836,5.085882500200305,1.0048453413331742,1.029168718632702,67,115,12.40721321105957,8.163734436035156,61,13
1127,1,11.3380523733727,11.338052373372703,0.9160106905299107,0.9160106905299117,0,0,11.612886428833008,11.612886428833008,1,1
1127,2,9.757055092507699,9.757055092507699,0.9561103974293006,0.9561103974293008,0,0,11.743383407592773,11.612886428833008,2,2
1127,3,9.571310546239612,9.571310546239612,0.9627103050351786,0.9627103050351788,0,0,11.808045387268066,11.612886428833008,3,3
1127,4,9.481820993319987,9.481820993319985,0.9654548786463097,0.9654548786463084,0,0,11.888527870178223,11.612886428833008,4,4
1127,8,8.37601380628204,8.406507918205595,0.9961236089126623,0.995986908221764,3,3,12.243599891662598,11.612886428833008,5,5
1127,16,7.959231443853871,8.197877246859655,1.0045994950010013,1.0025234884001155,6,8,13.099571228027344,11.612886428833008,10,8
1127,32,7.24252725196961,7.85552846283985,1.0143830103566938,1.0199672146834127,12,19,13.602794647216797,11.612886428833008,20,13
1127,64,5.111896927926344,7.83627884076693,1.0151678949230867,1.0231945398963247,25,48,14.207426071166992,11.612886428833008,39,16
1127,128,3.0109917294883104,7.574637004644299,1.0117328432629418,1.0370694282812045,59,110,14.80806827545166,11.612886428833008,69,18
1128,1,10.25602793493749,10.25602793493749,0.9397981537683232,0.9397981537683266,0,0,10.405710220336914,10.405710220336914,1,1
1128,2,8.850878918183573,8.850878918183573,0.9794773900631148,0.9794773900631164,0,0,11.71921157836914,10.405710220336914,2,2
1128,3,8.60393454227729,8.60393454227729,0.9863343657353301,0.9863343657353313,0,0,12.157547950744629,10.405710220336914,3,3
1128,4,8.553639046799441,8.553639046799441,0.9875000661984933,0.9875000661984942,0,0,12.531126976013184,10.405710220336914,4,4
1128,8,7.587633867495326,7.686788074511282,1.0130828862194043,1.0137637391408836,2,3,13.38257122039795,10.405710220336914,6,5
1128,16,7.141171177135921,7.616458395853831,1.017974213280902,1.0163377223822563,4,7,14.399144172668457,10.405710220336914,12,9
1128,32,6.365358351799683,7.442431455192766,1.0237931019168869,1.0224222828487521,13,19,14.77733039855957,10.405710220336914,19,13
1128,64,5.135415126566812,7.118494783788938,1.0295548912510735,1.037469146785008,27,48,15.268744468688965,10.405710220336914,37,16
1128,128,3.188698813622312,7.028867339650153,1.0077207704254232,1.0395604957254367,63,108,15.663330078125,10.405710220336914,65,20
1129,1,11.288410053764322,11.288410053764322,0.924879243956024,0.9248792439560259,0,0,11.5078763961792,11.5078763961792,1,1
1129,2,9.455056068474446,9.455056068474448,0.9706272485211,0.9706272485211025,0,0,12.362582206726074,11.5078763961792,2,2
1129,3,9.164390692734575,9.164390692734575,0.9809722856419525,0.9809722856419547,0,0,12.5369234085083,11.5078763961792,3,3
1129,4,9.037831160969771,9.037831160969771,0.9816913194736457,0.9816913194736445,0,0,12.652591705322266,11.5078763961792,4,4
1129,8,8.787297717825686,8.80342831877923,0.9892449010189814,0.9888858759245163,2,2,12.834237098693848,11.5078763961792,6,6
1129,16,8.05753170585884,8.287356250321585,1.007858678525062,1.0042231697625672,6,7,13.09650707244873,11.5078763961792,10,9
1129,32,7.0689967340918605,7.803841378287585,1.0279396843584294,1.0195855788590362,12,19,13.409886360168457,11.5078763961792,20,13
1129,64,5.682632657758448,7.353982742363893,1.0268877913588783,1.0312313750032718,30,49,13.762395858764648,11.5078763961792,34,15
1129,128,3.2028114596166395,7.159983245495211,1.0156564195202744,1.037850153371048,60,108,14.12810230255127,11.5078763961792,68,20
1130,1,8.150723027483789,8.150723027483789,0.9650086934351672,0.9650086934351679,0,0,8.218514442443848,8.218514442443848,1,1
1130,2,7.198599711648662,7.198599711648662,0.9825577007123746,0.9825577007123749,0,0,8.271296501159668,8.218514442443848,2,2
1130,3,5.978542472010072,5.978542472010072,0.9987961447639169,0.9987961447639175,0,0,8.419327735900879,8.218514442443848,3,3
1130,4,5.72658991239209,5.72658991239209,1.0027695166853738,1.0027695166853747,0,0,8.578364372253418,8.218514442443848,4,4
1130,8,4.912925998213047,4.968159849255669,1.0134311920220551,1.012758059524931,1,1,8.971936225891113,8.218514442443848,7,7
1130,16,4.6344544618653245,4.91267128126406,1.0166014071520837,1.0142501764510627,7,8,9.746199607849121,8.218514442443848,9,8
1130,32,3.8296116437567855,4.822177330794293,1.0125116584994884,1.0176353525186597,12,23,10.251974105834961,8.218514442443848,20,9
1130,64,2.650501290775171,4.762084083765173,1.0075882776204168,1.0199441866835195,28,53,10.728751182556152,8.218514442443848,36,11
1130,128,1.3059166701064897,4.740419748987098,1.0009801294891023,1.0200759202634524,57,116,11.156829833984375,8.218514442443848,71,12
1131,1,9.978602238702857,9.978602238702857,0.9450606330716885,0.9450606330716903,0,0,10.110115051269531,10.110115051269531,1,1
1131,2,8.812861395423761,8.812861395423761,0.9718012588617204,0.9718012588617211,0,0,10.881282806396484,10.110115051269531,2,2
1131,3,8.739396913429465,8.739396913429465,0.9737509066499898,0.9737509066499901,0,0,10.965713500976562,10.110115051269531,3,3
1131,4,8.564999398511938,8.564999398511937,0.9786586963732611,0.9786586963732609,0,0,11.590801239013672,10.110115051269531,4,4
1131,8,7.488759666702124,7.501598380087898,1.002630825137401,1.0024996990424393,2,2,12.202274322509766,10.110115051269531,6,6
1131,16,7.012049561863465,7.3433965307424485,1.0122900792014629,1.0102193082291004,4,7,13.164143562316895,10.110115051269531,12,9
1131,32,6.296754746133803,6.89254976101539,1.031855390495466,1.0336078893517946,14,21,13.630005836486816,10.110115051269531,18,11
1131,64,4.5096624585906,6.770607131280137,1.0257813632713622,1.0418279237276822,26,47,14.571413040161133,10.110115051269531,38,17
1131,128,2.841232983646049,6.672779842145289,1.006938595044525,1.0475640685997698,63,111,15.333271980285645,10.110115051269531,65,17
1132,1,5.802988075936328,5.802988075936328,0.9849949283255045,0.9849949283255061,0,0,5.820741176605225,5.820741176605225,1,1
1132,2,4.168920251179123,4.168920251179124,0.999859769821279,0.9998597698212799,0,0,6.136142253875732,5.820741176605225,2,2
1132,3,3.8284851551467955,3.8284851551467955,1.0038729428859228,1.003872942885923,0,0,6.2910590171813965,5.820741176605225,3,3
1132,4,3.5284373189146607,3.52843731891466,1.008614548599721,1.008614548599722,0,0,7.464483261108398,5.820741176605225,4,4
1132,8,3.414673564333622,3.5022673920997804,1.0082951672423968,1.0103987616567671,2,2,8.666030883789062,5.820741176605225,6,6
1132,16,3.2047434996997617,3.40154004079918,1.0114536598448745,1.0137475388390114,6,5,9.069698333740234,5.820741176605225,10,11
1132,32,2.4820426156902715,3.2185180062512693,1.0107142105511757,1.0183953699093369,14,24,10.04826545715332,5.820741176605225,18,8
1132,64,2.0248107822981574,3.1985643240077364,1.0072388160286994,1.0198423190856394,28,52,10.757285118103027,5.820741176605225,36,12
1132,128,1.2943154651789088,3.1741655709870886,1.0008286468133432,1.0208937761896133,66,115,11.558856010437012,5.820741176605225,62,13
1133,1,9.381431285603083,9.381431285603083,0.9457885196482373,0.9457885196482388,0,0,9.521967887878418,9.521967887878418,1,1
1133,2,7.355940208221191,7.35594020822119,0.9888906453719843,0.9888906453719849,0,0,9.5524320602417,9.521967887878418,2,2
1133,3,6.683087899222998,6.683087899222999,0.998075613937278,0.9980756139372797,0,0,9.701950073242188,9.521967887878418,3,3
1133,4,6.593677491281482,6.593677491281483,1.0001715518696372,1.0001715518696386,0,0,9.77928638458252,9.521967887878418,4,4
1133,8,6.002243228798057,6.021242294733582,1.0123093394607854,1.0119831381116224,1,1,10.345093727111816,9.521967887878418,7,7
1133,16,5.381456646225336,5.6509306721835495,1.023435105398068,1.0203096674476648,5,8,10.65597152709961,9.521967887878418,11,8
1133,32,4.712709400686186,5.230536444747652,1.0292474752204528,1.0324444144297558,13,19,11.312112808227539,9.521967887878418,19,13
1133,64,3.689552385384603,5.011475797495487,1.014589942687557,1.0399958567485483,31,47,11.876103401184082,9.521967887878418,33,17
1133,128,2.362163087680322,5.006681483653527,1.0041775309921535,1.0409776802469417,61,107,12.684630393981934,9.521967887878418,67,21
1134,1,10.74112824171298,10.741128241712978,0.9188062038621436,0.9188062038621453,0,0,11.01025676727295,11.01025676727295,1,1
1134,2,8.738615263231793,8.738615263231793,0.9742472614595306,0.9742472614595306,0,0,11.256965637207031,11.01025676727295,2,2
1134,3,8.19309946338333,8.193099463383332,0.9875112571606401,0.9875112571606404,0,0,11.321993827819824,11.01025676727295,3,3
1134,4,8.160110699221757,8.160110699221757,0.9871876382471747,0.9871876382471741,0,0,11.444818496704102,11.01025676727295,4,4
1134,8,7.4800611877903345,7.480061187790333,1.004208402378405,1.0042084023784072,0,0,12.049991607666016,11.01025676727295,8,8
1134,16,6.919185119144769,7.0242668156217,1.0224481887785581,1.01766727630128,3,4,12.562159538269043,11.01025676727295,13,12
1134,32,6.238466704703301,6.915503797872595,1.0275720038970242,1.0216672077985605,13,16,13.307418823242188,11.01025676727295,19,16
1134,64,4.282288937696087,6.75794991193428,1.0126876655176673,1.0279101863111404,26,48,14.164570808410645,11.01025676727295,38,16
1134,128,3.118054279061536,6.608635152391478,1.0065563516959461,1.0402653542116798,68,110,14.88968563079834,11.01025676727295,60,18
1135,1,8.36844403679461,8.36844403679461,0.9534034020083595,0.9534034020083603,0,0,8.486612319946289,8.486612319946289,1,1
1135,2,7.135284171961418,7.135284171961418,0.9762139268829814,0.9762139268829815,0,0,8.552030563354492,8.486612319946289,2,2
1135,3,7.023064905308453,7.023064905308453,0.978707815330796,0.9787078153307963,0,0,9.039199829101562,8.486612319946289,3,3
1135,4,5.969238034481934,5.969238034481935,0.9980561281711451,0.9980561281711456,0,0,9.052845001220703,8.486612319946289,4,4
1135,8,5.50560392881521,5.576508805700115,1.0048826692909727,1.0056171087557544,1,2,9.965997695922852,8.486612319946289,7,6
1135,16,5.204422163134837,5.344757645840921,1.011682077209458,1.012212477342298,3,6,10.198822021484375,8.486612319946289,13,10
1135,32,4.551284969185814,5.339177279188237,1.0109047931291926,1.0132853923506793,14,21,10.852334022521973,8.486612319946289,18,11
1135,64,3.699811016760198,5.303413680535806,1.0157152657904691,1.0165419254576518,32,50,11.415541648864746,8.486612319946289,32,14
1135,128,2.006650940787731,5.235730576783302,1.006383095371961,1.022211843536836,59,109,12.009503364562988,8.486612319946289,69,19
1136,1,8.182287811117423,8.182287811117423,0.9630777579350197,0.9630777579350224,0,0,8.25445556640625,8.25445556640625,1,1
1136,2,6.521873454868826,6.521873454868826,0.9908497254621494,0.9908497254621498,0,0,8.262895584106445,8.25445556640625,2,2
1136,3,5.570301232421661,5.570301232421661,1.0047397769669701,1.0047397769669704,0,0,8.288719177246094,8.25445556640625,3,3
1136,4,5.1008402283809415,5.100840228380941,1.0094616555244953,1.0094616555244948,0,0,8.332131385803223,8.25445556640625,4,4
1136,8,4.820311798323129,4.820311798323129,1.014386550195775,1.0143865501957743,0,0,9.182205200195312,8.25445556640625,8,8
1136,16,4.457719616083817,4.519409514933294,1.0204737962474737,1.0215786172862842,5,5,9.956708908081055,8.25445556640625,11,11
1136,32,3.560413124313944,4.344998836553999,1.0219381420107903,1.0280782743423011,12,19,10.51503849029541,8.25445556640625,20,13
1136,64,2.993122756821255,4.32918515400722,1.0121686251009085,1.029669810909822,31,50,11.266852378845215,8.25445556640625,33,14
1136,128,1.982171473257838,4.324901608710252,0.9997605763392517,1.0302594737576607,63,112,12.300633430480957,8.25445556640625,65,16
1137,1,7.814447570082013,7.814447570082013,0.970918329380011,0.9709183293800122,0,0,7.863621711730957,7.863621711730957,1,1
1137,2,5.964717032038062,5.964717032038062,1.002277897204281,1.0022778972042818,0,0,7.925384998321533,7.863621711730957,2,2
1137,3,5.722563689715272,5.722563689715271,1.0041185384748723,1.004118538474872,0,0,7.9701762199401855,7.863621711730957,3,3
1137,4,5.352231877151901,5.352231877151901,1.0089949470740387,1.0089949470740374,0,0,8.188302040100098,7.863621711730957,4,4
1137,8,4.599274935379974,4.599274935379973,1.0181043271406647,1.018104327140664,0,0,8.473834037780762,7.863621711730957,8,8
1137,16,4.414923092147632,4.535284231923726,1.0185509599786895,1.0189424809968024,3,5,9.201498031616211,7.863621711730957,13,11
1137,32,3.5385773734298245,4.406143465605024,1.015176582963985,1.0230897001428454,12,18,10.008642196655273,7.863621711730957,20,14
1137,64,2.7048731727575537,4.393515499301117,1.005195547582241,1.0234918533933914,32,48,10.594017028808594,7.863621711730957,32,16
1137,128,1.2425031659804338,4.331809745710959,0.9987183833850177,1.0260275914550647,56,113,11.858128547668457,7.863621711730957,72,15
1138,1,7.51167383474354,7.51167383474354,0.9661345674803427,0.9661345674803451,0,0,7.578680515289307,7.578680515289307,1,1
1138,2,5.749672252963986,5.749672252963986,0.9949110960217139,0.9949110960217162,0,0,7.751911640167236,7.578680515289307,2,2
1138,3,5.535355632720178,5.5353556327201785,0.9980677137608183,0.9980677137608205,0,0,8.10726261138916,7.578680515289307,3,3
1138,4,5.303480516201507,5.303480516201507,1.002996402788581,1.0029964027885827,0,0,8.300806999206543,7.578680515289307,4,4
1138,8,4.479255829774343,4.48425356101656,1.0152861290770145,1.0151255899348275,1,1,8.561223030090332,7.578680515289307,7,7
1138,16,4.079635131457239,4.212105010619143,1.0230329109202756,1.0211535472009188,3,4,9.251104354858398,7.578680515289307,13,12
1138,32,3.5913862254434474,4.164655965638519,1.0218955494293342,1.0233639726720951,10,15,9.839882850646973,7.578680515289307,22,17
1138,64,2.7866068000737503,4.085137273283805,1.0158716001752408,1.0267525633001853,32,45,10.528311729431152,7.578680515289307,32,19
1138,128,1.6336572775323501,4.051491401316979,0.9977393595971573,1.0291276707810786,61,108,11.180479049682617,7.578680515289307,67,20
1139,1,9.975773653088421,9.975773653088421,0.9321461327245892,0.9321461327245905,0,0,10.183119773864746,10.183119773864746,1,1
1139,2,9.03207642786344,9.032076427863442,0.9479330411581526,0.9479330411581538,0,0,10.235684394836426,10.183119773864746,2,2
1139,3,9.015891554633493,9.015891554633493,0.947656407952354,0.9476564079523551,0,0,10.306562423706055,10.183119773864746,3,3
1139,4,8.976156729172212,8.976156729172214,0.9487982736906567,0.9487982736906574,0,0,10.474648475646973,10.183119773864746,4,4
1139,8,8.066070427182446,8.09347952229148,0.9752357351243239,0.9745705185168626,3,3,11.044770240783691,10.183119773864746,5,5
1139,16,6.0732476276059435,6.758172132966279,1.0088816381393366,1.0100650376495237,5,6,12.082817077636719,10.183119773864746,11,10
1139,32,5.332489160490123,6.389073266702442,1.0168918125580406,1.0248130999282115,12,16,13.301508903503418,10.183119773864746,20,16
1139,64,4.350440021678417,6.124152445556059,1.0047164203544783,1.032641407344302,30,48,14.407032012939453,10.183119773864746,34,16
1139,128,2.8630934031301147,6.083108771446589,1.0103610712348947,1.0392743657467105,62,109,15.36340045928955,10.183119773864746,66,19
1140,1,6.700533080276402,6.700533080276403,0.9803618088432299,0.9803618088432311,0,0,6.72700834274292,6.72700834274292,1,1
1140,2,5.665606021847135,5.665606021847135,1.0000955227707446,1.0000955227707444,0,0,8.164222717285156,6.72700834274292,2,2
1140,3,5.329331848086698,5.329331848086696,1.0041354100769584,1.004135410076959,0,0,8.329814910888672,6.72700834274292,3,3
1140,4,5.319344208311015,5.319344208311015,1.0043426140539142,1.0043426140539145,0,0,8.343268394470215,6.72700834274292,4,4
1140,8,4.865722971429505,4.9044301380128115,1.0103158463363962,1.0100931770879886,1,2,8.684016227722168,6.72700834274292,7,6
1140,16,4.529047535179973,4.5922431217187905,1.0155753823037617,1.0144092487193543,4,8,8.931154251098633,6.72700834274292,12,8
1140,32,3.866643662781746,4.489723102441319,1.014971011281614,1.0192764273192112,14,19,9.643436431884766,6.72700834274292,18,13
1140,64,2.629257564001912,4.482678493887629,1.0059727218451822,1.0197612155854174,28,52,10.220637321472168,6.72700834274292,36,12
1140,128,1.2969683741531424,4.45753408973155,1.0011934928805666,1.021110322562597,67,115,11.151594161987305,6.72700834274292,61,13
1141,1,2.6152171564899045,2.615217156489905,0.9950811558329443,0.9950811558329464,0,0,2.619637966156006,2.619637966156006,1,1
1141,2,2.3659924568288204,2.365992456828822,0.9960779228397351,0.9960779228397372,0,0,2.6346447467803955,2.619637966156006,2,2
1141,3,2.2304047545890175,2.230404754589019,0.9971685180875929,0.9971685180875947,0,0,2.77563738822937,2.619637966156006,3,3
1141,4,2.1566979238260435,2.156697923826044,0.9980538158538514,0.9980538158538529,0,0,2.8023743629455566,2.619637966156006,4,4
1141,8,1.7221217068978176,1.7977101630488617,0.9996539770356501,0.9995868143671585,3,3,3.057137966156006,2.619637966156006,5,5
1141,16,1.445305806531607,1.5995610378500884,1.0013275692245354,1.0012325919712475,6,6,3.3470864295959473,2.619637966156006,10,10
1141,32,1.1080811288766401,1.5595985994648387,1.0003501574085405,1.0016307527933663,16,20,3.7290256023406982,2.619637966156006,16,12
1141,64,0.5317842359120136,1.3746828350403468,1.0000475303208505,1.0034142248240596,28,52,4.141135215759277,2.619637966156006,36,12
1141,128,0.0935007695157935,1.3440217759532,0.9999918477860666,1.003969302091884,62,115,4.608447074890137,2.619637966156006,66,13
1142,1,6.450101963003521,6.450101963003522,0.9767096738018535,0.9767096738018557,0,0,6.487293243408203,6.487293243408203,1,1
1142,2,5.796942081752298,5.796942081752298,0.9888875299716013,0.9888875299716025,0,0,7.581018924713135,6.487293243408203,2,2
1142,3,5.034724387226356,5.0347243872263565,1.001271411512908,1.0012714115129087,0,0,7.6504740715026855,6.487293243408203,3,3
1142,4,5.002196937222712,5.0021969372227115,1.0021146721993142,1.0021146721993155,0,0,7.702849864959717,6.487293243408203,4,4
1142,8,4.623596356565966,4.626338553033704,1.0082422681920473,1.0084161522664676,1,2,8.480887413024902,6.487293243408203,7,6
1142,16,4.436223422760588,4.453054730675709,1.0138911134578144,1.0146086010162827,5,7,9.204166412353516,6.487293243408203,11,9
1142,32,3.8848842876796157,4.15733811404713,1.016544433724035,1.0220564897474027,14,18,9.820087432861328,6.487293243408203,18,14
1142,64,2.8417453235118604,4.096820329523286,1.0031407248995565,1.025385414711489,32,44,10.516233444213867,6.487293243408203,32,20
1142,128,1.8368620458045695,4.093702841542163,1.0017680943525993,1.0262160985328634,65,107,11.252557754516602,6.487293243408203,63,21
1143,1,5.0707140294263,5.0707140294263,0.9851871091067883,0.9851871091067896,0,0,5.090280532836914,5.090280532836914,1,1
1143,2,4.236689607808496,4.236689607808496,0.9959184701357235,0.995918470135724,0,0,6.1511149406433105,5.090280532836914,2,2
1143,3,4.103821796030693,4.103821796030692,0.9977525541768868,0.9977525541768867,0,0,6.26309061050415,5.090280532836914,3,3
1143,4,4.061791316976481,4.061791316976481,0.9989498093040667,0.9989498093040671,0,0,6.3001556396484375,5.090280532836914,4,4
1143,8,3.5188526180460284,3.554222332144138,1.0057020955565332,1.0056911400174435,2,2,6.818265438079834,5.090280532836914,6,6
1143,16,3.1055620035890064,3.307828032254689,1.0075940080075971,1.0102091311162757,6,7,7.447756767272949,5.090280532836914,10,9
1143,32,2.4257307663828795,3.2050619719932585,1.0061637095388394,1.0124629742059152,11,22,8.1637544631958,5.090280532836914,21,10
1143,64,1.5598376528483826,3.193682676202036,1.001664609694841,1.0133270793384728,29,50,8.851495742797852,5.090280532836914,35,14
1143,128,0.8997572113475575,3.187340592387948,0.9999762419666248,1.0143293733313001,61,113,9.61617374420166,5.090280532836914,67,15
1144,1,10.505319269690816,10.505319269690817,0.936094546140523,0.936094546140526,0,0,10.680659294128418,10.680659294128418,1,1
1144,2,9.20340387219086,9.203403872190862,0.970316922458705,0.9703169224587062,0,0,11.322813034057617,10.680659294128418,2,2
1144,3,8.870492680728557,8.870492680728555,0.9787961308070259,0.9787961308070271,0,0,11.404986381530762,10.680659294128418,3,3
1144,4,8.483338457489705,8.483338457489705,0.9879978660878171,0.9879978660878186,0,0,11.592536926269531,10.680659294128418,4,4
1144,8,7.589503036337702,7.664240120260651,1.0085202824009523,1.0081321301984292,2,2,11.95695686340332,10.680659294128418,6,6
1144,16,7.161772611324471,7.24450246470352,1.0232605981500846,1.0211368454242626,4,4,12.580899238586426,10.680659294128418,12,12
1144,32,5.989154131910919,6.562928050282703,1.0325199878621762,1.0370616586792978,12,15,13.44894790649414,10.680659294128418,20,17
1144,64,4.564050026444302,6.433700049170499,1.0202491229684316,1.0448109578484686,25,47,14.120159149169922,10.680659294128418,39,17
1144,128,3.2843609928963193,6.426125739994174,1.0096581789979024,1.0459590862697687,63,108,14.921101570129395,10.680659294128418,65,20
1145,1,7.375155332169303,7.375155332169303,0.9624984840781713,0.9624984840781722,0,0,7.460295677185059,7.460295677185059,1,1
1145,2,5.311793232714258,5.311793232714259,0.9972427757067948,0.9972427757067948,0,0,8.775802612304688,7.460295677185059,2,2
1145,3,4.847510699044257,4.847510699044257,1.0059608383149834,1.0059608383149832,0,0,9.134597778320312,7.460295677185059,3,3
1145,4,4.8453632961805555,4.8453632961805555,1.005951306962593,1.0059513069625927,0,0,9.450579643249512,7.460295677185059,4,4
1145,8,4.726106540780481,4.771682631488867,1.0086979325750058,1.0083656002789847,2,2,9.829339027404785,7.460295677185059,6,6
1145,16,4.233351708635074,4.4611120527323,1.0194305956722083,1.017611483565925,5,6,10.512717247009277,7.460295677185059,11,10
1145,32,3.5045151112277777,4.371809387972094,1.0203692833234785,1.0200902047429634,14,20,11.085649490356445,7.460295677185059,18,12
1145,64,2.9629383155323454,4.2836673655165525,1.012492223261075,1.0255559557153653,29,51,11.724398612976074,7.460295677185059,35,13
1145,128,2.0903655308708147,4.153412995268837,1.0024139044251565,1.0285276171350457,56,111,12.497048377990723,7.460295677185059,72,17
1146,1,9.730887291543823,9.730887291543826,0.933286459472053,0.9332864594720548,0,0,9.927586555480957,9.927586555480957,1,1
1146,2,8.750273525324584,8.750273525324584,0.9594694671264481,0.9594694671264488,0,0,10.880674362182617,9.927586555480957,2,2
1146,3,8.500586992932885,8.500586992932885,0.9693793852685983,0.9693793852685988,0,0,11.002284049987793,9.927586555480957,3,3
1146,4,8.4241430056694,8.4241430056694,0.9720616210799674,0.972061621079968,0,0,11.08630657196045,9.927586555480957,4,4
1146,8,8.130911247855115,8.154893466474372,0.9802973817297428,0.9804720459766958,2,2,11.302297592163086,9.927586555480957,6,6
1146,16,6.967319428402901,7.674643494613904,1.0026603118936674,0.9931604821466821,4,8,11.689412117004395,9.927586555480957,12,8
1146,32,6.308983715323794,7.138432005694619,1.0210418848654306,1.0108474670102714,13,22,12.075908660888672,9.927586555480957,19,10
1146,64,5.38239921693935,7.11008104985024,1.013279442043429,1.0131060196171016,29,48,12.511486053466797,9.927586555480957,35,16
1146,128,3.356131775846319,7.0059368870287555,1.0091223364234572,1.018358104324007,62,111,13.202693939208984,9.927586555480957,66,17
1147,1,5.6009914526624796,5.6009914526624796,0.9802725527241531,0.980272552724153,0,0,5.633855819702148,5.633855819702148,1,1
1147,2,4.65445082363681,4.654450823636809,0.9939801580554619,0.9939801580554612,0,0,6.003054618835449,5.633855819702148,2,2
1147,3,4.3151512471657005,4.3151512471657005,0.9977959998171657,0.997795999817165,0,0,6.008008003234863,5.633855819702148,3,3
1147,4,4.3145115621096455,4.3151512471657005,0.9978359231303086,0.9977959998171655,1,1,6.3451690673828125,5.633855819702148,3,3
1147,8,3.9042434282253846,4.028954517125116,1.000714084741194,1.0013821746340297,3,4,6.795926570892334,5.633855819702148,5,4
1147,16,3.5618363183867787,3.818305030246807,1.0039614257058105,1.0063503357133539,6,9,7.530210971832275,5.633855819702148,10,7
1147,32,2.315183738147925,3.5606829675864677,1.0040963579873745,1.013987437762805,13,23,8.048653602600098,5.633855819702148,19,9
1147,64,1.3934723882233153,3.558034698296721,0.9993559748486924,1.0141561592024173,34,53,8.645240783691406,5.633855819702148,30,11
1147,128,0.5786322515018154,3.53814267072111,0.997232359989843,1.0150244953887846,61,113,9.762505531311035,5.633855819702148,67,15
1148,1,9.352701601276916,9.352701601276912,0.9378433819402693,0.9378433819402714,0,0,9.536459922790527,9.536459922790527,1,1
1148,2,8.433245672792275,8.433245672792273,0.9611941222520102,0.9611941222520111,0,0,9.646076202392578,9.536459922790527,2,2
1148,3,7.980033710011417,7.9800337100114165,0.9729231179930762,0.9729231179930762,0,0,9.896265983581543,9.536459922790527,3,3
1148,4,7.145128530827398,7.145128530827396,0.987021407509712,0.9870214075097128,0,0,9.920552253723145,9.536459922790527,4,4
1148,8,6.805186591003467,6.832267453618827,0.994000395859486,0.9928827361162733,2,2,10.348310470581055,9.536459922790527,6,6
1148,16,6.201654677889102,6.501775287361256,1.0088596253019524,1.003170088456033,5,6,10.868207931518555,9.536459922790527,11,10
1148,32,4.844387530306005,5.631204768363911,1.0258492932498726,1.0235805876122652,11,23,11.347622871398926,9.536459922790527,21,9
1148,64,4.001599828812656,5.6265590562506205,1.012100268019791,1.0241205338069679,31,53,11.9613676071167,9.536459922790527,33,11
1148,128,2.4517097036470923,5.547690937060576,1.0025301358660217,1.0289035316402884,57,112,12.573348045349121,9.536459922790527,71,16
1149,1,9.506047564807712,9.506047564807716,0.9480708957433924,0.9480708957433942,0,0,9.630614280700684,9.630614280700684,1,1
1149,2,8.364559174940675,8.364559174940661,0.9678192825214854,0.9678192825214879,0,0,9.814003944396973,9.630614280700684,2,2
1149,3,7.702764647617977,7.702764647617977,0.9799248898618299,0.9799248898618301,0,0,10.142842292785645,9.630614280700684,3,3
1149,4,7.699589468692898,7.699589468692899,0.9801736043796596,0.9801736043796597,0,0,10.191736221313477,9.630614280700684,4,4
1149,8,6.666146372590198,6.717566967937232,1.0057497521083905,1.005635941605587,1,1,10.537969589233398,9.630614280700684,7,7
1149,16,5.570570084060151,5.7345484378391065,1.0256136699965221,1.0239507127050307,4,5,10.760669708251953,9.630614280700684,12,11
1149,32,5.1263427319955985,5.504941829950807,1.0308940314000772,1.0308308540593498,14,19,11.338828086853027,9.630614280700684,18,13
1149,64,3.955869720434635,5.341687370501152,1.0189286978818968,1.0364079494011231,30,49,12.087919235229492,9.630614280700684,34,15
1149,128,2.075752607108259,5.341256473903586,1.0037871594642247,1.0363982607663804,61,112,12.696331977844238,9.630614280700684,67,16
1150,1,8.541776908736711,8.541776908736711,0.955802067052746,0.9558020670527472,0,0,8.643793106079102,8.643793106079102,1,1
1150,2,7.60856469150914,7.608564691509141,0.9785539965803302,0.9785539965803316,0,0,9.062884330749512,8.643793106079102,2,2
1150,3,7.402204201555576,7.402204201555576,0.9820547808619058,0.9820547808619068,0,0,9.271138191223145,8.643793106079102,3,3
1150,4,7.145838944689686,7.145838944689686,0.9885472626315156,0.9885472626315168,0,0,9.527310371398926,8.643793106079102,4,4
1150,8,5.68724378255188,5.724854253522786,1.0146777873515254,1.0145527678783473,2,3,9.915861129760742,8.643793106079102,6,5
1150,16,5.241891055645576,5.528285356641658,1.0170461532708095,1.0189925581079637,6,8,10.492088317871094,8.643793106079102,10,8
1150,32,4.378497050377212,5.283788426027683,1.0243325365153264,1.0276374915563504,13,20,11.116487503051758,8.643793106079102,19,12
1150,64,3.070466104534438,5.225524430368467,1.0121932743135886,1.030082208643648,28,51,11.81286907196045,8.643793106079102,36,13
1150,128,1.7898022998388177,5.200225548532805,1.0028230388067454,1.0321904586408217,61,112,12.388840675354004,8.643793106079102,67,16
1151,1,7.785641651956447,7.785641651956447,0.9619193724993853,0.9619193724993869,0,0,7.869955539703369,7.869955539703369,1,1
1151,2,6.2937083203913975,6.2937083203913975,0.988325351782344,0.9883253517823452,0,0,8.154097557067871,7.869955539703369,2,2
1151,3,6.204270780683627,6.204270780683627,0.990419268107231,0.9904192681072322,0,0,8.650309562683105,7.869955539703369,3,3
1151,4,5.882540062833028,5.882540062833028,0.9997210821567273,0.9997210821567277,0,0,9.15576457977295,7.869955539703369,4,4
1151,8,5.204010248190299,5.284179006822033,1.008293854959517,1.0096514493334678,2,1,10.303814888000488,7.869955539703369,6,7
1151,16,4.416571513585387,4.802944633491768,1.0133907335862489,1.0189597833585164,7,7,11.204124450683594,7.869955539703369,9,9
1151,32,3.7404588076562755,4.7974004404932185,1.0061346036987249,1.019658110598972,15,22,12.003556251525879,7.869955539703369,17,10
1151,64,2.9775203379183925,4.7897372467909545,1.008071850720681,1.0208677086310651,30,52,13.146917343139648,7.869955539703369,34,12
1151,128,1.8187401842655742,4.772111907389693,1.0036404928482374,1.0220172053832495,66,115,13.661429405212402,7.869955539703369,62,13
1152,1,8.68130962076313,8.681309620763127,0.9508493224522093,0.950849322452212,0,0,8.803715705871582,8.803715705871582,1,1
1152,2,7.111778478380625,7.111778478380627,0.9778290855303821,0.9778290855303837,0,0,9.135092735290527,8.803715705871582,2,2
1152,3,6.89457711483973,6.89457711483973,0.9838283096587745,0.9838283096587749,0,0,9.225491523742676,8.803715705871582,3,3
1152,4,6.888475689640564,6.888475689640564,0.9841793216286683,0.9841793216286682,0,0,9.468022346496582,8.803715705871582,4,4
1152,8,5.885677011391002,5.906641391795189,1.0032814979251707,1.00312276867515,1,2,9.877628326416016,8.803715705871582,7,6
1152,16,5.669296286100528,5.867053102615098,1.0056952403742085,1.0050079746176812,7,8,10.44509220123291,8.803715705871582,9,8
1152,32,4.736466806243295,5.436660975835098,1.015621785759353,1.015604341936395,15,24,10.94482421875,8.803715705871582,17,8
1152,64,3.626249212970158,5.36684511778155,1.0085161361058221,1.0193531399214835,30,53,11.737555503845215,8.803715705871582,34,11
1152,128,2.199610333812526,5.268139026405794,1.0038310387545828,1.0256595234801131,61,116,12.577568054199219,8.803715705871582,67,12
1153,1,8.65225306271708,8.652253062717081,0.956093930990922,0.9560939309909245,0,0,8.747414588928223,8.747414588928223,1,1
1153,2,7.921675091564825,7.921675091564825,0.9759457329048051,0.9759457329048065,0,0,10.441987037658691,8.747414588928223,2,2
1153,3,6.94968211944456,6.94968211944456,1.0023100056254137,1.0023100056254144,0,0,10.996790885925293,8.747414588928223,3,3
1153,4,6.454390141066894,6.454390141066895,1.0111892184689273,1.011189218468929,0,0,10.999948501586914,8.747414588928223,4,4
1153,8,5.725753182160172,6.016487572497713,1.01885911932527,1.019092007289596,1,1,11.600915908813477,8.747414588928223,7,7
1153,16,5.229496423044312,5.818266091787804,1.020016843703449,1.0238278475519642,6,9,12.33877944946289,8.747414588928223,10,7
1153,32,4.412374449886538,5.683134066526021,1.0249677424775594,1.028549067494304,17,22,12.906869888305664,8.747414588928223,15,10
1153,64,3.3886357816171273,5.499447396097072,1.011874901660073,1.0368426296936104,29,53,13.68586254119873,8.747414588928223,35,11
1153,128,2.035605097733866,5.495238785344615,1.004522169395547,1.0374492599400025,65,116,15.157200813293457,8.747414588928223,63,12
1154,1,8.451776331608482,8.451776331608485,0.9613892274291834,0.9613892274291849,0,0,8.529752731323242,8.529752731323242,1,1
1154,2,7.6127765063949475,7.612776506394948,0.976482483491755,0.9764824834917558,0,0,9.038300514221191,8.529752731323242,2,2
1154,3,7.0377306979142675,7.037730697914266,0.9906478144950074,0.9906478144950079,0,0,9.75718879699707,8.529752731323242,3,3
1154,4,6.728044987402162,6.728044987402162,0.9968565910642346,0.9968565910642356,0,0,9.81386947631836,8.529752731323242,4,4
1154,8,5.658319478502673,5.658549759904974,1.0159787256661805,1.016001467851264,1,1,10.155820846557617,8.529752731323242,7,7
1154,16,5.450729337527115,5.560041255451603,1.0188840466527904,1.018346528822975,5,7,10.52700424194336,8.529752731323242,11,9
1154,32,4.470940164243303,5.015860902312508,1.0285082742224927,1.030144099751212,14,16,11.079119682312012,8.529752731323242,18,16
1154,64,3.4452978964688037,4.958297969649211,1.0083960035236545,1.0335205892715487,31,46,11.795110702514648,8.529752731323242,33,18
1154,128,2.218046884378978,4.926075301057604,0.9986670594833408,1.034483361196075,62,108,12.624625205993652,8.529752731323242,66,20
1155,1,9.382387081759871,9.382387081759877,0.947454229690164,0.9474542296901665,0,0,9.514398574829102,9.514398574829102,1,1
1155,2,7.592546827088524,7.592546827088527,0.9821973529353762,0.9821973529353782,0,0,9.525104522705078,9.514398574829102,2,2
1155,3,6.764997725117172,6.764997725117172,0.997648195007532,0.9976481950075335,0,0,9.768671035766602,9.514398574829102,3,3
1155,4,6.7270112444065315,6.727011244406532,0.9993705089963763,0.999370508996377,0,0,9.942392349243164,9.514398574829102,4,4
1155,8,6.332409002453912,6.354055552928172,1.0090303956225242,1.0085294896328938,1,1,10.453598976135254,9.514398574829102,7,7
1155,16,5.630197776803563,5.956833766393247,1.0200644248720916,1.018289806843804,5,6,10.745318412780762,9.514398574829102,11,10
1155,32,5.113035625792595,5.783377448194078,1.0240983329763163,1.0259792275668176,10,19,11.500195503234863,9.514398574829102,22,13
1155,64,3.4916388291590272,5.604410376956753,1.0184314526649667,1.0336132990910327,29,46,12.201170921325684,9.514398574829102,35,18
1155,128,2.359003033928592,5.4882147052549275,1.00632134334435,1.0410041365113725,69,108,13.117090225219727,9.514398574829102,59,20
1156,1,8.66923755078615,8.669237550786148,0.9544761812675918,0.9544761812675936,0,0,8.778812408447266,8.778812408447266,1,1
1156,2,6.782131005836615,6.782131005836615,0.9943459524534783,0.9943459524534782,0,0,8.831374168395996,8.778812408447266,2,2
1156,3,6.110742476371902,6.110742476371903,1.0059694250106592,1.0059694250106594,0,0,8.943716049194336,8.778812408447266,3,3
1156,4,5.709827375712858,5.709827375712859,1.0108734737102545,1.0108734737102556,0,0,8.96040153503418,8.778812408447266,4,4
1156,8,5.247366097200302,5.310237580678903,1.0184906259873971,1.0183265133086645,1,1,9.228455543518066,8.778812408447266,7,7
1156,16,4.8161006744887676,4.935102157956717,1.0212363774748676,1.0211911393358863,4,6,9.658905982971191,8.778812408447266,12,10
1156,32,4.102374482665487,4.805741554290906,1.022897474214284,1.0255413162829823,10,14,10.095723152160645,8.778812408447266,22,18
1156,64,3.3382697517965503,4.591025090448538,1.0199796837447115,1.0338520027205638,32,43,10.625805854797363,8.778812408447266,32,21
1156,128,1.801459616471606,4.5463587517347595,1.0048126246198519,1.0358290426392216,63,108,11.382752418518066,8.778812408447266,65,20
1157,1,8.52406911025822,8.524069110258221,0.947570559822036,0.947570559822038,0,0,8.668270111083984,8.668270111083984,1,1
1157,2,6.599340905078421,6.599340905078421,0.9865139125009534,0.9865139125009537,0,0,8.769360542297363,8.668270111083984,2,2
1157,3,6.297667304638783,6.297667304638783,0.9921119928217823,0.992111992821782,0,0,9.073912620544434,8.668270111083984,3,3
1157,4,6.2598507495760805,6.2598507495760805,0.9928993037975635,0.9928993037975626,0,0,9.122220039367676,8.668270111083984,4,4
1157,8,5.459674432651356,5.46641252380805,1.0087295766037603,1.0088162719854783,1,1,9.524767875671387,8.668270111083984,7,7
1157,16,4.932279108432317,5.386808485504437,1.0127103367709447,1.0121947496642347,5,7,10.126721382141113,8.668270111083984,11,9
1157,32,4.538982923302731,5.320336887104199,1.0123573950500917,1.0147464551305605,12,21,10.453149795532227,8.668270111083984,20,11
1157,64,3.688882870143352,5.3078734035026605,1.0071610627331002,1.015719711157438,26,50,11.009729385375977,8.668270111083984,38,14
1157,128,2.503654659864973,5.26684288675903,0.9999839750568126,1.0191323255140305,60,113,11.621265411376953,8.668270111083984,68,15
1158,1,4.900219407878616,4.900219407878617,0.9820727431155483,0.9820727431155494,0,0,4.931549549102783,4.931549549102783,1,1
1158,2,4.633818194334818,4.633818194334818,0.9843500185362646,0.9843500185362652,0,0,5.0487847328186035,4.931549549102783,2,2
1158,3,4.604638936544523,4.604638936544523,0.9852689834345091,0.9852689834345093,0,0,5.275801181793213,4.931549549102783,3,3
1158,4,4.583503158149085,4.604638936544523,0.985032838422792,0.9852689834345093,1,1,5.309258460998535,4.931549549102783,3,3
1158,8,4.500228753340994,4.547589355124437,0.9874130814009412,0.986332019379395,3,3,5.403451442718506,4.931549549102783,5,5
1158,16,3.685259799679296,4.226482074379975,0.992977484745088,0.9922139899312836,7,10,5.56376314163208,4.931549549102783,9,6
1158,32,3.3274506681895653,4.172691360094749,0.9951599285123436,0.9926946028582994,15,26,5.809685230255127,4.931549549102783,17,6
1158,64,2.7828361237002346,3.908331248661179,0.9965146424352517,0.9975341890876571,31,55,6.046638011932373,4.931549549102783,33,9
1158,128,0.6707798361240924,2.894686347849315,1.0003373233144597,1.0076673607903581,68,117,6.346719741821289,4.931549549102783,60,11
1159,1,6.753815187034624,6.75381518703462,0.9761636040225917,0.9761636040225957,0,0,6.792377948760986,6.792377948760986,1,1
1159,2,6.381720553627191,6.381720553627192,0.984966921593847,0.9849669215938506,0,0,7.998905181884766,6.792377948760986,2,2
1159,3,6.283323801275386,6.283323801275386,0.9887493086822527,0.9887493086822564,0,0,8.717814445495605,6.792377948760986,3,3
1159,4,6.277989753392561,6.283323801275386,0.9882409990236714,0.9887493086822564,1,1,8.798696517944336,6.792377948760986,3,3
1159,8,5.5276833742457905,5.772258895081336,0.9949978775492644,0.9987407603336017,3,4,9.295680046081543,6.792377948760986,5,4
1159,16,4.011603042385683,5.674545183435864,0.9916215176430303,1.0026408340051514,7,11,10.653536796569824,6.792377948760986,9,5
1159,32,3.376293393355206,5.460533724131641,0.9993646464294632,1.0073939019520954,14,25,11.39867115020752,6.792377948760986,18,7
1159,64,2.535828909840206,4.964160346991653,1.002382953242121,1.0273539103517446,31,54,12.045354843139648,6.792377948760986,33,10
1159,128,1.5986763606749101,4.93079840984463,1.0005623691685726,1.028851475489751,64,117,13.098612785339355,6.792377948760986,64,11
1160,1,12.939035156286767,12.939035156286767,0.9015400838817133,0.9015400838817157,0,0,13.24197006225586,13.24197006225586,1,1
1160,2,10.19045708090788,10.19045708090788,0.9847792664368955,0.9847792664368948,0,0,13.975107192993164,13.24197006225586,2,2
1160,3,9.696727678630866,9.696727678630864,0.9959059847397711,0.9959059847397735,0,0,13.987565040588379,13.24197006225586,3,3
1160,4,9.692863729709877,9.696727678630866,0.9961855694087558,0.9959059847397718,1,1,14.100275993347168,13.24197006225586,3,3
1160,8,8.697326355570162,8.70925045076271,1.0231725077029221,1.022382151272928,1,2,14.435267448425293,13.24197006225586,7,6
1160,16,8.03885646035561,8.116995314200274,1.0427970278523735,1.0403133677265166,5,5,15.35275650024414,13.24197006225586,11,11
1160,32,6.938269498753336,8.059247284184492,1.0455435103650375,1.04290368266876,15,21,15.803689002990723,13.24197006225586,17,11
1160,64,5.442202112668827,7.751641475121681,1.0336839438268464,1.055844673643627,31,52,16.352787017822266,13.24197006225586,33,12
1160,128,3.1999595267555736,7.7150118015375355,1.0088719812095746,1.0601412202980527,60,115,16.939289093017578,13.24197006225586,68,13
1161,1,13.097682171263509,13.09768217126351,0.9034105277717527,0.9034105277717536,0,0,13.406974792480469,13.406974792480469,1,1
1161,2,11.771796637718543,11.771796637718541,0.9459283268232961,0.9459283268232956,0,0,14.207555770874023,13.406974792480469,2,2
1161,3,11.388342936488009,11.38834293648801,0.9645965992094456,0.9645965992094446,0,0,15.289284706115723,13.406974792480469,3,3
1161,4,11.303509204517374,11.303509204517372,0.968559614266391,0.9685596142663901,0,0,15.367925643920898,13.406974792480469,4,4
1161,8,10.49927566409519,10.511919630100419,1.000999169329241,1.0011775039283157,2,2,16.591960906982422,13.406974792480469,6,6
1161,16,9.889148705815051,10.25543035294958,1.0085065627868364,1.01461251437265,7,7,17.15081024169922,13.406974792480469,9,9
1161,32,8.861641051111825,10.087652504379141,1.013301343800975,1.0219122710097248,12,22,17.80314826965332,13.406974792480469,20,10
1161,64,7.268992356276634,9.845986731799146,1.025486329224156,1.0355007322287433,27,50,18.394512176513672,13.406974792480469,37,14
1161,128,4.334313659154294,9.844915765103682,1.0205238440918163,1.0360443468439002,57,113,18.885746002197266,13.406974792480469,71,15
1162,1,6.827427866178846,6.82742786617885,0.9753229931106682,0.97532299311067,0,0,6.8676018714904785,6.8676018714904785,1,1
1162,2,6.008789485731176,6.008789485731178,0.9950080650566748,0.9950080650566764,0,0,7.963199615478516,6.8676018714904785,2,2
1162,3,5.778447322919627,5.778447322919626,1.0020478848171466,1.0020478848171481,0,0,9.728238105773926,6.8676018714904785,3,3
1162,4,5.6281019966762065,5.628101996676208,1.0091969722116192,1.009196972211619,0,0,9.976380348205566,6.8676018714904785,4,4
1162,8,5.444557313427895,5.444557313427895,1.016744618812965,1.0167446188129639,0,0,10.460817337036133,6.8676018714904785,8,8
1162,16,5.131120158107375,5.187680279601096,1.020372824608275,1.0211115588456012,3,5,10.683244705200195,6.8676018714904785,13,11
1162,32,4.739804743262133,5.074660201972686,1.0207836334236369,1.0249850497723147,13,16,11.404953956604004,6.8676018714904785,19,16
1162,64,3.6400555438460698,5.029844258463187,1.0111656569853098,1.025490951082329,25,50,12.049561500549316,6.8676018714904785,39,14
1162,128,2.189633997132784,4.936391567531269,1.0045711455770578,1.029599159879957,62,110,12.84788990020752,6.8676018714904785,66,18
1163,1,8.768500830412478,8.76850083041248,0.9611498179066936,0.961149817906695,0,0,8.845272064208984,8.845272064208984,1,1
1163,2,7.337816507232541,7.337816507232542,0.9919056931098015,0.9919056931098024,0,0,8.860060691833496,8.845272064208984,2,2
1163,3,6.442176167339209,6.442176167339209,1.0040593872261756,1.0040593872261756,0,0,8.882331848144531,8.845272064208984,3,3
1163,4,6.355554505853642,6.355554505853642,1.005152357801916,1.005152357801916,0,0,8.900480270385742,8.845272064208984,4,4
1163,8,5.410220080490162,5.411735675487383,1.0164941785503754,1.0165692155824257,1,1,9.254563331604004,8.845272064208984,7,7
1163,16,4.575625979482247,4.637639892171394,1.0272660922642598,1.027678108660181,3,3,10.163260459899902,8.845272064208984,13,13
1163,32,3.9146737932353743,4.579083349868437,1.020825587840624,1.0278792630934301,14,19,10.630507469177246,8.845272064208984,18,13
1163,64,3.15268538726418,4.558714519654268,1.0118047922799835,1.0291283479224806,32,49,11.244392395019531,8.845272064208984,32,15
1163,128,1.6154786799216352,4.453382003914265,1.0022793336663876,1.033023650272431,67,113,11.953433990478516,8.845272064208984,61,15
1164,1,10.244190171082128,10.244190171082124,0.9304355890029935,0.9304355890029958,0,0,10.451432228088379,10.451432228088379,1,1
1164,2,9.403055581758355,9.403055581758357,0.9505742101261904,0.9505742101261918,0,0,10.864439964294434,10.451432228088379,2,2
1164,3,8.486248535147505,8.486248535147507,0.9769643016864193,0.9769643016864189,0,0,12.0220365524292,10.451432228088379,3,3
1164,4,7.8215189206024816,7.8215189206024816,0.9986226340628024,0.9986226340628022,0,0,12.530609130859375,10.451432228088379,4,4
1164,8,7.447314971503785,7.447314971503785,1.0137905151782165,1.0137905151782163,0,0,12.631122589111328,10.451432228088379,8,8
1164,16,6.540895840911608,7.103795361830385,1.0220216770916346,1.0271058604978984,6,7,13.367631912231445,10.451432228088379,10,9
1164,32,6.037497018265306,7.002062768099979,1.0343559085087337,1.0346214661604975,11,17,13.79412841796875,10.451432228088379,21,15
1164,64,4.729263506314927,6.799511686211373,1.0291099647225201,1.0435333486539298,27,48,14.324084281921387,10.451432228088379,37,16
1164,128,3.175031439164175,6.681276699085066,1.012831542534863,1.04857125083351,61,109,14.760120391845703,10.451432228088379,67,19
1165,1,7.859271475752757,7.859271475752757,0.9718151473206444,0.9718151473206458,0,0,7.904458045959473,7.904458045959473,1,1
1165,2,6.560434853208417,6.560434853208418,0.9923826122192312,0.9923826122192326,0,0,7.948489189147949,7.904458045959473,2,2
1165,3,5.800513799251387,5.800513799251387,1.003681777526635,1.0036817775266351,0,0,8.171526908874512,7.904458045959473,3,3
1165,4,5.7990562764525935,5.800513799251387,1.003616061082167,1.0036817775266351,1,1,8.223100662231445,7.904458045959473,3,3
1165,8,5.49516835332295,5.5056013059177715,1.0084494497951837,1.008607019366802,2,2,8.568965911865234,7.904458045959473,6,6
1165,16,4.291194613190443,4.416652974191957,1.0214398507708005,1.021332245026452,6,7,8.986847877502441,7.904458045959473,10,9
1165,32,3.809152188678969,4.311301023297195,1.023102625728158,1.0254476193333089,12,17,9.48340129852295,7.904458045959473,20,15
1165,64,3.0326470783620345,4.123426710515954,1.0134564721671475,1.0286218114453636,27,50,10.075922012329102,7.904458045959473,37,14
1165,128,1.5240012244938543,4.123387969459343,1.002308176811657,1.0286668674713026,62,113,10.811440467834473,7.904458045959473,66,15
1166,1,1.9827640648674059,1.9827640648674063,0.9975202675726776,0.9975202675726792,0,0,1.9842557907104492,1.9842557907104492,1,1
1166,2,1.9394700292364677,1.9394700292364682,0.9982880350201229,0.9982880350201239,0,0,3.6662356853485107,1.9842557907104492,2,2
1166,3,1.8901347694829223,1.9394700292364682,0.9977810148967569,0.9982880350201239,1,1,3.745940923690796,1.9842557907104492,2,2
1166,4,1.8399821943517656,1.9280163698793922,0.998318008626832,0.9986281910862598,1,1,4.03011417388916,1.9842557907104492,3,3
1166,8,1.5506670034539332,1.9280163698793922,0.9971019350559922,0.9986281910862598,3,5,4.777667999267578,1.9842557907104492,5,3
1166,16,1.4513118897341462,1.8990753085614642,0.9975416399126162,0.9994831786467808,8,12,5.046601295471191,1.9842557907104492,8,4
1166,32,1.1303844284623403,1.836852375515096,0.9992549524693388,1.0003752396723165,15,28,5.689151287078857,1.9842557907104492,17,4
1166,64,0.6857106902619159,1.836852375515096,0.9990665099541287,1.0003752396723165,27,60,6.351865291595459,1.9842557907104492,37,4
1166,128,0.29169523401779746,1.8368523755150965,0.9999037716047636,1.0003752396723167,66,124,7.080807209014893,1.9842557907104492,62,4
1167,1,6.9951431702669,6.9951431702669,0.9660644831532357,0.9660644831532375,0,0,7.068106651306152,7.068106651306152,1,1
1167,2,6.12214260828661,6.122142608286609,0.976307936688265,0.9763079366882645,0,0,7.389580249786377,7.068106651306152,2,2
1167,3,5.5022443103560725,5.5022443103560725,0.9874046394491314,0.9874046394491309,0,0,7.526353359222412,7.068106651306152,3,3
1167,4,5.484415845784284,5.484415845784283,0.9883463188262995,0.9883463188262995,0,0,7.668259143829346,7.068106651306152,4,4
1167,8,4.99320047704938,5.033113644655355,0.9976498633535508,0.9979210390027932,1,1,8.348477363586426,7.068106651306152,7,7
1167,16,4.539025259486195,4.797990116176321,1.006445447254733,1.005951980415499,4,4,8.789316177368164,7.068106651306152,12,12
1167,32,3.6645333234881368,4.364925696353622,1.0107383801086383,1.0155282296789991,15,21,9.556812286376953,7.068106651306152,17,11
1167,64,2.6256127975449406,4.259646656791788,1.0009799958717278,1.0203292804475408,28,49,10.446124076843262,7.068106651306152,36,15
1167,128,1.5996437454739714,4.245093759807418,0.997517506878316,1.0219855090769854,69,110,11.283507347106934,7.068106651306152,59,18
1168,1,10.36281958104741,10.36281958104741,0.9301005026548157,0.9301005026548178,0,0,10.570347785949707,10.570347785949707,1,1
1168,2,8.640329683730908,8.640329683730908,0.9693172098570205,0.9693172098570235,0,0,10.674120903015137,10.570347785949707,2,2
1168,3,8.386417166959927,8.386417166959928,0.9757057194695251,0.9757057194695278,0,0,11.317816734313965,10.570347785949707,3,3
1168,4,8.313677147145022,8.313677147145022,0.9781453697670535,0.9781453697670556,0,0,11.463545799255371,10.570347785949707,4,4
1168,8,7.760246721067734,7.760246721067733,0.9964017560044436,0.9964017560044462,0,0,12.652050971984863,10.570347785949707,8,8
1168,16,6.938781921404169,7.3507354421995545,1.0135962855348923,1.0116807803016814,5,8,14.027596473693848,10.570347785949707,11,8
1168,32,5.05373502272013,6.9378345404760315,1.0086325632884159,1.0210119519692284,15,23,14.491654396057129,10.570347785949707,17,9
1168,64,4.164239401665291,6.9378345404760315,1.0077546903680008,1.0210119519692284,29,55,15.352508544921875,10.570347785949707,35,9
1168,128,2.448563352402498,6.7748163409256055,1.0021341026304356,1.0331712034901426,70,117,16.181289672851562,10.570347785949707,58,11
1169,1,10.051177855646005,10.051177855646007,0.9396108578873965,0.9396108578873983,0,0,10.211506843566895,10.211506843566895,1,1
1169,2,8.965328094110179,8.96532809411018,0.9662729722851711,0.9662729722851728,0,0,10.30163860321045,10.211506843566895,2,2
1169,3,8.018010246393896,8.018010246393898,0.9876503704274063,0.9876503704274087,0,0,10.858549118041992,10.211506843566895,3,3
1169,4,7.395401884127894,7.395401884127895,1.001770981304523,1.0017709813045244,0,0,10.878056526184082,10.211506843566895,4,4
1169,8,6.581191187659025,6.618389831857095,1.0150459369710811,1.0157747922054754,1,1,11.151695251464844,10.211506843566895,7,7
1169,16,6.226825690438334,6.4703322021251575,1.0210066690224893,1.0216089821964658,4,7,11.901124000549316,10.211506843566895,12,9
1169,32,5.517460154984789,6.3893375403787624,1.0222271557633926,1.026972675948242,12,22,13.078676223754883,10.211506843566895,20,10
1169,64,3.9973440704623533,6.148922530437639,1.012246689609144,1.03974202417942,35,51,13.719815254211426,10.211506843566895,29,13
1169,128,2.726970353298481,6.105743071786417,1.0018461085697679,1.0439774287306567,67,112,14.5932035446167,10.211506843566895,61,16
1170,1,6.562419752367288,6.562419752367289,0.9718905417090475,0.9718905417090501,0,0,6.617438793182373,6.617438793182373,1,1
1170,2,5.226922029689147,5.226922029689149,0.9901355354758192,0.9901355354758213,0,0,7.002513885498047,6.617438793182373,2,2
1170,3,5.057779378066157,5.057779378066157,0.9930402969018939,0.9930402969018951,0,0,7.317810535430908,6.617438793182373,3,3
1170,4,4.714010367118011,4.714010367118011,0.9992434933764545,0.9992434933764553,0,0,7.525195598602295,6.617438793182373,4,4
1170,8,3.8858399538578485,4.099390795907863,1.008646546605403,1.0082269996917472,3,3,8.1951904296875,6.617438793182373,5,5
1170,16,3.7476767622401534,4.097710543358195,1.008060257565125,1.008236006878809,8,10,8.869272232055664,6.617438793182373,8,6
1170,32,3.2922616825195083,4.092255897811309,1.003600257919532,1.0090790818888489,17,22,9.329181671142578,6.617438793182373,15,10
1170,64,2.2728161091057957,4.083547640831143,0.9982469911489771,1.0096653407112455,33,53,10.016582489013672,6.617438793182373,31,11
1170,128,1.4499810778672595,4.059215828553547,0.9976651296788764,1.010786884210355,60,118,10.66329288482666,6.617438793182373,68,10
1171,1,9.471813019185493,9.471813019185495,0.9524368449574194,0.9524368449574224,0,0,9.576498985290527,9.576498985290527,1,1
1171,2,8.488159883582654,8.488159883582655,0.9737746678540902,0.9737746678540924,0,0,9.699466705322266,9.576498985290527,2,2
1171,3,8.409434217687341,8.409434217687343,0.9777549069814063,0.9777549069814081,0,0,11.012120246887207,9.576498985290527,3,3
1171,4,7.767815202488726,7.767815202488726,0.9946874251921853,0.9946874251921869,0,0,11.08674430847168,9.576498985290527,4,4
1171,8,6.988966393154007,7.009698165420696,1.0096147623645184,1.0101734013306165,2,2,11.47519302368164,9.576498985290527,6,6
1171,16,6.020480381646224,6.339533181804536,1.0285016351121459,1.0275816572148326,4,9,12.086623191833496,9.576498985290527,12,7
1171,32,5.055748240835476,5.964543031853455,1.027145560190117,1.0393477421456678,14,21,12.940123558044434,9.576498985290527,18,11
1171,64,3.9000530926434207,5.692356622481784,1.0195625674931743,1.0497876042518,31,51,13.949249267578125,9.576498985290527,33,13
1171,128,2.278368226485707,5.675738462394463,1.0052535409268497,1.0531319135724433,64,106,14.97162914276123,9.576498985290527,64,22
1172,1,11.43878566981461,11.438785669814614,0.9295957299494444,0.9295957299494457,0,0,11.632987976074219,11.632987976074219,1,1
1172,2,10.373515370213502,10.373515370213505,0.956637326827787,0.9566373268277881,0,0,11.635120391845703,11.632987976074219,2,2
1172,3,8.11426458798671,8.11426458798671,1.0039786676699647,1.0039786676699665,0,0,11.730247497558594,11.632987976074219,3,3
1172,4,8.107090013835016,8.107090013835014,1.0039910943646062,1.0039910943646049,0,0,11.759570121765137,11.632987976074219,4,4
1172,8,7.468456032375947,7.468456032375947,1.013840200011653,1.0138402000116535,0,0,12.106977462768555,11.632987976074219,8,8
1172,16,6.986538046054634,7.181744873515584,1.0256020261917342,1.0249522692731448,4,5,12.723362922668457,11.632987976074219,12,11
1172,32,6.525318394873995,6.9731365616651955,1.0290636975803484,1.0312704091735645,13,17,13.161603927612305,11.632987976074219,19,15
1172,64,5.581858489799812,6.868045978089524,1.0209479741706389,1.0389681318943627,33,46,13.571117401123047,11.632987976074219,31,18
1172,128,3.9345748250644825,6.62707759245272,1.0143416845796909,1.0515403683610032,68,105,13.979759216308594,11.632987976074219,60,23
1173,1,7.807018961034656,7.807018961034656,0.9687456354096137,0.9687456354096153,0,0,7.863282203674316,7.863282203674316,1,1
1173,2,6.623163502604308,6.623163502604307,0.9887449093172609,0.9887449093172611,0,0,7.992029190063477,7.863282203674316,2,2
1173,3,6.4558851131822825,6.4558851131822825,0.9920319152381678,0.9920319152381682,0,0,9.106575965881348,7.863282203674316,3,3
1173,4,6.213431097721298,6.213431097721298,0.994422256840732,0.9944222568407315,0,0,9.133077621459961,7.863282203674316,4,4
1173,8,5.965034077978123,5.978896768312311,0.9975517387403421,0.9984252230562218,2,2,9.468513488769531,7.863282203674316,6,6
1173,16,5.052371692366917,5.424046381998042,1.0135644780494713,1.0145585795782104,6,8,9.989096641540527,7.863282203674316,10,8
1173,32,3.8904611281823596,4.832783948620644,1.0216970667631617,1.0270883104867337,13,20,10.378830909729004,7.863282203674316,19,12
1173,64,2.948224953423775,4.745498821828312,1.0141369117038064,1.02973425823801,31,46,10.838289260864258,7.863282203674316,33,18
1173,128,1.1950769381434918,4.723669173762883,0.9980278299045251,1.031364053473379,59,111,11.671282768249512,7.863282203674316,69,17
1174,1,11.008738521197708,11.00873852119771,0.9167281729929796,0.9167281729929805,0,0,11.287412643432617,11.287412643432617,1,1
1174,2,9.2179171689266,9.217917168926599,0.9683541159596991,0.968354115959699,0,0,11.399153709411621,11.287412643432617,2,2
1174,3,8.71733355676744,8.71733355676744,0.9783448318691799,0.9783448318691801,0,0,11.683764457702637,11.287412643432617,3,3
1174,4,8.420090260206674,8.420090260206674,0.9872656078525253,0.987265607852525,0,0,11.868916511535645,11.287412643432617,4,4
1174,8,7.790850884827685,7.998774478929531,1.0071681697042842,1.002834968889257,1,1,12.298630714416504,11.287412643432617,7,7
1174,16,7.484053398141172,7.909850263402906,1.011706756494631,1.0075642974367598,3,7,12.849934577941895,11.287412643432617,13,9
1174,32,6.102125265826423,7.674350055553945,1.0176051594675095,1.020673987801888,13,19,13.771665573120117,11.287412643432617,19,13
1174,64,4.339780075949939,7.347930702884229,1.0151277489641546,1.0381113390273105,33,47,14.443897247314453,11.287412643432617,31,17
1174,128,3.092981882071501,6.874425424536844,1.0089976147139745,1.0564480700482886,61,109,15.06895637512207,11.287412643432617,67,19
1175,1,6.422008766982976,6.422008766982978,0.975098392836294,0.9750983928362957,0,0,6.465975761413574,6.465975761413574,1,1
1175,2,5.29159729920221,5.291597299202211,0.9905317774945008,0.9905317774945017,0,0,6.6187744140625,6.465975761413574,2,2
1175,3,4.29050210366449,4.29050210366449,1.0016854549878285,1.0016854549878293,0,0,6.686960697174072,6.465975761413574,3,3
1175,4,4.259068206709062,4.259068206709062,1.0020921336242923,1.0020921336242938,0,0,6.840323448181152,6.465975761413574,4,4
1175,8,3.7527926548522577,3.941275989633696,1.0072092492646036,1.0061318739053278,3,3,7.0546040534973145,6.465975761413574,5,5
1175,16,3.015265947235287,3.3582200414982792,1.0137554782078482,1.0133683119746684,4,7,7.550379276275635,6.465975761413574,12,9
1175,32,2.5660487912008882,3.0481900925971464,1.0117120578037504,1.0189316176888852,13,19,8.245014190673828,6.465975761413574,19,13
1175,64,1.8170146838172363,3.023751029458951,1.0069048267643088,1.0190534652174892,28,50,8.975041389465332,6.465975761413574,36,14
1175,128,1.0095786373203548,3.023371845440183,1.0039889049878967,1.0191715697002026,64,113,9.888633728027344,6.465975761413574,64,15
1176,1,12.084335523329443,12.084335523329447,0.9107849083526142,0.9107849083526164,0,0,12.36841106414795,12.36841106414795,1,1
1176,2,10.691291101563476,10.691291101563476,0.9616152573434678,0.9616152573434692,0,0,14.696653366088867,12.36841106414795,2,2
1176,3,10.40081646343762,10.400816463437621,0.9756209661929711,0.9756209661929717,0,0,15.363266944885254,12.36841106414795,3,3
1176,4,9.631616494258568,9.631616494258568,0.994567463029387,0.9945674630293886,0,0,15.365608215332031,12.36841106414795,4,4
1176,8,9.43367279203686,9.510755471416454,1.001275663448816,1.0021971876690396,2,2,16.108970642089844,12.36841106414795,6,6
1176,16,9.051178986768479,9.37186842248485,1.0028443723544909,1.011050909295903,7,7,16.431127548217773,12.36841106414795,9,9
1176,32,7.4882561311494245,9.188315090419685,1.0198234898733416,1.0231982807451518,14,20,17.272769927978516,12.36841106414795,18,12
1176,64,5.977579573905743,9.10232969923723,1.0095211976676324,1.0327330883841115,34,49,18.070894241333008,12.36841106414795,30,15
1176,128,3.665033377554951,9.018569108419252,1.0096206486092651,1.0386425046548424,58,109,18.67418098449707,12.36841106414795,70,19
1177,1,10.119531636303932,10.119531636303934,0.9369455251996196,0.936945525199621,0,0,10.294849395751953,10.294849395751953,1,1
1177,2,6.837019637749841,6.83701963774984,1.006602174759022,1.006602174759024,0,0,10.302650451660156,10.294849395751953,2,2
1177,3,6.431249876934417,6.431249876934419,1.0122763308576113,1.0122763308576106,0,0,10.68044662475586,10.294849395751953,3,3
1177,4,6.410189728728763,6.4101897287287635,1.0134989240892995,1.0134989240892986,0,0,10.811087608337402,10.294849395751953,4,4
1177,8,5.921374471835093,5.921650340513549,1.0255705648188393,1.0256627054190577,1,1,11.196810722351074,10.294849395751953,7,7
1177,16,4.993480358441121,5.446070704540027,1.0350417829080518,1.0368775349661044,6,7,11.524964332580566,10.294849395751953,10,9
1177,32,4.559448457439743,5.340975149509594,1.0361836392820445,1.040106326666268,16,22,12.098934173583984,10.294849395751953,16,10
1177,64,3.831511977773079,5.278046149837479,1.0220246831280915,1.0441287279269749,35,51,12.657020568847656,10.294849395751953,29,13
1177,128,2.376394407163302,5.258622476407706,1.0075697511705277,1.0471041686202875,58,109,13.360249519348145,10.294849395751953,70,19
1178,1,9.078570773172526,9.078570773172524,0.9597156112548313,0.9597156112548335,0,0,9.156001091003418,9.156001091003418,1,1
1178,2,8.429771849818943,8.429771849818941,0.9693468284373579,0.9693468284373581,0,0,9.36259937286377,9.156001091003418,2,2
1178,3,6.822810493691626,6.822810493691626,0.9947445417440546,0.9947445417440548,0,0,9.48893928527832,9.156001091003418,3,3
1178,4,6.792029449120959,6.79202944912096,0.9955108740490353,0.995510874049035,0,0,9.530548095703125,9.156001091003418,4,4
1178,8,6.092109926263669,6.128495558546425,1.0102281926158998,1.009581297821222,1,1,10.051193237304688,9.156001091003418,7,7
1178,16,5.504202550397964,5.7066365339398075,1.024667007824489,1.020662708128305,5,7,10.560593605041504,9.156001091003418,11,9
1178,32,4.430345278157239,5.289755035332793,1.0308686037971153,1.0319262562522602,12,18,11.203656196594238,9.156001091003418,20,14
1178,64,3.471765238983544,5.0658556961476755,1.0202339264181466,1.0390413462698336,32,46,11.87924575805664,9.156001091003418,32,18
1178,128,2.249825742635469,5.032832238127153,1.0055165686740084,1.041640992635624,61,106,12.735276222229004,9.156001091003418,67,22
1179,1,8.852909232250305,8.852909232250301,0.9493530781250386,0.949353078125042,0,0,8.977849006652832,8.977849006652832,1,1
1179,2,8.73160815042511,8.731608150425114,0.9565482204345326,0.9565482204345348,0,0,11.115007400512695,8.977849006652832,2,2
1179,3,8.702793315282305,8.70279331528231,0.9595125503243119,0.9595125503243138,0,0,11.297218322753906,8.977849006652832,3,3
1179,4,8.545487383955727,8.545487383955727,0.9661867348712259,0.9661867348712283,0,0,11.599176406860352,8.977849006652832,4,4
1179,8,8.133928173244474,8.256988906360933,0.9771349843183349,0.9778898198951284,2,3,12.460988998413086,8.977849006652832,6,5
1179,16,6.31266586399307,7.839414631549294,0.9966243950336492,0.9942786048076785,4,8,12.942617416381836,8.977849006652832,12,8
1179,32,5.470845776116855,7.496979495035922,0.9987754837687656,1.0049270923103355,14,23,13.523911476135254,8.977849006652832,18,9
1179,64,3.670149560843336,6.852580337129989,1.007145963917182,1.0255329619314544,32,55,14.31832504272461,8.977849006652832,32,9
1179,128,2.4981054855290976,6.827168516323164,1.0050310024668714,1.0285293721645004,62,115,15.253437995910645,8.977849006652832,66,13
1180,1,7.907563415448951,7.907563415448922,0.9675197841645359,0.9675197841645384,0,0,7.967299461364746,7.967299461364746,1,1
1180,2,6.927571767088058,6.927571767088059,0.9879327391701764,0.9879327391701778,0,0,8.74012565612793,7.967299461364746,2,2
1180,3,6.464261940651357,6.464261940651358,0.9925561781817999,0.9925561781818023,0,0,8.904044151306152,7.967299461364746,3,3
1180,4,6.2144006907291995,6.2144006907292,0.9987498319864574,0.9987498319864598,0,0,9.040811538696289,7.967299461364746,4,4
1180,8,5.5514442712089105,5.608147989887668,1.0113317523883198,1.0108119047838273,2,2,9.54433536529541,7.967299461364746,6,6
1180,16,4.703998478786921,5.389909129485844,1.0240251289379012,1.0191072784574857,5,6,10.155386924743652,7.967299461364746,11,10
1180,32,3.9718069020260898,5.015846387444837,1.0272448998910648,1.0264996326385059,14,23,10.67505168914795,7.967299461364746,18,9
1180,64,3.1134103926836394,4.924214518553455,1.0108142237436195,1.0303856402354503,26,53,11.458641052246094,7.967299461364746,38,11
1180,128,1.7700293065644643,4.883390141436073,1.001151730212059,1.0328196922987785,65,115,12.31588077545166,7.967299461364746,63,13
1181,1,8.87842864981873,8.87842864981873,0.96335980106469,0.9633598010646903,0,0,8.946877479553223,8.946877479553223,1,1
1181,2,7.968228826697616,7.968228826697615,0.9850910833706178,0.9850910833706169,0,0,9.847368240356445,8.946877479553223,2,2
1181,3,6.825008421839853,6.825008421839853,1.0056135723735424,1.0056135723735418,0,0,10.179704666137695,8.946877479553223,3,3
1181,4,6.663668160439726,6.663668160439726,1.0090727076086827,1.0090727076086827,0,0,10.588457107543945,8.946877479553223,4,4
1181,8,6.480665775927441,6.480665775927442,1.0169871078768764,1.016987107876874,0,0,11.68934440612793,8.946877479553223,8,8
1181,16,5.43678356400074,5.624384136717402,1.0334794266544833,1.0357765088759696,6,7,12.286018371582031,8.946877479553223,10,9
1181,32,5.041190942519124,5.521489954475039,1.030886294786189,1.0390616478572832,13,18,12.890924453735352,8.946877479553223,19,14
1181,64,3.7736942600864674,5.466610671174482,1.0171469733955711,1.0403093909370495,33,51,13.48853874206543,8.946877479553223,31,13
1181,128,2.3015981114625315,5.423484964241164,1.0018581113270588,1.044061986182605,64,112,14.135133743286133,8.946877479553223,64,16
1182,1,8.421617073626546,8.421617073626546,0.9620661970984721,0.9620661970984737,0,0,8.499140739440918,8.499140739440918,1,1
1182,2,6.947883967485853,6.947883967485854,0.9867174401333869,0.9867174401333867,0,0,8.876514434814453,8.499140739440918,2,2
1182,3,6.568931095006257,6.568931095006256,0.9923000912278069,0.992300091227807,0,0,8.922215461730957,8.499140739440918,3,3
1182,4,6.528537320888265,6.528537320888265,0.9932425925951593,0.9932425925951598,0,0,9.091337203979492,8.499140739440918,4,4
1182,8,6.0107451200170905,6.0107451200170905,1.0019960703231212,1.0019960703231217,0,0,9.353626251220703,8.499140739440918,8,8
1182,16,5.862746165217703,5.988615085196791,1.003612651524628,1.0030538507047608,5,5,9.693493843078613,8.499140739440918,11,11
1182,32,4.671465292550323,5.598580362279148,1.0075609928910263,1.0099890298026897,15,23,10.152231216430664,8.499140739440918,17,9
1182,64,3.4199939695137465,5.551001996545258,1.001698270611908,1.0122985554333832,29,52,10.630721092224121,8.499140739440918,35,12
1182,128,1.6376984983464882,5.306095902770374,0.999873466266286,1.021709818723246,60,115,11.141447067260742,8.499140739440918,68,13
1183,1,8.489338832328992,8.489338832328993,0.9554473236470848,0.9554473236470863,0,0,8.595548629760742,8.595548629760742,1,1
1183,2,7.0403952409688415,7.0403952409688415,0.9810299970579843,0.9810299970579852,0,0,8.609376907348633,8.595548629760742,2,2
1183,3,6.779111280693103,6.779111280693103,0.985700302052929,0.9857003020529294,0,0,8.698022842407227,8.595548629760742,3,3
1183,4,6.594268618063669,6.594268618063668,0.9899323480761626,0.989932348076162,0,0,9.397928237915039,8.595548629760742,4,4
1183,8,6.431155932863198,6.431155932863197,0.9959824493398745,0.9959824493398728,0,0,9.610107421875,8.595548629760742,8,8
1183,16,5.335676482725762,5.5176477529598085,1.0183112971703003,1.0168436388478141,6,8,10.240446090698242,8.595548629760742,10,8
1183,32,4.499147635402428,5.396894004136432,1.016933660692582,1.0200131171696913,12,22,10.816665649414062,8.595548629760742,20,10
1183,64,3.3314898547308407,5.326379049811712,1.0102051464578587,1.0239166218929814,31,51,11.351675987243652,8.595548629760742,33,13
1183,128,1.899945484246272,5.243854430205196,0.9998953968366626,1.0246193183057182,60,113,11.951525688171387,8.595548629760742,68,15
1184,1,6.526182139415044,6.526182139415046,0.9755757566966806,0.9755757566966821,0,0,6.567645072937012,6.567645072937012,1,1
1184,2,5.037352016641008,5.037352016641007,0.9954766487034505,0.9954766487034516,0,0,6.754754066467285,6.567645072937012,2,2
1184,3,4.994471244524474,4.994471244524475,0.9965734358318017,0.9965734358318019,0,0,7.016602516174316,6.567645072937012,3,3
1184,4,4.984609874964106,4.994471244524474,0.996554948816087,0.9965734358318019,1,1,7.0334272384643555,6.567645072937012,3,3
1184,8,4.736871282257857,4.822994701928631,0.9997953106846598,0.9987544249321038,2,2,7.347223281860352,6.567645072937012,6,6
1184,16,3.821203653367188,4.23690035604097,1.0096536114360455,1.0076208214000497,7,7,7.928296089172363,6.567645072937012,9,9
1184,32,3.309209795565049,4.0056981097337445,1.0118306120555365,1.011657909161464,13,20,8.46675968170166,6.567645072937012,19,12
1184,64,2.488958010688579,3.9294874672589364,1.006400378365515,1.0151677248385216,28,50,9.205439567565918,6.567645072937012,36,14
1184,128,1.298867587071348,3.8739274063199756,1.0000705850957818,1.0183997377135428,62,110,9.897751808166504,6.567645072937012,66,18
1185,1,4.44273009104729,4.442730091047287,0.9878464951755838,0.9878464951755845,0,0,4.458540916442871,4.458540916442871,1,1
1185,2,4.032908308107339,4.032908308107339,0.9913853653489546,0.9913853653489572,0,0,4.470284461975098,4.458540916442871,2,2
1185,3,3.9629768572272277,3.962976857227228,0.9904658800886013,0.990465880088602,0,0,5.009588718414307,4.458540916442871,3,3
1185,4,3.765959226848913,3.765959226848913,0.9919200394846632,0.9919200394846635,0,0,5.0427751541137695,4.458540916442871,4,4
1185,8,3.551142131485461,3.556691361534472,0.9960015118798267,0.9959836154736593,2,2,5.317246437072754,4.458540916442871,6,6
1185,16,2.640942044924446,3.0612810995982622,1.003319007456652,1.002218819308261,5,11,5.647508144378662,4.458540916442871,11,5
1185,32,1.9646300079371637,2.725841119475874,1.0035471878210647,1.0040906875164606,16,24,6.14854621887207,4.458540916442871,16,8
1185,64,1.1362966595268618,2.670522828945103,1.0024444421995955,1.0051548565269446,29,55,6.545534610748291,4.458540916442871,35,9
1185,128,0.3647445587984471,2.592448921373255,0.9999215616057513,1.0067607293996548,61,117,7.188237190246582,4.458540916442871,67,11
1186,1,9.458426250314492,9.458426250314494,0.9431159955798598,0.9431159955798605,0,0,9.615323066711426,9.615323066711426,1,1
1186,2,8.621294844133308,8.621294844133308,0.9660535820804628,0.9660535820804628,0,0,10.046876907348633,9.615323066711426,2,2
1186,3,7.312605537837546,7.312605537837546,0.9939782681017806,0.9939782681017797,0,0,10.181400299072266,9.615323066711426,3,3
1186,4,7.159285506967495,7.159285506967496,0.9972861238848626,0.9972861238848615,0,0,10.43874454498291,9.615323066711426,4,4
1186,8,6.740668554960545,6.809997205544628,1.0068423494657095,1.0060453906516007,1,1,11.067338943481445,9.615323066711426,7,7
1186,16,5.947658578353924,6.219605127086807,1.0210409970608456,1.0233823869737295,6,4,11.836278915405273,9.615323066711426,10,12
1186,32,4.223304831708868,6.176777996129247,1.0205808636742797,1.0266423716152913,13,20,12.973654747009277,9.615323066711426,19,12
1186,64,3.392230511703144,6.011375994711303,1.0101934575683953,1.0339654340584232,32,52,13.626359939575195,9.615323066711426,32,12
1186,128,2.0551951891115023,5.95709327799137,1.003380899651769,1.039628489681299,64,115,14.585426330566406,9.615323066711426,64,13
1187,1,10.57593559161585,10.575935591615853,0.9338367626362757,0.9338367626362769,0,0,10.760318756103516,10.760318756103516,1,1
1187,2,9.825303750259419,9.82530375025942,0.9606417386065855,0.9606417386065865,0,0,12.433283805847168,10.760318756103516,2,2
1187,3,9.065310588250538,9.065310588250538,0.9822429223348996,0.9822429223348998,0,0,12.64523983001709,10.760318756103516,3,3
1187,4,8.87587121793808,8.875871217938077,0.9906270869482559,0.9906270869482556,0,0,12.687909126281738,10.760318756103516,4,4
1187,8,7.871597448711005,8.038740276113797,1.0137030463836687,1.0154910890472326,3,3,13.048233032226562,10.760318756103516,5,5
1187,16,6.601654696827793,7.253049957799922,1.0382302474457077,1.0366343777928984,6,6,13.359620094299316,10.760318756103516,10,10
1187,32,6.037626084857981,6.846943999596131,1.0427822976493786,1.0484178720426935,14,22,13.818526268005371,10.760318756103516,18,10
1187,64,4.800596978292815,6.7653925598549725,1.0356485808692706,1.0556296510175545,32,50,14.461687088012695,10.760318756103516,32,14
1187,128,2.956589720247827,6.725309908035013,1.0101543015664447,1.0589583339452777,61,111,15.373397827148438,10.760318756103516,67,17
1188,1,5.137486787233156,5.137486787233158,0.9884511367624682,0.9884511367624689,0,0,5.149570941925049,5.149570941925049,1,1
1188,2,4.3276115443690015,4.3276115443690015,0.9964333714964858,0.9964333714964865,0,0,5.4419965744018555,5.149570941925049,2,2
1188,3,3.7165106865486432,3.7165106865486432,1.0021286326414778,1.0021286326414778,0,0,5.958364486694336,5.149570941925049,3,3
1188,4,3.6823724734386367,3.6823724734386367,1.0027294827698172,1.0027294827698177,0,0,6.236034393310547,5.149570941925049,4,4
1188,8,3.4866209525979506,3.4879285952192656,1.006864826830089,1.0068297214602013,2,2,6.386072635650635,5.149570941925049,6,6
1188,16,2.9950106859232877,3.1025925145879385,1.0122641834155175,1.0124454438002037,6,8,6.895621299743652,5.149570941925049,10,8
1188,32,2.498904149597722,3.0861658955734845,1.0047336257405874,1.0128413373830225,16,23,7.778395175933838,5.149570941925049,16,9
1188,64,1.5320300375098288,2.9596675932053254,1.0021176230258513,1.0179060550307941,29,51,8.546714782714844,5.149570941925049,35,13
1188,128,0.779031822126444,2.9596675932053254,0.9986725181412679,1.0179060550307941,68,115,9.652105331420898,5.149570941925049,60,13
1189,1,8.485856273008189,8.485856273008189,0.9476374410372721,0.9476374410372731,0,0,8.629796981811523,8.629796981811523,1,1
1189,2,6.248392635193828,6.248392635193827,0.9913011671031204,0.9913011671031212,0,0,8.977124214172363,8.629796981811523,2,2
1189,3,5.25967282005306,5.25967282005306,1.0093922534005777,1.0093922534005775,0,0,9.249343872070312,8.629796981811523,3,3
1189,4,5.259410167809338,5.25967282005306,1.0093007030853427,1.0093922534005775,1,1,9.63274097442627,8.629796981811523,3,3
1189,8,4.83906930852476,4.843815170890867,1.0177875668468517,1.018196195683609,2,2,10.177481651306152,8.629796981811523,6,6
1189,16,4.578276709566018,4.622254221716007,1.0220040145636036,1.0231143457188767,4,4,10.618627548217773,8.629796981811523,12,12
1189,32,3.986772061947193,4.546924665582599,1.022096544152849,1.0241719044873923,13,18,11.15281867980957,8.629796981811523,19,14
1189,64,3.1509557864013598,4.527923775401488,1.0147487337060797,1.025645975727755,31,50,11.891276359558105,8.629796981811523,33,14
1189,128,2.1895147866517486,4.474044470675604,1.0081429423142123,1.0299064356045207,61,112,12.615995407104492,8.629796981811523,67,16
1190,1,8.02539967825226,8.025399678252262,0.9608997287752876,0.9608997287752888,0,0,8.107693672180176,8.107693672180176,1,1
1190,2,6.364630557332939,6.36463055733294,0.9911578905193076,0.9911578905193077,0,0,8.42465591430664,8.107693672180176,2,2
1190,3,6.219494350111933,6.219494350111933,0.9941267421909853,0.994126742190985,0,0,8.563596725463867,8.107693672180176,3,3
1190,4,5.74690283706387,5.746902837063869,1.0042076526130486,1.0042076526130486,0,0,8.62793254852295,8.107693672180176,4,4
1190,8,5.092617219859844,5.096312860850853,1.0133343330692717,1.0132678817278482,1,1,9.310091018676758,8.107693672180176,7,7
1190,16,4.992839366067988,5.044172854607585,1.0134847167482548,1.015723583876448,5,6,9.934864044189453,8.107693672180176,11,10
1190,32,3.9893007035885217,4.8933248876150754,1.0127627711712506,1.0222296407558602,16,21,10.98139762878418,8.107693672180176,16,11
1190,64,3.0839117510914877,4.738418853129369,1.0096349765913886,1.0301889790849381,29,47,11.939303398132324,8.107693672180176,35,17
1190,128,1.9498911540450727,4.612649283999377,1.0012409090193493,1.0367420962500906,65,110,12.958944320678711,8.107693672180176,63,18
1191,1,10.693256710050104,10.693256710050102,0.9375932650784181,0.9375932650784192,0,0,10.85017204284668,10.85017204284668,1,1
1191,2,8.908014439829111,8.908014439829113,0.9807468276034073,0.9807468276034079,0,0,12.602176666259766,10.85017204284668,2,2
1191,3,8.428555865173747,8.428555865173749,0.9900552913907741,0.9900552913907752,0,0,12.643280029296875,10.85017204284668,3,3
1191,4,8.27009852113142,8.27009852113142,0.9962333642676104,0.996233364267612,0,0,12.719284057617188,10.85017204284668,4,4
1191,8,7.691453881849393,7.691473359763368,1.0123548691296058,1.0123718369820123,2,2,12.94136905670166,10.85017204284668,6,6
1191,16,7.08859514016342,7.265098101922562,1.027907341215421,1.0271885261891063,5,5,13.368372917175293,10.85017204284668,11,11
1191,32,6.149758445063948,7.148147815729679,1.0209429561195784,1.0292907302911978,14,18,13.713204383850098,10.85017204284668,18,14
1191,64,4.950273054718028,7.0392653940022285,1.0226939528483454,1.0347702564413352,31,45,14.13270378112793,10.85017204284668,33,19
1191,128,3.418663714331941,6.896171008304053,1.0089908893874426,1.0433405373022013,65,107,14.513266563415527,10.85017204284668,63,21
1192,1,5.534890758583076,5.534890758583077,0.9809270047287845,0.9809270047287866,0,0,5.564709186553955,5.564709186553955,1,1
1192,2,4.581697328390834,4.581697328390835,0.9935388844625139,0.993538884462515,0,0,5.633073806762695,5.564709186553955,2,2
1192,3,4.453016843169048,4.453016843169048,0.9948375711945301,0.994837571194532,0,0,5.82883358001709,5.564709186553955,3,3
1192,4,4.411187004958005,4.453016843169048,0.9943881114735634,0.994837571194532,1,1,6.589909553527832,5.564709186553955,3,3
1192,8,3.9688154357056797,4.194272828331981,1.000400317206214,0.9996692037760089,2,1,7.144026279449463,5.564709186553955,6,7
1192,16,3.4585821346576067,4.037090354085982,0.9991940350941646,1.0043907849108575,7,8,8.061737060546875,5.564709186553955,9,8
1192,32,2.7649617283573242,3.8852480646987915,0.9963091339575465,1.007800806648288,15,22,8.537952423095703,5.564709186553955,17,10
1192,64,1.9289506593962424,3.818294065890331,1.0012696711622227,1.00989071834554,31,50,9.143512725830078,5.564709186553955,33,14
1192,128,1.1217796908424573,3.7796644465697273,0.9994652637935848,1.0132450240701345,64,113,9.829376220703125,5.564709186553955,64,15
1193,1,6.909802540077202,6.9098025400772025,0.971503884964876,0.9715038849648775,0,0,6.963891983032227,6.963891983032227,1,1
1193,2,5.495208096790671,5.495208096790671,0.9950179998677869,0.9950179998677877,0,0,7.0073957443237305,6.963891983032227,2,2
1193,3,4.785814954605908,4.785814954605909,1.004607978167806,1.0046079781678068,0,0,7.2774457931518555,6.963891983032227,3,3
1193,4,4.772329343590282,4.772329343590281,1.0046618419801137,1.0046618419801143,0,0,7.4283366203308105,6.963891983032227,4,4
1193,8,3.8121008496750703,3.8632618529748197,1.015307949562771,1.0149208449617952,2,2,7.619185447692871,6.963891983032227,6,6
1193,16,3.7102604934688252,3.788362502922364,1.016915009255389,1.0164247526112042,3,4,8.135828018188477,6.963891983032227,13,12
1193,32,3.082235339365918,3.5817284997737318,1.0179990093220752,1.0211564669539954,9,17,8.643600463867188,6.963891983032227,23,15
1193,64,2.336533605977153,3.51522117377581,1.0073080148378106,1.0241665215158864,26,46,9.380022048950195,6.963891983032227,38,18
1193,128,1.2988313570115895,3.5072452537443497,1.0014607773689064,1.025244070821882,60,109,10.289979934692383,6.963891983032227,68,19
1194,1,13.997832805351752,13.997832805351756,0.8627863095819052,0.8627863095819069,0,0,14.591211318969727,14.591211318969727,1,1
1194,2,10.797607222793095,10.797607222793097,0.9721305355684043,0.9721305355684056,0,0,14.597151756286621,14.591211318969727,2,2
1194,3,10.350721426682654,10.350721426682654,0.9838829524043022,0.9838829524043031,0,0,14.833542823791504,14.591211318969727,3,3
1194,4,10.350395220689379,10.350395220689379,0.9839085839548816,0.9839085839548819,0,0,14.873739242553711,14.591211318969727,4,4
1194,8,9.426754358732246,9.582008169398561,1.0113184116678535,1.007583686000393,1,2,15.042438507080078,14.591211318969727,7,6
1194,16,9.049176106762959,9.326021398953623,1.0167690427313534,1.0131391876222096,4,5,15.312049865722656,14.591211318969727,12,11
1194,32,7.984169513463685,9.087963191749877,1.02800026398542,1.02041217164071,14,18,15.694366455078125,14.591211318969727,18,14
1194,64,6.6845725466893935,8.845431130068947,1.0349555721773744,1.0323999069009895,30,49,16.027259826660156,14.591211318969727,34,15
1194,128,4.608703025724973,8.740803233366282,1.0300769832524073,1.0395594220751092,59,110,16.41253089904785,14.591211318969727,69,18
1195,1,3.3982671185048043,3.3982671185048052,0.9941353867850132,0.9941353867850137,0,0,3.40305233001709,3.40305233001709,1,1
1195,2,3.0565360567334436,3.056536056733444,0.9957112227088216,0.9957112227088221,0,0,3.4626522064208984,3.40305233001709,2,2
1195,3,2.248024769181585,2.248024769181585,1.001884690380582,1.0018846903805825,0,0,3.643700122833252,3.40305233001709,3,3
1195,4,2.1578156477086976,2.1578156477086967,1.0022943117392786,1.0022943117392784,0,0,3.7339837551116943,3.40305233001709,4,4
1195,8,1.9939862466576197,2.0081516498479224,1.003346258974296,1.0035872385273001,2,2,4.064672470092773,3.40305233001709,6,6
1195,16,1.7955026249540336,1.9249835341611927,1.0047418992950918,1.004811928422905,8,6,4.348104476928711,3.40305233001709,8,10
1195,32,1.443947153787619,1.6801154787127586,1.006660701031279,1.0072640674668198,14,17,4.7272210121154785,3.40305233001709,18,15
1195,64,1.0117445409282455,1.651725844118395,1.0025579066240777,1.0079803524267976,32,48,5.263123512268066,3.40305233001709,32,16
1195,128,0.25377638392294144,1.6028612968804261,1.0000737928331038,1.0088163755407789,59,112,5.837981700897217,3.40305233001709,69,16
1196,1,7.043980505596454,7.043980505596455,0.9793003554716452,0.9793003554716484,0,0,7.071329593658447,7.071329593658447,1,1
1196,2,6.7482883738132635,6.748288373813264,0.9845557403684346,0.9845557403684367,0,0,7.4100565910339355,7.071329593658447,2,2
1196,3,5.972877132386816,5.972877132386815,0.9942630889890016,0.9942630889890022,0,0,7.441309928894043,7.071329593658447,3,3
1196,4,5.925462949278229,5.972877132386815,0.994572791525274,0.9942630889890022,1,1,7.85617208480835,7.071329593658447,3,3
1196,8,4.792913032431121,5.05324598850514,1.0022555680557415,1.0067314860766032,3,3,8.97674560546875,7.071329593658447,5,5
1196,16,3.8450199369729896,4.315645787038704,1.015620261782674,1.0224391491821527,6,9,9.796146392822266,7.071329593658447,10,7
1196,32,3.4770844970703503,4.309049787725359,1.0109956660479638,1.022794782858801,12,24,10.487251281738281,7.071329593658447,20,8
1196,64,2.8754831197380817,4.2888476155372315,1.0052486223107437,1.0253039126894776,30,54,11.248186111450195,7.071329593658447,34,10
1196,128,1.967541777736602,4.2637808772191015,0.9960647960489298,1.0272448604615951,58,118,11.876376152038574,7.071329593658447,70,10
1197,1,9.080400346598308,9.080400346598315,0.9481476664745445,0.9481476664745465,0,0,9.212422370910645,9.212422370910645,1,1
1197,2,7.300580162375321,7.300580162375321,0.9839993868194649,0.9839993868194659,0,0,9.618391990661621,9.212422370910645,2,2
1197,3,7.0386567907141195,7.038656790714119,0.9871289119747472,0.9871289119747467,0,0,9.663021087646484,9.212422370910645,3,3
1197,4,6.2718213651222925,6.2718213651222925,0.9990507136500737,0.9990507136500744,0,0,9.732392311096191,9.212422370910645,4,4
1197,8,6.019293409668018,6.021552321584546,1.0026818934033375,1.0028207968623075,1,1,9.98993968963623,9.212422370910645,7,7
1197,16,5.5020262300347245,5.774096638074669,1.0103426881779394,1.0068778630483228,5,7,10.416428565979004,9.212422370910645,11,9
1197,32,4.606770636845555,5.6380422239637715,1.0208207079902474,1.011274576039281,11,22,10.946706771850586,9.212422370910645,21,10
1197,64,3.687936103164951,5.4358946334434775,1.015606189610528,1.0218212389355974,31,47,11.406342506408691,9.212422370910645,33,17
1197,128,1.9617654580307173,5.425722878802784,1.00471942981844,1.023216905557142,59,110,12.08633041381836,9.212422370910645,69,18
1198,1,9.473158213795609,9.47315821379561,0.9476099746876806,0.9476099746876813,0,0,9.599960327148438,9.599960327148438,1,1
1198,2,8.52981486321669,8.529814863216687,0.9710281416328856,0.9710281416328855,0,0,10.198561668395996,9.599960327148438,2,2
1198,3,7.5959959392278416,7.595995939227841,0.9928811927813177,0.992881192781317,0,0,10.209548950195312,9.599960327148438,3,3
1198,4,7.591777138764153,7.591777138764153,0.9931458434647408,0.9931458434647403,0,0,10.462693214416504,9.599960327148438,4,4
1198,8,7.11165826764909,7.267724577504903,1.0034285605428825,1.0015709253665874,3,3,10.593842506408691,9.599960327148438,5,5
1198,16,6.4627895570375635,6.842536604445633,1.016334303907194,1.0114993666604153,5,9,10.935080528259277,9.599960327148438,11,7
1198,32,5.712914128043644,6.49235362068014,1.0189413013947362,1.0193285933871628,12,21,11.370182991027832,9.599960327148438,20,11
1198,64,4.298218625922007,6.246568425478764,1.0088851425724086,1.0266044416455893,31,51,12.256674766540527,9.599960327148438,33,13
1198,128,2.7872547425139174,6.177507006645304,1.0002938696646644,1.0308432565715018,65,113,13.21054458618164,9.599960327148438,63,15
1199,1,12.223723570957752,12.223723570957754,0.9213939814670798,0.9213939814670817,0,0,12.44581413269043,12.44581413269043,1,1
1199,2,10.963717724119867,10.963717724119865,0.9567750596355171,0.9567750596355182,0,0,12.957794189453125,12.44581413269043,2,2
1199,3,9.890952006222575,9.890952006222575,0.9887754222696286,0.9887754222696294,0,0,13.531152725219727,12.44581413269043,3,3
1199,4,9.429542856339634,9.429542856339634,1.0023096842790908,1.0023096842790917,0,0,13.68889045715332,12.44581413269043,4,4
1199,8,9.101703064499668,9.105726497424152,1.018998659095574,1.0192481730108518,1,1,14.648457527160645,12.44581413269043,7,7
1199,16,8.664778143093706,8.866739828693705,1.024190467606179,1.0254986951931524,7,8,14.94674015045166,12.44581413269043,9,8
1199,32,7.358926863355432,8.301598220075942,1.053927349027815,1.0496375990412994,13,16,15.408814430236816,12.44581413269043,19,16
1199,64,5.419113269161966,8.178214135448703,1.0442013992302641,1.0568749583323163,30,46,15.95983600616455,12.44581413269043,34,18
1199,128,3.9172647705908727,8.024225903879255,1.0264251827932211,1.0651745145305478,60,108,16.845502853393555,12.44581413269043,68,20
1200,1,10.526575274057759,10.526575274057759,0.935237799569403,0.9352377995694044,0,0,10.702282905578613,10.702282905578613,1,1
1200,2,8.188526519680023,8.188526519680023,0.9899683324101045,0.9899683324101058,0,0,10.871724128723145,10.702282905578613,2,2
1200,3,7.850248533403195,7.850248533403195,0.9929242129248461,0.9929242129248457,0,0,11.143506050109863,10.702282905578613,3,3
1200,4,7.778009654040782,7.850248533403195,0.9927457435494603,0.9929242129248457,1,1,11.298197746276855,10.702282905578613,3,3
1200,8,6.568646166627545,6.587193532610328,1.0221761565610397,1.0228702992489134,2,3,11.876747131347656,10.702282905578613,6,5
1200,16,5.837037847408927,6.0140340173855655,1.032284471513424,1.0351387163517494,6,6,12.506546020507812,10.702282905578613,10,10
1200,32,5.320338659995226,5.7126743254068435,1.0371471853695395,1.0434035586045356,14,20,12.830828666687012,10.702282905578613,18,12
1200,64,4.139806965036275,5.660934475792055,1.0258439849956011,1.0465849013791546,34,50,13.386550903320312,10.702282905578613,30,14
1200,128,2.981165652576673,5.639185846650393,1.0118425098008816,1.0482985104710236,60,111,13.98095417022705,10.702282905578613,68,17
1201,1,8.606503119666112,8.606503119666113,0.9621218140495973,0.9621218140495991,0,0,8.681602478027344,8.681602478027344,1,1
1201,2,7.21134549266633,7.21134549266633,0.9882682691646334,0.9882682691646341,0,0,8.748530387878418,8.681602478027344,2,2
1201,3,7.083222402656454,7.083222402656455,0.9921769390319537,0.9921769390319537,0,0,9.596514701843262,8.681602478027344,3,3
1201,4,6.907662929713765,6.907662929713765,0.9965790933964532,0.9965790933964529,0,0,9.889142990112305,8.681602478027344,4,4
1201,8,5.872047512095564,5.887139793249641,1.0146020336738442,1.0154625571850853,1,1,10.099662780761719,8.681602478027344,7,7
1201,16,5.366912133676234,5.580328109021509,1.0244335605614743,1.0236717697256337,5,6,10.630367279052734,8.681602478027344,11,10
1201,32,4.641655322112093,5.240348484470248,1.0337178266580493,1.0333541642870303,13,16,11.194634437561035,8.681602478027344,19,16
1201,64,3.2692681104320327,5.02504954142035,1.0230224599875626,1.0390369828105352,31,51,11.788663864135742,8.681602478027344,33,13
1201,128,1.8605216467664323,4.96086807012447,1.007054374401275,1.0409233797485502,58,110,12.597026824951172,8.681602478027344,70,18
1202,1,10.835265612430199,10.835265612430193,0.9324194833944863,0.9324194833944903,0,0,11.022320747375488,11.022320747375488,1,1
1202,2,9.492807847776296,9.492807847776296,0.9736875440192703,0.9736875440192714,0,0,12.660337448120117,11.022320747375488,2,2
1202,3,9.325528495864987,9.325528495864988,0.9805286189344444,0.9805286189344455,0,0,13.517967224121094,11.022320747375488,3,3
1202,4,8.45016551867261,8.45016551867261,1.0038788960091332,1.0038788960091358,0,0,13.751701354980469,11.022320747375488,4,4
1202,8,8.103137151842882,8.103137151842894,1.0210844413533973,1.0210844413533984,0,0,14.183869361877441,11.022320747375488,8,8
1202,16,7.412219351791664,7.604101553466799,1.0326769463302357,1.0376963560239154,4,6,14.748132705688477,11.022320747375488,12,10
1202,32,6.900171449507941,7.408482538532155,1.038528460571189,1.044729202119698,12,20,15.438313484191895,11.022320747375488,20,12
1202,64,5.145096837146371,7.373428063192945,1.0262903532006709,1.0474165946391394,29,53,16.166934967041016,11.022320747375488,35,11
1202,128,3.0569820761080737,7.36296272882997,1.0117362533576824,1.0491703098970446,62,116,17.010215759277344,11.022320747375488,66,12
1203,1,13.033660016978864,13.033660016978862,0.8847815636423537,0.884781563642355,0,0,13.494977951049805,13.494977951049805,1,1
1203,2,11.96314550975144,11.96314550975144,0.9230614698680613,0.9230614698680617,0,0,14.072800636291504,13.494977951049805,2,2
1203,3,11.67460208719939,11.674602087199393,0.9323684693122625,0.9323684693122636,0,0,14.103363990783691,13.494977951049805,3,3
1203,4,10.961441992298417,10.961441992298415,0.9590438020311083,0.9590438020311072,0,0,14.581661224365234,13.494977951049805,4,4
1203,8,10.335581008843258,10.335581008843258,0.9816479738712591,0.9816479738712602,0,0,14.803950309753418,13.494977951049805,8,8
1203,16,9.470765578031255,9.70343299650885,1.0081553142027926,1.0040755725908619,4,6,14.950335502624512,13.494977951049805,12,10
1203,32,8.70213847632528,9.561453731991834,1.0214802274945658,1.0079118397928728,12,20,15.24864673614502,13.494977951049805,20,12
1203,64,6.43256545449959,9.461057329431897,1.0146159874046226,1.014063032535593,29,51,15.699767112731934,13.494977951049805,35,13
1203,128,3.987867218798627,8.69951089919147,1.0105181758232633,1.0387343083881673,54,116,16.10228729248047,13.494977951049805,74,12
1204,1,9.342290593513995,9.342290593513995,0.9588480664727271,0.9588480664727285,0,0,9.423864364624023,9.423864364624023,1,1
1204,2,7.76438356908413,7.7643835690841305,0.9868843151017141,0.9868843151017153,0,0,9.74030876159668,9.423864364624023,2,2
1204,3,7.1236914594770635,7.1236914594770635,0.9986095892760424,0.9986095892760423,0,0,9.904627799987793,9.423864364624023,3,3
1204,4,6.867982823978067,6.867982823978066,1.003435154272178,1.0034351542721778,0,0,10.004666328430176,9.423864364624023,4,4
1204,8,6.554828499021472,6.560338508238034,1.0102920825102797,1.0102051941950776,1,1,10.301310539245605,9.423864364624023,7,7
1204,16,5.787286556483928,5.931205369930287,1.0275691574229944,1.0258354193612707,4,5,10.562159538269043,9.423864364624023,12,11
1204,32,5.24955856999012,5.676590150605677,1.0309232281904173,1.0297627545516572,12,18,10.93887710571289,9.423864364624023,20,14
1204,64,4.274096589246365,5.555742088151163,1.0198742975991542,1.0323588128036247,29,45,11.407373428344727,9.423864364624023,35,19
1204,128,2.317685432423431,5.534026349572942,1.0070489512724965,1.0338057064559505,64,108,11.838852882385254,9.423864364624023,64,20
1205,1,6.815079702202805,6.815079702202807,0.9753467047815457,0.975346704781548,0,0,6.855615615844727,6.855615615844727,1,1
1205,2,5.206867059355622,5.206867059355621,1.0050690516362253,1.0050690516362266,0,0,8.07358455657959,6.855615615844727,2,2
1205,3,4.965931391295058,4.965931391295057,1.009642186149736,1.009642186149737,0,0,8.115961074829102,6.855615615844727,3,3
1205,4,4.855476213165679,4.855476213165678,1.0126017100014688,1.0126017100014688,0,0,8.49975872039795,6.855615615844727,4,4
1205,8,4.772900307785808,4.775991932098013,1.0143908038465455,1.0145226154269005,2,2,8.939773559570312,6.855615615844727,6,6
1205,16,4.259496848284497,4.388977076366334,1.0229355234760802,1.0226061003679923,5,7,9.423395156860352,6.855615615844727,11,9
1205,32,3.617587586410234,4.130771595860862,1.0227905937283295,1.02920173713578,14,21,9.868631362915039,6.855615615844727,18,11
1205,64,2.799927557881893,4.103828248852992,1.0157266748462865,1.0305301203382446,30,49,10.564087867736816,6.855615615844727,34,15
1205,128,1.5319378350836124,4.068366717088024,1.0026979477433349,1.0326367743898943,70,109,11.294682502746582,6.855615615844727,58,19
1206,1,7.493127855344869,7.493127855344868,0.9666112936557482,0.9666112936557496,0,0,7.558504104614258,7.558504104614258,1,1
1206,2,6.461150596456314,6.461150596456313,0.9862205419261241,0.9862205419261247,0,0,7.673126697540283,7.558504104614258,2,2
1206,3,6.322932220808616,6.3229322208086165,0.9886223121693097,0.9886223121693107,0,0,7.871811389923096,7.558504104614258,3,3
1206,4,5.8963052156927125,5.8963052156927125,0.9970709197678411,0.9970709197678408,0,0,8.071349143981934,7.558504104614258,4,4
1206,8,5.018402377914481,5.094181425758525,1.0102386062591928,1.0077767326377494,1,2,8.369359016418457,7.558504104614258,7,6
1206,16,4.22226557624055,4.484688262484976,1.016379500102316,1.015552796701829,5,7,8.802790641784668,7.558504104614258,11,9
1206,32,3.31572094196925,4.064502634676418,1.0190740586836395,1.0249906628421073,13,20,9.573580741882324,7.558504104614258,19,12
1206,64,2.7989046860855344,3.8822690553722095,1.0161906826633615,1.030156423198627,27,47,10.32723331451416,7.558504104614258,37,17
1206,128,1.7158586432348195,3.8517290349124433,1.0024315525856269,1.031438738019832,60,111,11.442450523376465,7.558504104614258,68,17
1207,1,2.0911047960519418,2.0911047960519418,0.9985996392703562,0.9985996392703563,0,0,2.0914931297302246,2.0914931297302246,1,1
1207,2,1.9052073805698289,1.9052073805698289,0.9995705298313332,0.9995705298313333,0,0,2.755979061126709,2.0914931297302246,2,2
1207,3,1.8923707276481838,1.8923707276481836,0.9997420869143951,0.9997420869143956,0,0,3.3400790691375732,2.0914931297302246,3,3
1207,4,1.8345210919960515,1.8923707276481836,0.9992460056627701,0.9997420869143956,1,1,3.9083774089813232,2.0914931297302246,3,3
1207,8,1.6773642058951908,1.7764217707006906,1.0000819881460754,1.00110765416011,2,3,4.0164666175842285,2.0914931297302246,6,5
1207,16,1.507575686282571,1.7169678468961802,0.9998551683590988,1.0016029715748211,5,9,4.364538192749023,2.0914931297302246,11,7
1207,32,1.11410956273557,1.7029074766256516,0.9998780429011549,1.0023092058101541,11,20,4.625323295593262,2.0914931297302246,21,12
1207,64,0.611894336284947,1.6652704230562467,0.9987829966179219,1.0027754284567785,32,55,5.088196754455566,2.0914931297302246,32,9
1207,128,0.10737193784129186,1.652439338745399,0.998908184753772,1.00320741452412,60,118,5.709278106689453,2.0914931297302246,68,10
1208,1,11.966058705402128,11.96605870540213,0.921694883354913,0.9216948833549148,0,0,12.173941612243652,12.173941612243652,1,1
1208,2,10.489058794298803,10.489058794298805,0.9669147056723042,0.9669147056723053,0,0,13.843637466430664,12.173941612243652,2,2
1208,3,9.107902628200105,9.107902628200103,1.0075349281779147,1.007534928177914,0,0,14.089649200439453,12.173941612243652,3,3
1208,4,8.652092426066599,8.652092426066599,1.014327455066102,1.0143274550661026,0,0,14.14717960357666,12.173941612243652,4,4
1208,8,8.330811619121702,8.342269696479853,1.0223797470690894,1.0232661367699825,1,1,14.838655471801758,12.173941612243652,7,7
1208,16,8.060568694963829,8.164676566712886,1.031524751594561,1.0328114059940479,5,5,15.212481498718262,12.173941612243652,11,11
1208,32,7.545089598217347,7.988366251116552,1.0422507675345158,1.0441532868972956,11,16,15.60522174835205,12.173941612243652,21,16
1208,64,6.483404705405675,7.69009686473363,1.0426331627923877,1.05698982280105,27,45,16.063631057739258,12.173941612243652,37,19
1208,128,4.213159719839712,7.624785715928202,1.0209095716146561,1.0610386752394383,59,112,16.426557540893555,12.173941612243652,69,16
1209,1,8.461267102607241,8.461267102607245,0.9672656711332582,0.967265671133261,0,0,8.518694877624512,8.518694877624512,1,1
1209,2,6.642620929263493,6.642620929263494,0.9970063731181517,0.9970063731181533,0,0,8.630763053894043,8.518694877624512,2,2
1209,3,5.769315524674275,5.769315524674276,1.0115141744101175,1.0115141744101188,0,0,9.1226167678833,8.518694877624512,3,3
1209,4,5.691831483799017,5.691831483799016,1.0128415757350966,1.0128415757350977,0,0,9.140043258666992,8.518694877624512,4,4
1209,8,5.215493203886858,5.331814486177509,1.0166619870829174,1.0173632315063559,2,2,9.654618263244629,8.518694877624512,6,6
1209,16,4.704421775483725,5.140502815637094,1.0244621300820203,1.0242108348145487,5,6,10.172547340393066,8.518694877624512,11,10
1209,32,4.509555046872423,5.063554495150631,1.0278523200426313,1.0267647619916107,12,21,10.799351692199707,8.518694877624512,20,11
1209,64,3.0481913576952047,4.984970246833856,1.0090960112296352,1.029054785059637,30,49,11.48854923248291,8.518694877624512,34,15
1209,128,1.789524919374926,4.91093310536666,1.0015098533676985,1.0345681504588435,64,111,12.382181167602539,8.518694877624512,64,17
1210,1,7.0148285702265865,7.0148285702265865,0.9719180798009406,0.9719180798009411,0,0,7.066014289855957,7.066014289855957,1,1
1210,2,6.039078372616099,6.039078372616099,0.9831987233798252,0.983198723379825,0,0,7.390102863311768,7.066014289855957,2,2
1210,3,5.829684151708232,5.829684151708233,0.9873715389165632,0.987371538916562,0,0,7.649875640869141,7.066014289855957,3,3
1210,4,5.767716145019735,5.767716145019734,0.9892347933720191,0.9892347933720189,0,0,8.149822235107422,7.066014289855957,4,4
1210,8,5.083079981054374,5.102172443350835,1.0021039480183473,1.0030612840265305,3,3,8.586899757385254,7.066014289855957,5,5
1210,16,4.556994041321774,4.881927943947376,1.006795943060416,1.0082163392236998,6,7,8.971841812133789,7.066014289855957,10,9
1210,32,3.6913442621288826,4.38912207498253,1.0115141580539189,1.0171554841347823,14,18,9.440893173217773,7.066014289855957,18,14
1210,64,2.4607940736900473,4.243070532722827,1.0040914628605435,1.021719482555088,28,50,10.074199676513672,7.066014289855957,36,14
1210,128,1.0901508444658945,4.238259529671838,0.9977519226913395,1.0222265582230028,61,113,10.731646537780762,7.066014289855957,67,15
1211,1,8.28689728232847,8.28689728232847,0.9674305263214585,0.9674305263214599,0,0,8.343429565429688,8.343429565429688,1,1
1211,2,7.662800995747064,7.662800995747064,0.9840823132302647,0.9840823132302654,0,0,10.093079566955566,8.343429565429688,2,2
1211,3,7.40736556545279,7.40736556545279,0.9908922396036157,0.9908922396036162,0,0,10.384785652160645,8.343429565429688,3,3
1211,4,7.30991611011227,7.309916110112269,0.9947632239027784,0.994763223902779,0,0,10.630342483520508,8.343429565429688,4,4
1211,8,7.213397562969129,7.213397562969127,0.9989380638111431,0.9989380638111451,0,0,11.252777099609375,8.343429565429688,8,8
1211,16,5.531826386675901,5.917895221772486,1.0228617313599253,1.019415295781393,5,7,11.786205291748047,8.343429565429688,11,9
1211,32,4.538155114031709,5.887308759335052,1.025767421362798,1.0208215026486647,11,23,12.27742862701416,8.343429565429688,21,9
1211,64,3.3935572826469076,5.7970096246409515,1.0213930853485127,1.0238535806967957,27,54,12.685131072998047,8.343429565429688,37,10
1211,128,2.167610036130623,5.709636315731822,1.0064332615654967,1.0311310114763697,68,115,13.260059356689453,8.343429565429688,60,13
1212,1,8.00921487747588,8.009214877475877,0.9608321783122445,0.9608321783122463,0,0,8.093791007995605,8.093791007995605,1,1
1212,2,5.854752717655666,5.854752717655666,0.9931132705067021,0.993113270506703,0,0,8.170336723327637,8.093791007995605,2,2
1212,3,5.777343834046892,5.777343834046891,0.9959984976197735,0.9959984976197743,0,0,9.045485496520996,8.093791007995605,3,3
1212,4,5.157370420240684,5.157370420240689,1.0074725806992577,1.0074725806992593,0,0,9.058040618896484,8.093791007995605,4,4
1212,8,4.989514059705487,5.002771325756919,1.0108810618705693,1.010919712744018,2,2,9.563433647155762,8.093791007995605,6,6
1212,16,4.590669452342177,4.734086277467591,1.0181956252476743,1.017966888082173,6,6,9.951173782348633,8.093791007995605,10,10
1212,32,4.173406383889412,4.502146897296828,1.0254299850673019,1.0255434758104902,11,19,10.567727088928223,8.093791007995605,21,13
1212,64,3.432382143965626,4.361660466609172,1.0187215839139583,1.0327839413633293,28,48,11.325393676757812,8.093791007995605,36,16
1212,128,2.2801635136345384,4.274285505957185,1.0064348255206377,1.0357295603306178,59,109,12.082000732421875,8.093791007995605,69,19
1213,1,9.799253919655094,9.799253919655094,0.9329200616192197,0.9329200616192216,0,0,10.001130104064941,10.001130104064941,1,1
1213,2,8.663861488144978,8.663861488144978,0.9628149017341183,0.9628149017341194,0,0,10.17428207397461,10.001130104064941,2,2
1213,3,8.490094732994375,8.490094732994377,0.9675960914697699,0.96759609146977,0,0,10.988977432250977,10.001130104064941,3,3
1213,4,8.324773707297721,8.324773707297723,0.9750293230342231,0.975029323034223,0,0,11.560066223144531,10.001130104064941,4,4
1213,8,7.571823242966827,7.580972809169204,1.0019702478042116,1.0022758935240144,1,1,11.931255340576172,10.001130104064941,7,7
1213,16,6.968134122313674,7.243200283580432,1.0114146698606739,1.0172980960828661,6,5,12.80261516571045,10.001130104064941,10,11
1213,32,6.176524395356723,7.189165401075596,1.0062509183564234,1.0226747707627692,14,20,13.695615768432617,10.001130104064941,18,12
1213,64,4.047819250578569,7.107824845633286,1.0115201432126213,1.0292947697278532,34,49,14.427227973937988,10.001130104064941,30,15
1213,128,2.5709680693476455,7.1051554490186914,1.0027478367314129,1.0299064919132057,63,111,15.271899223327637,10.001130104064941,65,17
1214,1,7.586635249694863,7.586635249694863,0.9586203158578772,0.9586203158578791,0,0,7.685459136962891,7.685459136962891,1,1
1214,2,7.1857980083533395,7.185798008353339,0.9739064302506403,0.973906430250641,0,0,11.87124252319336,7.685459136962891,2,2
1214,3,7.181337289161301,7.181337289161302,0.9750261731180008,0.9750261731180019,0,0,12.005863189697266,7.685459136962891,3,3
1214,4,6.475297324097728,6.484245548313207,0.9915967612233674,0.9927301080562851,1,1,12.060958862304688,7.685459136962891,3,3
1214,8,6.101338114265662,6.409013245406213,0.9938244802981816,0.996897835862244,3,4,12.25251293182373,7.685459136962891,5,4
1214,16,5.799686121004331,6.210274483025914,0.9984903055542882,1.0058329199947957,9,9,13.3228759765625,7.685459136962891,7,7
1214,32,5.040228591630282,5.913644940928029,1.017682008054952,1.0188302887372676,14,23,13.935660362243652,7.685459136962891,18,9
1214,64,3.7183485826685696,5.913644940928029,1.0053484297013986,1.0188302887372676,30,55,14.545639038085938,7.685459136962891,34,9
1214,128,2.4600908477231487,5.894226170946234,1.0006493774672833,1.0227459913231516,62,116,15.327436447143555,7.685459136962891,66,12
1215,1,11.32069267350357,11.32069267350357,0.9276492196499398,0.9276492196499413,0,0,11.52763557434082,11.52763557434082,1,1
1215,2,10.390125308827617,10.390125308827617,0.9557151176370434,0.9557151176370433,0,0,11.604462623596191,11.52763557434082,2,2
1215,3,8.959042563339821,8.959042563339821,0.98672416840755,0.9867241684075514,0,0,11.862283706665039,11.52763557434082,3,3
1215,4,8.153831726734484,8.153831726734484,1.0080981643108229,1.008098164310823,0,0,12.414167404174805,11.52763557434082,4,4
1215,8,7.645859323988228,7.646430118098809,1.0215399254412842,1.0216007906062194,1,1,13.205792427062988,11.52763557434082,7,7
1215,16,7.514687666495756,7.61384740410727,1.0237402879303277,1.0239760294421394,5,8,13.720057487487793,11.52763557434082,11,8
1215,32,6.685210086966108,7.248900955022256,1.037540522561736,1.0421570400835287,13,19,14.44947624206543,11.52763557434082,19,13
1215,64,5.093750673170497,7.215903211759708,1.0153180180218198,1.0454999798100737,28,50,15.276491165161133,11.52763557434082,36,14
1215,128,3.2633093608334143,6.846336517364277,1.0155980663772093,1.0605714960507913,60,110,15.923188209533691,11.52763557434082,68,18
1216,1,7.05595007004578,7.055950070045776,0.9687692539102908,0.9687692539102929,0,0,7.118305683135986,7.118305683135986,1,1
1216,2,4.84585962365939,4.845859623659391,1.0018941362378666,1.0018941362378682,0,0,7.486949443817139,7.118305683135986,2,2
1216,3,4.326433451652771,4.32643345165277,1.009023125043121,1.0090231250431216,0,0,7.731787204742432,7.118305683135986,3,3
1216,4,4.315344055198158,4.32643345165277,1.0089987823757647,1.0090231250431216,1,1,7.859853744506836,7.118305683135986,3,3
1216,8,3.8166508822136542,3.839909847194921,1.0152000547874551,1.0149632105036166,1,2,8.39782428741455,7.118305683135986,7,6
1216,16,3.4621431788095833,3.6936382733912927,1.0179401477695638,1.01749776607479,5,7,8.69649600982666,7.118305683135986,11,9
1216,32,2.9709901098045908,3.5054639887077483,1.0199229114930697,1.020238072369102,13,21,9.43780517578125,7.118305683135986,19,11
1216,64,1.91012046691058,3.5010155953811606,1.0100493070755063,1.0207899871147907,27,51,10.009832382202148,7.118305683135986,37,13
1216,128,0.9361271979935883,3.4973115317439696,1.0019097436015285,1.0213559291013192,64,113,10.599862098693848,7.118305683135986,64,15
1217,1,2.6117848576037908,2.611784857603786,0.9953447890991076,0.995344789099109,0,0,2.61574125289917,2.61574125289917,1,1
1217,2,2.403579566771259,2.4035795667712594,0.9972026173932559,0.9972026173932568,0,0,2.8519036769866943,2.61574125289917,2,2
1217,3,2.2898184212237687,2.2898184212237687,0.9978633155244427,0.9978633155244439,0,0,2.9137444496154785,2.61574125289917,3,3
1217,4,2.217846535913042,2.217846535913042,0.9974961682328023,0.9974961682328025,0,0,3.3000807762145996,2.61574125289917,4,4
1217,8,2.0038416100173944,2.0910249556877925,0.9986739467778329,0.9993753859457613,3,4,3.7167060375213623,2.61574125289917,5,4
1217,16,1.6928468391304166,1.831697654752007,0.9997570077788913,1.0011627397832252,8,9,4.141634464263916,2.61574125289917,8,7
1217,32,0.8596167144926279,1.4238940173840855,1.0015765002067019,1.0045906844503307,15,20,4.49138069152832,2.61574125289917,17,12
1217,64,0.46270063913914095,1.363010844489295,1.0009316790739757,1.00487844130005,27,54,4.879131317138672,2.61574125289917,37,10
1217,128,0.06216152784173727,1.3395605484809487,0.9997180789682507,1.0051969282749322,56,113,5.250993728637695,2.61574125289917,72,15
1218,1,12.253453322072453,12.25345332207245,0.9072096583455905,0.907209658345592,0,0,12.552474975585938,12.552474975585938,1,1
1218,2,10.560463994308233,10.560463994308234,0.9620593899162662,0.9620593899162672,0,0,13.035983085632324,12.552474975585938,2,2
1218,3,9.364389333713117,9.364389333713117,0.9875092696526775,0.9875092696526768,0,0,13.063703536987305,12.552474975585938,3,3
1218,4,9.298655790453244,9.298655790453244,0.9897969911467577,0.9897969911467575,0,0,13.212717056274414,12.552474975585938,4,4
1218,8,8.581703835727463,8.605330930697114,1.0159069488997503,1.014582194590702,1,1,13.71813678741455,12.552474975585938,7,7
1218,16,7.434913935375738,7.712903116898229,1.036506254645556,1.034595796958608,7,8,13.949972152709961,12.552474975585938,9,8
1218,32,6.329082604990185,7.042648937781898,1.0521416556144612,1.0538494911595448,15,20,14.362585067749023,12.552474975585938,17,12
1218,64,4.9728742783949045,6.853592784573447,1.0503292054822178,1.0602557247512747,28,49,14.862170219421387,12.552474975585938,36,15
1218,128,3.1803637859031273,6.735902698346631,1.0239696414951052,1.0651871950013982,57,109,15.365564346313477,12.552474975585938,71,19
1219,1,6.779470197337762,6.779470197337764,0.9724066633782497,0.9724066633782524,0,0,6.830441951751709,6.830441951751709,1,1
1219,2,5.557330231997219,5.55733023199722,0.9924598200209258,0.9924598200209274,0,0,7.622840881347656,6.830441951751709,2,2
1219,3,5.401710663838166,5.401710663838166,0.99607025311332,0.9960702531133209,0,0,7.988941192626953,6.830441951751709,3,3
1219,4,5.394738895799542,5.401710663838166,0.9955968030417661,0.9960702531133209,1,1,8.476114273071289,6.830441951751709,3,3
1219,8,4.833065559767509,5.118746511342579,1.0012685777026242,1.0010064114800268,3,4,8.73558521270752,6.830441951751709,5,4
1219,16,4.177703941742129,4.807083301813446,1.010730325802182,1.011084462914503,5,8,9.266313552856445,6.830441951751709,11,8
1219,32,3.639630685482347,4.594326851158185,1.0133344365100374,1.0178459073955965,16,24,9.805288314819336,6.830441951751709,16,8
1219,64,2.7261491892850085,4.494757960128444,1.009989931505511,1.0186126202121977,35,56,10.184051513671875,6.830441951751709,29,8
1219,128,1.4880933284002265,4.240726958048571,1.002528385368994,1.0228220681386837,64,118,10.794410705566406,6.830441951751709,64,10
1220,1,3.7857491329658934,3.7857491329658908,0.9908728176548475,0.9908728176548498,0,0,3.796274185180664,3.796274185180664,1,1
1220,2,2.935920329963186,2.9359203299631864,0.9967817608822137,0.9967817608822158,0,0,3.9812564849853516,3.796274185180664,2,2
1220,3,2.757789663776596,2.7577896637765975,0.997801217889098,0.9978012178890996,0,0,3.995245933532715,3.796274185180664,3,3
1220,4,2.537279673466361,2.543019175359835,0.9992755045056091,0.9992127527193431,1,1,4.148031234741211,3.796274185180664,3,3
1220,8,2.4913118464355386,2.4923328304027903,0.9996545697790724,0.9995871377531671,2,2,4.363609790802002,3.796274185180664,6,6
1220,16,1.951731848898112,2.348561385810654,0.9995584256113298,1.001036117587853,5,8,4.624887943267822,3.796274185180664,11,8
1220,32,1.5139404647893497,2.0711070547579573,1.0025005221624212,1.004084408161989,14,22,5.042709827423096,3.796274185180664,18,10
1220,64,0.9680104171801995,2.058533947460638,1.0001488183005298,1.004456199042918,31,53,5.375288963317871,3.796274185180664,33,11
1220,128,0.4938047413650398,2.0112853024376154,0.998682163239028,1.0062190111185652,68,114,5.865283489227295,3.796274185180664,60,14
1221,1,6.037884228250524,6.037884228250524,0.9782006134497013,0.9782006134497024,0,0,6.074113845825195,6.074113845825195,1,1
1221,2,5.712683227952711,5.712683227952712,0.9846413757022505,0.9846413757022516,0,0,7.171187877655029,6.074113845825195,2,2
1221,3,5.119958108157805,5.119958108157805,0.9927021470955603,0.9927021470955608,0,0,7.527007102966309,6.074113845825195,3,3
1221,4,5.118680509062485,5.119958108157805,0.9925582405456215,0.9927021470955608,1,1,7.827954292297363,6.074113845825195,3,3
1221,8,4.766725632301097,4.842562982849143,0.9982829360640522,0.9994845548105302,3,4,8.823249816894531,6.074113845825195,5,4
1221,16,4.073575892776819,4.387982108531095,1.0094247909660545,1.0119358214024445,6,7,9.842087745666504,6.074113845825195,10,9
1221,32,3.2080640920323575,4.1824040266182365,1.0120202913823024,1.0184014135018011,8,21,10.370195388793945,6.074113845825195,24,11
1221,64,2.4687713231844053,4.04748642111959,1.0085071430547967,1.022673254547948,31,52,11.046979904174805,6.074113845825195,33,12
1221,128,1.5383481481122636,4.047306504867807,0.9988185889744733,1.0228314208125295,62,115,11.586431503295898,6.074113845825195,66,13
1222,1,10.81453839091335,10.814538390913354,0.9286568788065486,0.9286568788065501,0,0,11.016373634338379,11.016373634338379,1,1
1222,2,9.62215414398309,9.622154143983092,0.9554696321540912,0.9554696321540919,0,0,11.069260597229004,11.016373634338379,2,2
1222,3,9.225960014458725,9.225960014458725,0.9637673267865021,0.963767326786503,0,0,11.113031387329102,11.016373634338379,3,3
1222,4,8.053352930828227,8.053352930828229,0.9907470729299666,0.9907470729299668,0,0,11.137032508850098,11.016373634338379,4,4
1222,8,7.443545774735098,7.540996940813998,1.002024086278181,1.002129580273707,1,1,11.550511360168457,11.016373634338379,7,7
1222,16,6.795794755762537,7.084703958314998,1.0173268158947648,1.0151025039351358,6,6,12.043334007263184,11.016373634338379,10,10
1222,32,5.949545852906916,6.768376673632034,1.0241836192072709,1.0267858785496495,15,20,12.652047157287598,11.016373634338379,17,12
1222,64,4.4694501091931516,6.70529150579705,1.0194279845040988,1.0333433929312514,32,46,13.168037414550781,11.016373634338379,32,18
1222,128,2.68376346363135,6.6100590233265075,1.0086459193359802,1.0396377492177953,63,110,13.711271286010742,11.016373634338379,65,18
1223,1,11.037254057744272,11.037254057744272,0.9262157346911359,0.9262157346911382,0,0,11.248644828796387,11.248644828796387,1,1
1223,2,9.235484558191025,9.235484558191025,0.9736499032658105,0.9736499032658119,0,0,11.258380889892578,11.248644828796387,2,2
1223,3,7.780130386654659,7.780130386654659,1.0029942131385867,1.002994213138588,0,0,11.372370719909668,11.248644828796387,3,3
1223,4,7.516058602760279,7.516058602760279,1.007880858203149,1.0078808582031498,0,0,11.381173133850098,11.248644828796387,4,4
1223,8,6.807261706434462,6.8394518420311625,1.0213053970715742,1.0214334950321755,2,2,12.311783790588379,11.248644828796387,6,6
1223,16,6.36567175115748,6.522223694198617,1.0290397085600953,1.030384168458202,5,8,12.627477645874023,11.248644828796387,11,8
1223,32,5.944902596272869,6.362492662733867,1.0355873800643045,1.0358203532296664,12,16,13.017014503479004,11.248644828796387,20,16
1223,64,4.835817554834854,6.301764299047832,1.0276222882832742,1.0398729950820593,25,45,13.559833526611328,11.248644828796387,39,19
1223,128,3.1689083242748235,6.2146971836362574,1.0098706421415273,1.045207914195971,63,107,14.369063377380371,11.248644828796387,65,21
1224,1,7.853587047435725,7.853587047435728,0.9579912756618222,0.9579912756618254,0,0,7.955170154571533,7.955170154571533,1,1
1224,2,6.462908595055346,6.462908595055341,0.9895781033410964,0.9895781033410997,0,0,9.719181060791016,7.955170154571533,2,2
1224,3,6.1470767745644395,6.1470767745644395,0.9975080107085664,0.9975080107085689,0,0,9.917295455932617,7.955170154571533,3,3
1224,4,5.851855562914603,5.8518555629146025,1.0033881160891747,1.0033881160891773,0,0,10.140618324279785,7.955170154571533,4,4
1224,8,5.502971480163807,5.503137595042027,1.0123993868548493,1.0124917739479333,1,1,10.874251365661621,7.955170154571533,7,7
1224,16,5.0224604560925545,5.208179370914149,1.0242254375117954,1.0239674421979457,4,7,11.304378509521484,7.955170154571533,12,9
1224,32,4.189126835768275,5.0491242884489544,1.0207293269975029,1.0293378406012257,14,20,12.236763954162598,7.955170154571533,18,12
1224,64,3.0265342739690895,5.015111047522383,1.0128737388803386,1.0314824618206482,31,51,12.74239730834961,7.955170154571533,33,13
1224,128,2.016484212110323,4.939447973246627,1.004826941400403,1.0371597436862483,58,112,13.666023254394531,7.955170154571533,70,16
1225,1,6.756674734925016,6.756674734925017,0.9708289692413533,0.9708289692413538,0,0,6.813672065734863,6.813672065734863,1,1
1225,2,4.987131771392764,4.987131771392763,0.9944601085494822,0.9944601085494817,0,0,7.168209075927734,6.813672065734863,2,2
1225,3,4.475954432499157,4.475954432499157,1.0016885077232693,1.001688507723269,0,0,7.228067874908447,6.813672065734863,3,3
1225,4,4.058396442608538,4.0583964426085375,1.0057099856392784,1.0057099856392782,0,0,7.2718658447265625,6.813672065734863,4,4
1225,8,3.8504215439091665,3.852141675651097,1.0085686766451474,1.008548753060372,1,1,7.8316969871521,6.813672065734863,7,7
1225,16,3.5473710543303465,3.704234904840444,1.0129936632254037,1.0135012808860027,3,3,8.69256591796875,6.813672065734863,13,13
1225,32,3.3189041585292984,3.6550256414674376,1.0088786033461892,1.0152216020038383,12,16,9.241379737854004,6.813672065734863,20,16
1225,64,2.5341923854343174,3.638777971172992,1.0055782257264183,1.0158935681937737,30,49,10.051041603088379,6.813672065734863,34,15
1225,128,1.4685246953822855,3.638777971172992,0.998629855162754,1.0158935681937737,61,113,10.939729690551758,6.813672065734863,67,15
1226,1,8.16342705968046,8.16342705968046,0.9682705196176725,0.968270519617674,0,0,8.218859672546387,8.218859672546387,1,1
1226,2,5.9530981577923106,5.953098157792311,1.0007964385161205,1.0007964385161217,0,0,8.66258430480957,8.218859672546387,2,2
1226,3,5.939783188205439,5.939783188205439,1.0012735067443284,1.001273506744329,0,0,8.891902923583984,8.218859672546387,3,3
1226,4,5.658351025438658,5.658351025438657,1.0042645949502862,1.0042645949502857,0,0,9.17593002319336,8.218859672546387,4,4
1226,8,4.9334525423053215,4.9334525423053215,1.0186806635216221,1.018680663521622,0,0,9.976147651672363,8.218859672546387,8,8
1226,16,4.465481571379412,4.915963811890236,1.018156981719522,1.0202396094427648,5,6,10.572407722473145,8.218859672546387,11,10
1226,32,3.7557117479136846,4.814912990589537,1.0165965680801765,1.022764617304243,14,22,10.946319580078125,8.218859672546387,18,10
1226,64,2.583610200837755,4.809330550345478,1.007609282799225,1.023438131181369,34,52,11.508715629577637,8.218859672546387,30,12
1226,128,1.5754460035971654,4.762981443992365,1.001432423047785,1.0257514933515555,61,116,12.12116813659668,8.218859672546387,67,12
1227,1,6.316897435551845,6.316897435551847,0.9693873794127864,0.9693873794127901,0,0,6.385673999786377,6.385673999786377,1,1
1227,2,5.694891405579401,5.694891405579402,0.9840601572252422,0.9840601572252445,0,0,7.211404800415039,6.385673999786377,2,2
1227,3,4.882681825769676,4.882681825769676,0.9941939942109521,0.9941939942109539,0,0,7.771000385284424,6.385673999786377,3,3
1227,4,4.678545764427327,4.678545764427329,0.9985409411726626,0.9985409411726645,0,0,8.175686836242676,6.385673999786377,4,4
1227,8,4.087921834868916,4.087921834868916,1.0090161754042482,1.009016175404252,0,0,8.977657318115234,6.385673999786377,8,8
1227,16,3.833521524158164,3.999356126559394,1.01001809641526,1.0121033018797565,3,4,9.811356544494629,6.385673999786377,13,12
1227,32,3.1626683580674704,3.8807536707063233,1.0066319043027352,1.014983474054641,14,22,10.399245262145996,6.385673999786377,18,10
1227,64,2.6141970712021165,3.8730458572044557,1.003668322030821,1.0159845000124992,30,50,11.085108757019043,6.385673999786377,34,14
1227,128,1.633161180058281,3.8067483296788085,0.9987620807567947,1.0194884355822,59,112,11.840730667114258,6.385673999786377,69,16
1228,1,7.132616710965054,7.132616710965055,0.9744985905489438,0.9744985905489442,0,0,7.173983097076416,7.173983097076416,1,1
1228,2,5.974186991752581,5.974186991752581,0.9925050059540019,0.9925050059540019,0,0,7.6037750244140625,7.173983097076416,2,2
1228,3,5.201722541974939,5.201722541974939,1.0036799099277953,1.0036799099277955,0,0,7.906711101531982,7.173983097076416,3,3
1228,4,5.146367815307667,5.146367815307666,1.0053765269160828,1.0053765269160828,0,0,7.925172805786133,7.173983097076416,4,4
1228,8,4.301500766026327,4.302100486573804,1.018473298093134,1.0184806033211427,1,1,8.280428886413574,7.173983097076416,7,7
1228,16,3.7007700684634646,4.087319790642041,1.0219508059925586,1.0221530738507059,6,7,8.858061790466309,7.173983097076416,10,9
1228,32,3.2596336974793174,4.050760665434376,1.0174713815406307,1.0234743716687464,16,17,9.420629501342773,7.173983097076416,16,15
1228,64,2.546946854992521,4.038891456357377,1.01098547895025,1.0247320262044148,35,46,10.10138988494873,7.173983097076416,29,18
1228,128,1.4654373720114897,4.01132431409838,1.0021590470614956,1.026508066734095,71,108,10.861750602722168,7.173983097076416,57,20
1229,1,8.654987589323305,8.654987589323305,0.9542904236734121,0.9542904236734129,0,0,8.763908386230469,8.763908386230469,1,1
1229,2,6.789823142973312,6.7898231429733125,0.9865964010820618,0.9865964010820626,0,0,8.977601051330566,8.763908386230469,2,2
1229,3,6.33154087210386,6.331540872103861,0.9932668828537106,0.9932668828537105,0,0,9.05453109741211,8.763908386230469,3,3
1229,4,6.175877260330201,6.1758772603302,0.9958917425981044,0.9958917425981042,0,0,9.075559616088867,8.763908386230469,4,4
1229,8,6.141436322923828,6.14413852996056,0.9979395754398821,0.9979100392454674,2,2,10.002517700195312,8.763908386230469,6,6
1229,16,5.770539694723872,5.947094266609006,1.0022756326838425,1.003703725043017,6,8,10.645254135131836,8.763908386230469,10,8
1229,32,4.376453775710002,5.367376010385761,1.0154170032513243,1.0220829500899864,14,20,10.897733688354492,8.763908386230469,18,12
1229,64,3.1082395468393638,5.068384625221149,1.010947692463346,1.028032832517241,33,48,11.752388954162598,8.763908386230469,31,16
1229,128,1.8254675155276507,4.953958502796836,1.001725366998851,1.0339575930301794,68,111,12.619534492492676,8.763908386230469,60,17
1230,1,10.851240937514163,10.851240937514165,0.9423062059154912,0.9423062059154934,0,0,10.982189178466797,10.982189178466797,1,1
1230,2,9.465091749536205,9.465091749536203,0.977677022092885,0.9776770220928857,0,0,11.812790870666504,10.982189178466797,2,2
1230,3,8.620376861988273,8.620376861988273,0.997270212572607,0.9972702125726072,0,0,11.86468505859375,10.982189178466797,3,3
1230,4,7.47816992761701,7.478169927617009,1.0203742843532515,1.0203742843532524,0,0,12.1433744430542,10.982189178466797,4,4
1230,8,6.696388552559524,6.720408010387877,1.038477428152964,1.0374763318536668,1,1,12.43718433380127,10.982189178466797,7,7
1230,16,6.1850806536696314,6.21667240394635,1.0440463952169656,1.0446828760200964,4,5,13.083657264709473,10.982189178466797,12,11
1230,32,5.532291911839828,6.115280710106977,1.044330444851565,1.0482864527217426,13,20,14.253804206848145,10.982189178466797,19,12
1230,64,4.180412417606998,6.105264791148014,1.0280718684879138,1.0497837799450174,30,51,15.18668270111084,10.982189178466797,34,13
1230,128,2.410074495958083,6.099589467969333,1.0032761268504993,1.0511407532533137,62,114,16.144990921020508,10.982189178466797,66,14
1231,1,11.74392462595962,11.743924625959623,0.9135440581895038,0.9135440581895058,0,0,12.026294708251953,12.026294708251953,1,1
1231,2,9.14724892930914,9.14724892930914,0.9851960565096881,0.9851960565096893,0,0,12.198439598083496,12.026294708251953,2,2
1231,3,8.511329144286709,8.51132914428671,1.0010403732012736,1.001040373201274,0,0,12.526920318603516,12.026294708251953,3,3
1231,4,8.049771925883068,8.049771925883066,1.0123820798760073,1.0123820798760088,0,0,12.56762981414795,12.026294708251953,4,4
1231,8,7.9376011504782555,7.976258034309239,1.0158491189826022,1.0154381653694085,2,2,13.274206161499023,12.026294708251953,6,6
1231,16,7.675338369322238,7.964169822035661,1.0146103497733894,1.0163339298066827,7,9,13.999165534973145,12.026294708251953,9,7
1231,32,6.451585363921556,7.256143505240251,1.034450139781379,1.0355522956979422,16,24,14.459022521972656,12.026294708251953,16,8
1231,64,5.351035265690658,7.207581984533687,1.031000765200015,1.0384794395282109,32,54,14.889485359191895,12.026294708251953,32,10
1231,128,3.4542897979380323,7.173686968789428,1.0106808720678013,1.042270232132923,60,118,15.499709129333496,12.026294708251953,68,10
1232,1,7.04114171788674,7.041141717886739,0.9700530728111113,0.9700530728111131,0,0,7.098806381225586,7.098806381225586,1,1
1232,2,5.224559388335122,5.224559388335122,0.9989840645344273,0.998984064534429,0,0,7.497169494628906,7.098806381225586,2,2
1232,3,4.885095268243574,4.885095268243573,1.001884420146711,1.0018844201467125,0,0,7.6218461990356445,7.098806381225586,3,3
1232,4,4.806664291659741,4.8066642916597395,1.0033171286221243,1.0033171286221259,0,0,7.683441638946533,7.098806381225586,4,4
1232,8,4.213180273811018,4.213180273811018,1.012235271578997,1.0122352715789966,0,0,8.133845329284668,7.098806381225586,8,8
1232,16,4.036952433409844,4.077305151721959,1.014968022490776,1.0158127942874293,4,4,8.62621784210205,7.098806381225586,12,12
1232,32,3.415470999774994,3.995647654715994,1.0113646700522785,1.0176580305366338,15,20,9.173699378967285,7.098806381225586,17,12
1232,64,2.23498412978482,3.955941475388056,1.0039193847687524,1.0195608440403063,33,50,9.876517295837402,7.098806381225586,31,14
1232,128,1.4291916577580133,3.8655304593244573,1.0021682785905475,1.0224237756087389,59,110,10.540836334228516,7.098806381225586,69,18
1233,1,8.39469672977564,8.394696729775642,0.9569448975890404,0.9569448975890413,0,0,8.495170593261719,8.495170593261719,1,1
1233,2,7.078616270600775,7.078616270600775,0.9836631902166089,0.9836631902166091,0,0,8.570231437683105,8.495170593261719,2,2
1233,3,6.67330777724004,6.67330777724004,0.990473708839266,0.9904737088392672,0,0,8.646029472351074,8.495170593261719,3,3
1233,4,6.602558194650381,6.60255819465038,0.9923879736451096,0.99238797364511,0,0,8.750360488891602,8.495170593261719,4,4
1233,8,4.879872981634871,5.115965885081818,1.0147374335208417,1.0131948084412967,1,1,9.387786865234375,8.495170593261719,7,7
1233,16,4.684463670917814,4.948263135148555,1.0178951663623983,1.019336572465921,2,6,10.082454681396484,8.495170593261719,14,10
1233,32,4.080846669132409,4.68025479926308,1.015582000685598,1.0257384875654783,13,20,10.893308639526367,8.495170593261719,19,12
1233,64,3.3895302412986847,4.676236667611462,1.007282916419114,1.0258760034352998,27,51,11.813177108764648,8.495170593261719,37,13
1233,128,1.6456057617041897,4.621810893455313,1.0019587965867212,1.0294513498592528,62,112,12.787642478942871,8.495170593261719,66,16
1234,1,8.684326645982225,8.684326645982225,0.9492995393462306,0.9492995393462307,0,0,8.820775985717773,8.820775985717773,1,1
1234,2,7.236617134673899,7.2366171346738986,0.9795241661837446,0.9795241661837444,0,0,8.940412521362305,8.820775985717773,2,2
1234,3,6.389685272840895,6.389685272840894,0.9911667345939039,0.9911667345939035,0,0,9.018160820007324,8.820775985717773,3,3
1234,4,6.258983762593011,6.27325658378509,0.9941684875195606,0.9937415781510135,1,1,9.04202651977539,8.820775985717773,3,3
1234,8,6.0762011320159015,6.084067378337219,0.9968891632029202,0.9968583678163476,3,3,9.39812183380127,8.820775985717773,5,5
1234,16,5.406327832313401,5.762496365267861,1.0060755809323005,1.0041411134131724,6,8,10.29689884185791,8.820775985717773,10,8
1234,32,4.426395758578346,5.6870169206365535,1.0060663513336445,1.0068079289997667,14,20,10.960360527038574,8.820775985717773,18,12
1234,64,3.0853465613366877,5.321671937738574,1.0051862906732072,1.0243681460946457,34,53,11.513540267944336,8.820775985717773,30,11
1234,128,2.0548846987486558,5.29779900994834,1.0009201383329844,1.0253029966857674,68,115,11.987650871276855,8.820775985717773,60,13
1235,1,9.6373820541858,9.637382054185803,0.9418724986677512,0.9418724986677552,0,0,9.793577194213867,9.793577194213867,1,1
1235,2,8.6079129756275,8.607912975627501,0.9718995558469647,0.971899555846967,0,0,10.342934608459473,9.793577194213867,2,2
1235,3,8.350482633625266,8.350482633625266,0.9797957945940168,0.979795794594018,0,0,10.351950645446777,9.793577194213867,3,3
1235,4,8.281689915216306,8.281689915216306,0.9816798329278288,0.9816798329278296,0,0,10.746931076049805,9.793577194213867,4,4
1235,8,6.938407412713519,6.965784339039492,1.0128516493461979,1.0124512656197426,1,1,11.160751342773438,9.793577194213867,7,7
1235,16,6.133563451615443,6.291088343104189,1.0292997094233185,1.0271049105883368,6,5,11.699315071105957,9.793577194213867,10,11
1235,32,5.228145052648194,6.28461277083538,1.0256784313189877,1.027952104083494,14,18,12.49735164642334,9.793577194213867,18,14
1235,64,3.5832973383424784,6.0496710955970885,1.0145505189129214,1.0372187140883917,28,49,13.406784057617188,9.793577194213867,36,15
1235,128,2.3185555134082367,5.990950066059159,1.0077860244294492,1.0395832974254826,62,112,14.325155258178711,9.793577194213867,66,16
1236,1,4.135341848889175,4.135341848889176,0.9887146195207719,0.988714619520774,0,0,4.149355888366699,4.149355888366699,1,1
1236,2,3.5778036030649534,3.5778036030649534,0.9967942576885267,0.996794257688528,0,0,5.945176601409912,4.149355888366699,2,2
1236,3,3.4669502708160214,3.4669502708160223,0.9989366754972271,0.9989366754972285,0,0,6.146167755126953,4.149355888366699,3,3
1236,4,3.4429562294138347,3.4429562294138347,0.9997967145916744,0.9997967145916757,0,0,6.538958549499512,4.149355888366699,4,4
1236,8,3.1572864835463204,3.2697474227082934,1.0011412126807029,1.0031174511423142,1,3,7.225968837738037,4.149355888366699,7,5
1236,16,2.9205644398804034,3.2312882058907118,1.0051500210156448,1.0058940285802658,6,8,7.796091556549072,4.149355888366699,10,8
1236,32,2.4722789990221603,3.1985983947844745,1.00212084786449,1.007782498790664,13,20,8.493436813354492,4.149355888366699,19,12
1236,64,1.8496047000652835,3.16047171661688,1.0021835214158925,1.009652973372028,31,52,9.109952926635742,4.149355888366699,33,12
1236,128,0.9001832497781312,3.114418918594295,1.0000287977869762,1.012310849897109,55,112,10.2273530960083,4.149355888366699,73,16
1237,1,10.719756009312874,10.719756009312864,0.9187779614531566,0.9187779614531607,0,0,10.986429214477539,10.986429214477539,1,1
1237,2,10.023489027518472,10.023489027518456,0.942185525799559,0.9421855257995617,0,0,11.569341659545898,10.986429214477539,2,2
1237,3,9.654867162923574,9.654867162923576,0.9526956314778017,0.952695631477804,0,0,11.854021072387695,10.986429214477539,3,3
1237,4,9.643067938747306,9.643067938747306,0.9535927826881082,0.9535927826881094,0,0,12.020028114318848,10.986429214477539,4,4
1237,8,8.10854257691288,8.108542666462881,0.9968369359004973,0.9968387994594756,1,1,12.568327903747559,10.986429214477539,7,7
1237,16,6.993870575062655,7.338149754556555,1.021670392094024,1.0175182400582008,5,7,13.117635726928711,10.986429214477539,11,9
1237,32,6.324368683812917,7.213735322003789,1.0280329137315536,1.0255209481032963,9,17,13.571166038513184,10.986429214477539,23,15
1237,64,4.596760482976762,7.149389852071421,1.032600704101102,1.0319635586963407,27,45,14.23609447479248,10.986429214477539,37,19
1237,128,3.3943672191519214,6.801883293803304,1.0145700200629044,1.0465112553145888,61,111,14.909187316894531,10.986429214477539,67,17
1238,1,5.2795360108889176,5.279536010888917,0.9851903715693465,0.9851903715693475,0,0,5.298765659332275,5.298765659332275,1,1
1238,2,4.676815707955452,4.676815707955452,0.9954702293315831,0.9954702293315838,0,0,6.401116371154785,5.298765659332275,2,2
1238,3,4.193619417176885,4.193619417176886,1.0036183559293306,1.0036183559293317,0,0,6.541496276855469,5.298765659332275,3,3
1238,4,3.920006071227974,3.920006071227974,1.0066725944380976,1.0066725944380983,0,0,6.656816005706787,5.298765659332275,4,4
1238,8,3.81776709627246,3.81776709627246,1.0094359672060778,1.0094359672060778,0,0,7.046623706817627,5.298765659332275,8,8
1238,16,3.3284144418293247,3.348995492575514,1.0163847313349699,1.0170348114546868,3,3,7.692822456359863,5.298765659332275,13,13
1238,32,2.789121491853259,3.1994394704715474,1.0130418764324076,1.0201778618150197,11,18,8.202655792236328,5.298765659332275,21,14
1238,64,1.8292436528682412,3.1994394704715465,1.0041431724210446,1.0201778618150197,28,50,8.8318452835083,5.298765659332275,36,14
1238,128,0.9636258262545049,3.1974154638271406,0.9988349011617148,1.0204147609099468,63,113,9.537107467651367,5.298765659332275,65,15
1239,1,6.79135660405281,6.791356604052812,0.9717160865390119,0.9717160865390133,0,0,6.844938278198242,6.844938278198242,1,1
1239,2,5.631684631880136,5.631684631880137,0.9884623907820986,0.9884623907820997,0,0,7.132968425750732,6.844938278198242,2,2
1239,3,5.429427542947543,5.429427542947543,0.9919194711547876,0.9919194711547884,0,0,7.591527462005615,6.844938278198242,3,3
1239,4,5.12506627453146,5.125066274531461,0.9963931552032088,0.9963931552032099,0,0,7.718943119049072,6.844938278198242,4,4
1239,8,4.839678373676592,4.88950591615851,1.0032311403911272,1.0021293580094297,2,2,8.067514419555664,6.844938278198242,6,6
1239,16,3.9138532916973836,4.0736433348579375,1.0149851216537147,1.0158323310509985,5,6,8.370131492614746,6.844938278198242,11,10
1239,32,3.248473315423071,3.9870006733346317,1.011774692208575,1.0187858134337167,14,20,9.109274864196777,6.844938278198242,18,12
1239,64,2.274851172381712,3.923071090299136,1.0038144960195825,1.0215932862796013,25,51,9.777368545532227,6.844938278198242,39,13
1239,128,1.2478837797135525,3.8194514690443824,1.0005547652301834,1.0257715456926872,62,110,10.525482177734375,6.844938278198242,66,18
1240,1,10.39976619565428,10.399766195654282,0.9346954586096231,0.9346954586096249,0,0,10.5847806930542,10.5847806930542,1,1
1240,2,10.216538146628038,10.216538146628038,0.9411244109140371,0.941124410914038,0,0,10.804834365844727,10.5847806930542,2,2
1240,3,9.255699308326397,9.255699308326395,0.9682943048256243,0.9682943048256243,0,0,11.09415340423584,10.5847806930542,3,3
1240,4,8.746215790588426,8.746215790588424,0.9842267292435407,0.9842267292435407,0,0,11.288718223571777,10.5847806930542,4,4
1240,8,8.29124225528002,8.291332773417079,0.9945523563194797,0.9945750428018267,1,1,11.452923774719238,10.5847806930542,7,7
1240,16,7.879274301026938,8.12671615355965,1.0001658480031905,0.9990604511876342,7,9,11.779513359069824,10.5847806930542,9,7
1240,32,7.143156056974101,7.867769996836497,1.0109959817249996,1.0100502565924663,12,22,12.209843635559082,10.5847806930542,20,10
1240,64,5.503119824585568,7.651778414652669,1.0097866386169814,1.0177502307796389,28,50,12.927364349365234,10.5847806930542,36,14
1240,128,2.7115897545853005,7.335309260529317,1.0025431987663658,1.0273775972090977,64,116,13.636591911315918,10.5847806930542,64,12
1241,1,9.192076754216496,9.192076754216497,0.9430239295277933,0.9430239295277946,0,0,9.35209846496582,9.35209846496582,1,1
1241,2,8.407756452404918,8.40775645240492,0.9598012904341675,0.959801290434169,0,0,10.071919441223145,9.35209846496582,2,2
1241,3,7.252331669635292,7.252331669635292,0.9862265789119203,0.9862265789119202,0,0,10.483209609985352,9.35209846496582,3,3
1241,4,7.069810935958529,7.06981093595853,0.9911387621688718,0.9911387621688715,0,0,10.551179885864258,9.35209846496582,4,4
1241,8,6.742057436260341,6.753120659893697,0.99919865903198,0.9988092616006624,2,2,11.006176948547363,9.35209846496582,6,6
1241,16,6.397317924428724,6.724664872396727,1.0004595560400569,0.9996266091889296,6,8,11.376192092895508,9.35209846496582,10,8
1241,32,5.58858407019136,6.598559746651138,1.0055083413708759,1.0075954620944736,14,21,11.81140422821045,9.35209846496582,18,11
1241,64,4.580399828908803,6.5443474369912655,1.0090997248140625,1.0108105563132168,29,50,12.323949813842773,9.35209846496582,35,14
1241,128,2.7149225061377855,6.196142864124338,1.0038577346993598,1.0229165168540886,62,114,12.841282844543457,9.35209846496582,66,14
1242,1,9.669038968966609,9.669038968966609,0.9484737078223319,0.948473707822333,0,0,9.787909507751465,9.787909507751465,1,1
1242,2,8.179187563245156,8.179187563245156,0.9819769956278178,0.9819769956278173,0,0,9.846412658691406,9.787909507751465,2,2
1242,3,6.8314654681969085,6.831465468196908,1.0057953873348864,1.0057953873348868,0,0,11.012441635131836,9.787909507751465,3,3
1242,4,6.817738967242392,6.817738967242392,1.0065935119478655,1.006593511947866,0,0,11.596985816955566,9.787909507751465,4,4
1242,8,6.706608796441244,6.709043354921165,1.012882841306974,1.0133416732917981,2,2,11.80122184753418,9.787909507751465,6,6
1242,16,6.646218905173924,6.708157945630579,1.012605174613227,1.0136325895413136,5,8,12.258411407470703,9.787909507751465,11,8
1242,32,5.244580118172497,6.562427227095212,1.0157634559968396,1.0201438509194487,15,24,12.944300651550293,9.787909507751465,17,8
1242,64,4.0100026540549285,6.354584753764044,1.0139085230028004,1.0278026766172952,31,55,13.554866790771484,9.787909507751465,33,9
1242,128,2.850794514388121,6.354584753764044,1.007179205387052,1.0278026766172952,60,119,14.270901679992676,9.787909507751465,68,9
1243,1,11.38589887746002,11.385898877460022,0.9229396168240016,0.9229396168240039,0,0,11.61884593963623,11.61884593963623,1,1
1243,2,10.264798797696393,10.264798797696395,0.9527018815511723,0.9527018815511742,0,0,11.698394775390625,11.61884593963623,2,2
1243,3,10.235126390922058,10.235126390922064,0.9536802584978372,0.9536802584978397,0,0,11.814421653747559,11.61884593963623,3,3
1243,4,10.189616889688148,10.189616889688152,0.9554677743004572,0.9554677743004586,0,0,11.90218448638916,11.61884593963623,4,4
1243,8,9.585235743290998,9.775371277290894,0.9685401097374658,0.9660340296929598,1,2,12.289944648742676,11.61884593963623,7,6
1243,16,8.400418356001994,9.16619364260255,0.9976069308703276,0.9892187540234283,6,8,12.657193183898926,11.61884593963623,10,8
1243,32,7.119330315475637,8.342526541590539,1.0190475737151625,1.013557766710306,14,18,13.124194145202637,11.61884593963623,18,14
1243,64,4.794978351677068,7.563811754107274,1.0208900386652004,1.0329102981349434,32,53,13.491275787353516,11.61884593963623,32,11
1243,128,2.685388345836081,7.291563041794505,1.0073224024086374,1.0415207665379635,60,112,13.883195877075195,11.61884593963623,68,16
1244,1,9.631653899769125,9.63165389976913,0.9502272446647779,0.950227244664781,0,0,9.744741439819336,9.744741439819336,1,1
1244,2,8.863423146185825,8.863423146185829,0.9703868061274921,0.9703868061274945,0,0,10.768322944641113,9.744741439819336,2,2
1244,3,8.778924321217996,8.778924321217996,0.9747245091132,0.9747245091132026,0,0,11.291650772094727,9.744741439819336,3,3
1244,4,7.864015858428924,7.864015858428924,0.9994942175243202,0.9994942175243222,0,0,11.365874290466309,9.744741439819336,4,4
1244,8,6.965184362213871,6.984931815532645,1.0214814890242188,1.0210025886577543,2,2,11.881068229675293,9.744741439819336,6,6
1244,16,6.343375129660021,6.835141595759317,1.0252036166101965,1.0256919684226862,6,9,12.621904373168945,9.744741439819336,10,7
1244,32,5.747971577935068,6.753518571214837,1.0300179014114772,1.0294842883448028,13,23,13.322349548339844,9.744741439819336,19,9
1244,64,4.652327562313176,6.719878938725261,1.0189684518144206,1.030968390005591,29,56,14.266282081604004,9.744741439819336,35,8
1244,128,2.9838323791288683,6.659481943251512,1.0095066584590096,1.0376619519018018,60,116,15.4074068069458,9.744741439819336,68,12
1245,1,8.31739289933378,8.317392899333782,0.9579324226022441,0.957932422602245,0,0,8.410487174987793,8.410487174987793,1,1
1245,2,7.198814864564775,7.198814864564775,0.9771126885814723,0.9771126885814737,0,0,8.63999080657959,8.410487174987793,2,2
1245,3,6.357717217956633,6.357717217956633,0.9949848514115462,0.9949848514115477,0,0,9.10608196258545,8.410487174987793,3,3
1245,4,6.2909508895999044,6.290950889599905,0.9952219170877258,0.9952219170877259,0,0,9.209829330444336,8.410487174987793,4,4
1245,8,5.653363167857519,5.770082813361008,1.0091088515095459,1.008700880844264,1,1,10.082526206970215,8.410487174987793,7,7
1245,16,4.910090675476164,5.045623028612313,1.0251656666300866,1.024736411519978,4,5,10.48264217376709,8.410487174987793,12,11
1245,32,4.548945480880509,5.00920675120908,1.024023824380777,1.0273594985570491,11,18,11.448184967041016,8.410487174987793,21,14
1245,64,2.8313665041545817,4.817727684572241,1.0073179034994955,1.0356526744856267,30,53,12.085893630981445,8.410487174987793,34,11
1245,128,1.9052101944732782,4.811389850040309,1.0021446532712577,1.0365429459349929,60,115,12.8607816696167,8.410487174987793,68,13
1246,1,12.493505584581651,12.493505584581651,0.9024849093236111,0.9024849093236135,0,0,12.814270973205566,12.814270973205566,1,1
1246,2,11.817680938114853,11.817680938114846,0.9287021348833383,0.9287021348833397,0,0,13.586830139160156,12.814270973205566,2,2
1246,3,11.136460644672542,11.136460644672544,0.9538105889077094,0.953810588907711,0,0,14.826610565185547,12.814270973205566,3,3
1246,4,11.049867686104452,11.049867686104452,0.955835861052302,0.9558358610523041,0,0,14.955188751220703,12.814270973205566,4,4
1246,8,9.192376475091109,9.192679444562911,1.0238641963112642,1.023791947458334,1,1,15.581332206726074,12.814270973205566,7,7
1246,16,8.775911402907498,8.869880857194126,1.0352364042993922,1.033850955587605,4,7,15.889118194580078,12.814270973205566,12,9
1246,32,7.934234844906237,8.763912512294482,1.0398870219714547,1.0367677063831788,15,20,16.284841537475586,12.814270973205566,17,12
1246,64,7.193216665885904,8.70034728432708,1.0413616977503486,1.0396806802757808,37,50,16.70867156982422,12.814270973205566,27,14
1246,128,5.123775708786529,8.566383267641031,1.029045802874343,1.0460786915646612,64,110,17.1604061126709,12.814270973205566,64,18
1247,1,9.327923878458572,9.327923878458577,0.9482761931208634,0.9482761931208659,0,0,9.452348709106445,9.452348709106445,1,1
1247,2,8.452624404963538,8.45262440496354,0.9640975880794705,0.9640975880794723,0,0,9.600621223449707,9.452348709106445,2,2
1247,3,8.06541909146163,8.06541909146163,0.9739986658502144,0.9739986658502162,0,0,10.720961570739746,9.452348709106445,3,3
1247,4,7.946133442205138,7.946133442205139,0.9782673852142701,0.9782673852142718,0,0,10.808255195617676,9.452348709106445,4,4
1247,8,7.1745655244010775,7.1848030206434546,0.9905655771619043,0.9908800998661551,2,2,11.282364845275879,9.452348709106445,6,6
1247,16,6.542528518008358,7.028441654942233,0.9969450817355114,0.9974518499617253,6,7,11.859246253967285,9.452348709106445,10,9
1247,32,5.503937871117035,7.016928982474585,0.9978111058440448,0.9987562388084037,16,22,12.246358871459961,9.452348709106445,16,10
1247,64,4.349592654559322,6.867181908437081,0.9942410798985749,1.001755218834866,28,55,12.762805938720703,9.452348709106445,36,9
1247,128,3.5012601021344576,6.8503998759339035,0.987930061426606,1.0035794730627543,60,116,13.342867851257324,9.452348709106445,68,12
1248,1,10.803362054771801,10.803362054771801,0.9244985438829422,0.924498543882945,0,0,11.039088249206543,11.039088249206543,1,1
1248,2,9.876396215284585,9.876396215284585,0.9502779468029565,0.950277946802959,0,0,11.551782608032227,11.039088249206543,2,2
1248,3,9.788958091698207,9.788958091698207,0.9541449151408484,0.9541449151408502,0,0,12.277168273925781,11.039088249206543,3,3
1248,4,9.549420939323166,9.549420939323168,0.9628186664009475,0.9628186664009495,0,0,12.582837104797363,11.039088249206543,4,4
1248,8,9.015587211676547,9.047544970807664,0.9790573540676855,0.9800659057621047,4,3,13.089693069458008,11.039088249206543,4,5
1248,16,8.438366241933133,8.663879645207427,0.9972291473650781,0.9944253247230733,7,9,13.699115753173828,11.039088249206543,9,7
1248,32,6.7942182013572445,8.406691565180731,1.0073822113767954,1.0098809363706274,12,20,14.346092224121094,11.039088249206543,20,12
1248,64,4.941710015250235,8.097560480354932,0.9985608623561483,1.0239405939201012,30,52,15.114448547363281,11.039088249206543,34,12
1248,128,2.7661260627798874,7.970644724651578,0.9952901429607559,1.03317819036937,59,114,15.8698148727417,11.039088249206543,69,14
1249,1,9.557776713453725,9.557776713453725,0.9389923689845888,0.9389923689845904,0,0,9.72613525390625,9.72613525390625,1,1
1249,2,8.407140446533308,8.407140446533308,0.9691953152848747,0.9691953152848747,0,0,10.620736122131348,9.72613525390625,2,2
1249,3,8.013753010757751,8.013753010757751,0.9809697584955834,0.9809697584955839,0,0,11.087629318237305,9.72613525390625,3,3
1249,4,7.650729769145427,7.650729769145427,0.9891198274661925,0.9891198274661914,0,0,11.090415000915527,9.72613525390625,4,4
1249,8,7.1672955082873875,7.167664455787933,1.0015218821194618,1.001528597195712,1,1,11.287999153137207,9.72613525390625,7,7
1249,16,6.04134921956907,6.356521914752784,1.0260186602333048,1.023333698950601,5,5,12.025546073913574,9.72613525390625,11,11
1249,32,5.1696579506984115,5.638322510290977,1.0375761831342372,1.0401037295322715,11,20,12.738219261169434,9.72613525390625,21,12
1249,64,3.7741135794458636,5.628489260766953,1.022835657091107,1.0410391523260358,32,51,13.237464904785156,9.72613525390625,32,13
1249,128,2.4475054900025173,5.582687615623158,1.0073875854933276,1.0454170402364502,62,109,13.72098445892334,9.72613525390625,66,19
1250,1,13.245212485539938,13.245212485539932,0.872771003341655,0.8727710033416574,0,0,13.77570629119873,13.77570629119873,1,1
1250,2,11.794272842628658,11.79427284262866,0.921942417293641,0.9219424172936412,0,0,13.912912368774414,13.77570629119873,2,2
1250,3,10.507541751080058,10.50754175108006,0.9655876664110119,0.9655876664110123,0,0,14.111254692077637,13.77570629119873,3,3
1250,4,10.307724547813777,10.307724547813777,0.9730731179842078,0.9730731179842079,0,0,14.117347717285156,13.77570629119873,4,4
1250,8,9.090766730156428,9.099315041573536,1.004489533956132,1.004546604374813,2,2,14.519234657287598,13.77570629119873,6,6
1250,16,8.21404027590416,8.384532275483629,1.0279732573171128,1.0243001481460823,3,6,14.881311416625977,13.77570629119873,13,10
1250,32,7.32936593474002,8.28071567124901,1.0315975739174563,1.0284668902599643,12,20,15.326224327087402,13.77570629119873,20,12
1250,64,6.0937574784811135,8.193239519436522,1.0275958820694453,1.0323222154865532,32,47,15.7175874710083,13.77570629119873,32,17
1250,128,4.434694443716709,8.176382814743054,1.0105914237455873,1.035441636788861,66,108,16.249134063720703,13.77570629119873,62,20
1251,1,8.032159842077967,8.032159842077968,0.9613732783395366,0.9613732783395406,0,0,8.113056182861328,8.113056182861328,1,1
1251,2,7.694229619465759,7.6942296194657605,0.9690281249178823,0.9690281249178846,0,0,8.8767728805542,8.113056182861328,2,2
1251,3,6.8002759701955116,6.8002759701955116,0.9875206113917636,0.9875206113917641,0,0,8.973671913146973,8.113056182861328,3,3
1251,4,6.341392761631795,6.341392761631795,0.9954929865231621,0.9954929865231639,0,0,9.46834945678711,8.113056182861328,4,4
1251,8,5.946846494784697,6.0614046139577225,1.0028605157675778,1.002196290073191,3,2,9.720141410827637,8.113056182861328,5,6
1251,16,5.3054667666755595,5.692201882365616,1.0149189692153198,1.0121684328757614,7,9,10.191635131835938,8.113056182861328,9,7
1251,32,4.690756290034235,5.6490908154242225,1.0101342557727044,1.0142969662284511,16,22,10.877789497375488,8.113056182861328,16,10
1251,64,3.6788774851500285,5.434234413355032,1.0092792078722963,1.023092749122303,26,52,11.437549591064453,8.113056182861328,38,12
1251,128,2.4783989955500756,5.434047525884863,1.004462573729029,1.023243730844809,64,115,12.031394958496094,8.113056182861328,64,13
1252,1,5.747282851210323,5.747282851210322,0.9853765068509888,0.9853765068509892,0,0,5.764440059661865,5.764440059661865,1,1
1252,2,4.72610462645121,4.72610462645121,0.997096017501157,0.9970960175011583,0,0,5.768397331237793,5.764440059661865,2,2
1252,3,4.654449044305948,4.654449044305948,0.9985592921918957,0.9985592921918962,0,0,5.9885029792785645,5.764440059661865,3,3
1252,4,4.649444237739426,4.649444237739427,0.9985741874872567,0.9985741874872567,0,0,6.038963794708252,5.764440059661865,4,4
1252,8,4.384069693905286,4.384069693905286,1.0023019485799378,1.0023019485799378,0,0,6.738613605499268,5.764440059661865,8,8
1252,16,3.5494594674166917,3.6425700351586716,1.0134210295060104,1.0129206230382712,4,5,7.65190315246582,5.764440059661865,12,11
1252,32,2.8886625758514057,3.6065449693840197,1.0116431648992399,1.0142860736655595,9,19,8.075800895690918,5.764440059661865,23,13
1252,64,1.7494951744022345,3.557732625775694,1.004301495104517,1.0157122573211224,31,49,8.702550888061523,5.764440059661865,33,15
1252,128,0.6570245264639824,3.5470020824590294,0.999956795432509,1.0165748227000202,65,111,9.532854080200195,5.764440059661865,63,17
1253,1,8.897763435239858,8.897763435239858,0.9534288107973341,0.9534288107973357,0,0,9.006081581115723,9.006081581115723,1,1
1253,2,7.41109604442015,7.411096044420149,0.9859191835598852,0.9859191835598854,0,0,9.118247985839844,9.006081581115723,2,2
1253,3,6.513965575479293,6.5139655754792924,1.0019146158205345,1.001914615820535,0,0,9.126745223999023,9.006081581115723,3,3
1253,4,6.4280401933597195,6.428040193359721,1.0040617689657527,1.004061768965752,0,0,9.640096664428711,9.006081581115723,4,4
1253,8,5.411850279790953,5.413677447255468,1.0213429621081365,1.0213613484650832,1,1,9.98764419555664,9.006081581115723,7,7
1253,16,4.750393424425901,4.942980789617528,1.0291111857822726,1.0281802152627662,3,5,10.1846284866333,9.006081581115723,13,11
1253,32,4.447316074337354,4.8448443566261945,1.0303190729435576,1.031716419176011,12,18,10.594992637634277,9.006081581115723,20,14
1253,64,3.6677538193139383,4.820317583632603,1.0203078432514452,1.0333643086296906,33,48,11.0352783203125,9.006081581115723,31,16
1253,128,1.7571539691192377,4.7179355452361476,1.0000102103566486,1.0367071789126756,59,107,11.710585594177246,9.006081581115723,69,21
1254,1,9.81766102922502,9.81766102922502,0.9351318561019557,0.9351318561019584,0,0,10.007302284240723,10.007302284240723,1,1
1254,2,7.758993824453599,7.7589938244536,0.9838064637447502,0.9838064637447513,0,0,10.446833610534668,10.007302284240723,2,2
1254,3,7.1795106284549295,7.1795106284549295,0.998877909106789,0.9988779091067896,0,0,11.144410133361816,10.007302284240723,3,3
1254,4,6.945188441948795,6.945188441948795,1.0018680282104573,1.0018680282104584,0,0,11.455556869506836,10.007302284240723,4,4
1254,8,6.385327184207882,6.399068408210239,1.0150640542088967,1.0151577256762074,1,1,11.562788009643555,10.007302284240723,7,7
1254,16,6.000634862728324,6.171635823045844,1.0195405211318236,1.0203080636735047,5,6,12.003735542297363,10.007302284240723,11,10
1254,32,5.396682859470493,6.1457149681511325,1.0232077725471527,1.0223339057502174,11,19,12.549226760864258,10.007302284240723,21,13
1254,64,4.060364607652267,5.817498206480768,1.0220668072490136,1.033744860884792,28,52,13.234831809997559,10.007302284240723,36,12
1254,128,2.732984764599719,5.788191813922648,1.0038557197130262,1.0354531048066709,63,113,13.960288047790527,10.007302284240723,65,15
1255,1,4.359883304706704,4.359883304706705,0.9915391093500897,0.9915391093500909,0,0,4.367440700531006,4.367440700531006,1,1
1255,2,4.021332911494889,4.021332911494889,0.9949954952229765,0.9949954952229765,0,0,4.570479393005371,4.367440700531006,2,2
1255,3,3.8210714456021404,3.821071445602141,0.9979163484591805,0.9979163484591808,0,0,4.961292743682861,4.367440700531006,3,3
1255,4,3.6585428027812474,3.658542802781247,0.999328904968978,0.9993289049689781,0,0,5.711984634399414,4.367440700531006,4,4
1255,8,3.1756144354257465,3.1788308039143303,1.004502922108936,1.0046205651959554,1,2,6.089394569396973,4.367440700531006,7,6
1255,16,2.958965917680871,3.089425965902136,1.0042053292645172,1.0066012836608962,6,7,6.664445400238037,4.367440700531006,10,9
1255,32,2.55522996839429,2.9919252055536703,1.0071265427712648,1.00976094912165,14,20,7.378109931945801,4.367440700531006,18,12
1255,64,1.7418233358671893,2.9405868483265305,1.0026052226619149,1.011324098532087,29,50,8.151533126831055,4.367440700531006,35,14
1255,128,0.7702988276074402,2.9151063893815974,0.9992004688529788,1.013384201410159,68,111,8.762582778930664,4.367440700531006,60,17
1256,1,5.959057224823205,5.959057224823205,0.9787326870933366,0.978732687093337,0,0,5.9933600425720215,5.9933600425720215,1,1
1256,2,5.130921112472766,5.130921112472766,0.9882482107882539,0.9882482107882546,0,0,6.080965995788574,5.9933600425720215,2,2
1256,3,4.599743631987152,4.599743631987151,0.9946557519989758,0.9946557519989763,0,0,7.392908573150635,5.9933600425720215,3,3
1256,4,4.592666158688566,4.592666158688565,0.9949208608730065,0.994920860873007,0,0,7.44950008392334,5.9933600425720215,4,4
1256,8,3.9788855253751563,4.078297633197121,1.0016792050089647,1.0026097911723064,3,3,7.815364360809326,5.9933600425720215,5,5
1256,16,3.5721516918538314,3.9186509106955287,1.005756435946455,1.0071842140058858,5,8,8.374658584594727,5.9933600425720215,11,8
1256,32,3.113808387372856,3.785108498460742,1.0088363040134165,1.0096457960598506,12,22,9.079511642456055,5.9933600425720215,20,10
1256,64,2.233288373372292,3.637619529024919,1.0036040511618571,1.0157897378773368,33,53,10.028667449951172,5.9933600425720215,31,11
1256,128,1.0828227384929812,3.632785831057821,0.9991661516820027,1.016315525970974,64,113,10.773579597473145,5.9933600425720215,64,15
1257,1,4.397448431318812,4.397448431318812,0.9890352597614069,0.989035259761408,0,0,4.410024642944336,4.410024642944336,1,1
1257,2,3.8057394912038767,3.8057394912038762,0.9942790001520394,0.9942790001520397,0,0,4.526524543762207,4.410024642944336,2,2
1257,3,3.5301101846249843,3.5301101846249843,0.9972281759396888,0.9972281759396897,0,0,5.555717468261719,4.410024642944336,3,3
1257,4,3.438851736895794,3.438851736895794,0.9996162665158801,0.9996162665158814,0,0,6.336629867553711,4.410024642944336,4,4
1257,8,2.7447795807336437,2.7447795807336433,1.0084604099493477,1.0084604099493475,0,0,6.783387660980225,4.410024642944336,8,8
1257,16,2.6273060098461416,2.698591215349093,1.007977924538449,1.0100141554438684,6,6,7.10142183303833,4.410024642944336,10,10
1257,32,2.204113759141831,2.6553138871634445,1.0044376134426065,1.0107567713411163,17,20,8.075284957885742,4.410024642944336,15,12
1257,64,1.5069431364388908,2.6553138871634445,1.0024586808421292,1.0107567713411163,31,52,8.766341209411621,4.410024642944336,33,12
1257,128,0.8630817489788752,2.6437567768451826,1.000025144601004,1.011692757186323,60,115,9.480450630187988,4.410024642944336,68,13
1258,1,9.039548440558766,9.039548440558768,0.9439615627145032,0.9439615627145044,0,0,9.198263168334961,9.198263168334961,1,1
1258,2,8.715265977446759,8.71526597744676,0.9558989544619119,0.9558989544619128,0,0,10.139304161071777,9.198263168334961,2,2
1258,3,8.46395880693499,8.46395880693499,0.9617625683243911,0.9617625683243911,0,0,10.228026390075684,9.198263168334961,3,3
1258,4,7.771292956863289,7.771292956863289,0.9785349027457518,0.9785349027457515,0,0,10.335351943969727,9.198263168334961,4,4
1258,8,6.953121525329733,7.092316446397779,1.0022508238208863,1.000162246284464,2,2,10.649953842163086,9.198263168334961,6,6
1258,16,6.035549484598483,6.2824366799644595,1.018753321623787,1.017836152342154,6,6,10.978397369384766,9.198263168334961,10,10
1258,32,5.242364925513191,6.191160425397994,1.01788499158476,1.019815779221802,13,19,11.581006050109863,9.198263168334961,19,13
1258,64,3.647667532743473,6.070488393171507,1.0098219092975027,1.0234082616803692,29,50,12.381723403930664,9.198263168334961,35,14
1258,128,1.8062009947782796,5.970275532486111,1.0038593421890427,1.0257214027453903,60,112,12.873038291931152,9.198263168334961,68,16
1259,1,8.234878117931242,8.234878117931245,0.9637888042381653,0.9637888042381667,0,0,8.304500579833984,8.304500579833984,1,1
1259,2,6.79681889330417,6.79681889330417,0.9849782775751674,0.9849782775751674,0,0,8.33446979522705,8.304500579833984,2,2
1259,3,6.536398202997677,6.536398202997677,0.9894404224587041,0.9894404224587044,0,0,8.925932884216309,8.304500579833984,3,3
1259,4,6.238970264210479,6.238970264210479,0.9934121399597957,0.9934121399597956,0,0,8.96234130859375,8.304500579833984,4,4
1259,8,6.0371843658332445,6.044341293952519,0.9991552147951905,0.999056892458883,2,2,9.536694526672363,8.304500579833984,6,6
1259,16,4.873847204844895,5.041897814200036,1.019809757893692,1.0187892442254618,4,7,10.118987083435059,8.304500579833984,12,9
1259,32,4.416116428748127,4.987976623676452,1.0256939733976547,1.0216101708304806,12,20,10.690184593200684,8.304500579833984,20,12
1259,64,3.119278426405132,4.899951567152412,1.0078157068556632,1.0264232249582443,33,50,11.363815307617188,8.304500579833984,31,14
1259,128,1.8764212584872106,4.892078137918947,0.9992741508954205,1.027679995964308,59,111,12.129624366760254,8.304500579833984,69,17
1260,1,9.60293943031066,9.602939430310657,0.9524862180913971,0.952486218091401,0,0,9.70486068725586,9.70486068725586,1,1
1260,2,8.256565188698657,8.256565188698657,0.9808659791346377,0.9808659791346381,0,0,9.875499725341797,9.70486068725586,2,2
1260,3,7.740082822947476,7.740082822947476,0.9935211752253774,0.9935211752253783,0,0,10.335250854492188,9.70486068725586,3,3
1260,4,7.2977530493403355,7.297753049340336,1.0047986426762283,1.0047986426762283,0,0,10.483522415161133,9.70486068725586,4,4
1260,8,6.975856854288945,6.979328065001003,1.0124551648083013,1.0126801280279503,1,1,11.091459274291992,9.70486068725586,7,7
1260,16,6.433114964539826,6.7372666186827495,1.0162553643082355,1.0189636117919074,6,6,11.654800415039062,9.70486068725586,10,10
1260,32,5.539651824392373,6.325711790599057,1.029711953820339,1.0337889487609333,14,19,12.094019889831543,9.70486068725586,18,13
1260,64,4.518822000384447,6.224934811158472,1.0292705008533,1.0386692910752713,27,49,12.930026054382324,9.70486068725586,37,15
1260,128,2.8449514056177305,6.0594037146767805,1.009738527144868,1.0475946728660372,60,113,13.825725555419922,9.70486068725586,68,15
1261,1,10.718673079492387,10.71867307949237,0.9286302873453866,0.9286302873453903,0,0,10.92026424407959,10.92026424407959,1,1
1261,2,8.682267501303816,8.682267501303816,0.9830472818950879,0.9830472818950895,0,0,11.53798770904541,10.92026424407959,2,2
1261,3,8.185022068820732,8.185022068820732,0.9949845344211241,0.9949845344211254,0,0,11.61900806427002,10.92026424407959,3,3
1261,4,8.097415393143184,8.097415393143182,0.9984247535665529,0.998424753566554,0,0,12.106616020202637,10.92026424407959,4,4
1261,8,7.234941277697891,7.267667980507285,1.0205231730545448,1.0202185181568049,2,4,12.674174308776855,10.92026424407959,6,4
1261,16,6.932098006852321,7.260813054045863,1.021933581401866,1.0206636242187488,7,9,13.381857872009277,10.92026424407959,9,7
1261,32,6.167733388116359,7.219520929013261,1.0200559418655764,1.0223508122875848,13,25,13.872878074645996,10.92026424407959,19,7
1261,64,4.990144669696774,7.192900918483515,1.0136043411630227,1.0265122285994428,32,54,14.657432556152344,10.92026424407959,32,10
1261,128,3.2501087676494107,7.177014517435659,1.0031171622586017,1.0283637399947858,63,117,15.523484230041504,10.92026424407959,65,11
1262,1,10.919309288882825,10.919309288882825,0.9336570612049251,0.9336570612049281,0,0,11.091769218444824,11.091769218444824,1,1
1262,2,9.790531471759365,9.790531471759367,0.963090629746231,0.9630906297462333,0,0,11.965354919433594,11.091769218444824,2,2
1262,3,9.609549075438617,9.609549075438617,0.9693830237385193,0.9693830237385206,0,0,12.10944652557373,11.091769218444824,3,3
1262,4,8.64411757771468,8.644286625848194,0.9917039895432656,0.9917486271735029,1,1,12.12508773803711,11.091769218444824,3,3
1262,8,7.516494261497589,7.525768914871027,1.0202445656556303,1.0200871724906913,2,2,12.632929801940918,11.091769218444824,6,6
1262,16,6.4938129532271995,6.809972048730409,1.045991950811827,1.042399421342024,5,7,13.416112899780273,11.091769218444824,11,9
1262,32,6.155916447926597,6.752598533595022,1.0475765160738726,1.0464782152651935,11,18,14.062289237976074,11.091769218444824,21,14
1262,64,4.907605648927588,6.680678591793899,1.0331564760595178,1.0506267189412024,29,47,14.75300121307373,11.091769218444824,35,17
1262,128,3.519264138249343,6.600129498845942,1.0170264215228848,1.05579161210103,60,113,15.449305534362793,11.091769218444824,68,15
1263,1,3.3113218784492515,3.3113218784492524,0.993861973276155,0.9938619732761563,0,0,3.3167617321014404,3.3167617321014404,1,1
1263,2,2.9080764801996666,2.908076480199666,0.995866630015042,0.9958666300150425,0,0,3.412712574005127,3.3167617321014404,2,2
1263,3,2.678626951412753,2.678626951412753,0.9970168649303919,0.9970168649303929,0,0,3.4297409057617188,3.3167617321014404,3,3
1263,4,2.5575588728021126,2.557558872802113,0.997963391243042,0.9979633912430441,0,0,3.6926751136779785,3.3167617321014404,4,4
1263,8,2.4771130738917075,2.557558872802113,0.9977924789270909,0.9979633912430441,4,4,3.937345027923584,3.3167617321014404,4,4
1263,16,1.889960489612357,2.2091701503988155,1.0008728298597387,1.0005199102936198,8,12,4.212585926055908,3.3167617321014404,8,4
1263,32,1.349512983446561,2.129122130262662,1.0014126686022284,1.0018643783252197,13,27,4.613852500915527,3.3167617321014404,19,5
1263,64,0.8264765952453177,2.1114437139955182,0.9997982128361363,1.002289310733693,28,58,4.97999382019043,3.3167617321014404,36,6
1263,128,0.09058713039634607,2.1086910516102275,0.9985786175088172,1.0024457644458349,69,120,5.471367835998535,3.3167617321014404,59,8
1264,1,9.562359019308666,9.56235901930867,0.9495798791228833,0.9495798791228864,0,0,9.683595657348633,9.683595657348633,1,1
1264,2,8.805740537140592,8.805740537140593,0.9647601515477298,0.9647601515477309,0,0,10.07583236694336,9.683595657348633,2,2
1264,3,8.513145899350187,8.513145899350187,0.9712740553589425,0.9712740553589438,0,0,10.337882041931152,9.683595657348633,3,3
1264,4,8.39467102468394,8.394671024683939,0.9775259876596194,0.9775259876596198,0,0,11.019291877746582,9.683595657348633,4,4
1264,8,7.085288306331676,7.085288306331675,1.0123479499448882,1.0123479499448884,0,0,11.60221004486084,9.683595657348633,8,8
1264,16,6.1426942934401305,6.967139822001817,1.0072258264083518,1.0173242740751838,4,9,12.127532005310059,9.683595657348633,12,7
1264,32,4.771883312440392,6.693955977825499,1.01401631612158,1.0281609819283473,13,19,12.726638793945312,9.683595657348633,19,13
1264,64,3.4044885424288993,6.002357546879607,1.0062095418425434,1.0376470792903738,33,55,13.365265846252441,9.683595657348633,31,9
1264,128,2.6343988131097156,5.818876849340496,1.0037778021912773,1.0448132404871946,61,114,13.92842960357666,9.683595657348633,67,14
1265,1,8.088335432450423,8.088335432450423,0.958009861563831,0.9580098615638318,0,0,8.186495780944824,8.186495780944824,1,1
1265,2,7.0474615808530885,7.047461580853089,0.9793374635421446,0.9793374635421443,0,0,8.591686248779297,8.186495780944824,2,2
1265,3,6.636318858245941,6.636318858245942,0.9886736179251171,0.9886736179251174,0,0,8.883467674255371,8.186495780944824,3,3
1265,4,6.576333269907141,6.636318858245942,0.9882511921150829,0.9886736179251174,1,1,9.590256690979004,8.186495780944824,3,3
1265,8,6.392494009933956,6.636318858245942,0.9874695023590183,0.9886736179251174,3,5,9.963181495666504,8.186495780944824,5,3
1265,16,5.853558667071763,6.455029003652046,0.9965711726987383,0.994210638036004,7,11,10.534799575805664,8.186495780944824,9,5
1265,32,4.932184139823155,6.425237389678291,1.0095046320160905,0.9970496544700198,13,24,10.870890617370605,8.186495780944824,19,8
1265,64,3.8375215478329623,5.946954540972335,1.0108694188765832,1.0145981286458179,34,53,11.345988273620605,8.186495780944824,30,11
1265,128,2.485842681526626,5.77004670230245,1.0046270248544107,1.0217816378824098,59,116,11.957602500915527,8.186495780944824,69,12
1266,1,6.970634721693376,6.970634721693375,0.9649032490123395,0.9649032490123387,0,0,7.051271915435791,7.051271915435791,1,1
1266,2,5.946061577371967,5.946061577371967,0.9831930585522656,0.9831930585522652,0,0,7.18070125579834,7.051271915435791,2,2
1266,3,5.5711606265322695,5.571160626532269,0.9868315132225569,0.9868315132225556,0,0,7.523642063140869,7.051271915435791,3,3
1266,4,5.268168591970942,5.268168591970942,0.9917367529906838,0.9917367529906826,0,0,7.57978630065918,7.051271915435791,4,4
1266,8,4.5670493767894,4.622781235856691,1.002742923994143,1.0016613939486092,2,3,7.8024139404296875,7.051271915435791,6,5
1266,16,3.958190198027034,4.222187413451662,1.0143315316305164,1.010205927928609,5,7,8.145065307617188,7.051271915435791,11,9
1266,32,3.3648510949800787,3.968525867238257,1.0149171537085124,1.0147432516296093,13,20,8.692724227905273,7.051271915435791,19,12
1266,64,2.3897269276228195,3.8823155237193085,1.0079325918855526,1.0166060713325553,30,48,9.516613960266113,7.051271915435791,34,16
1266,128,1.3307266767782224,3.8668088241898353,1.001131993054948,1.0182900238561836,65,108,10.227109909057617,7.051271915435791,63,20
1267,1,7.748500992735878,7.748500992735878,0.9573690122378774,0.9573690122378797,0,0,7.857387542724609,7.857387542724609,1,1
1267,2,6.836404307158908,6.83640430715891,0.9722347548131927,0.9722347548131942,0,0,7.87396240234375,7.857387542724609,2,2
1267,3,6.406784714532556,6.406784714532555,0.9804266424819832,0.9804266424819834,0,0,7.930971622467041,7.857387542724609,3,3
1267,4,5.748514769502815,5.776425938026178,0.99518498487796,0.9942015042562875,1,1,8.235862731933594,7.857387542724609,3,3
1267,8,5.266089877017822,5.487575069137222,1.0034450100476537,1.0005858961033778,2,3,8.774068832397461,7.857387542724609,6,5
1267,16,4.250585820000587,5.048071480387575,1.010895448621012,1.0089300969365222,6,9,9.348224639892578,7.857387542724609,10,7
1267,32,3.632546257046684,4.956345593562034,1.0149668208803972,1.0132012699159196,15,21,9.848097801208496,7.857387542724609,17,11
1267,64,2.6326123831231167,4.95351478971228,1.0073973150915292,1.0134007057373706,35,51,10.503317832946777,7.857387542724609,29,13
1267,128,1.3066863119164154,4.867909796925426,1.0019788442133462,1.0165721603101305,64,117,11.140625,7.857387542724609,64,11
1268,1,10.049779650477284,10.049779650477284,0.9221240823786726,0.9221240823786738,0,0,10.322540283203125,10.322540283203125,1,1
1268,2,9.485795674930309,9.485795674930309,0.9369201366181463,0.9369201366181471,0,0,10.721940040588379,10.322540283203125,2,2
1268,3,9.11141706332321,9.111417063323207,0.9492739768666678,0.9492739768666674,0,0,10.751547813415527,10.322540283203125,3,3
1268,4,9.024619470352437,9.024619470352437,0.9502512730978548,0.9502512730978547,0,0,10.843027114868164,10.322540283203125,4,4
1268,8,8.589576212403953,8.613264599304202,0.9596754618104498,0.9593376678478598,2,2,11.105740547180176,10.322540283203125,6,6
1268,16,8.109101267262915,8.392974308999207,0.9698010321235213,0.9666099576628455,7,10,11.319060325622559,10.322540283203125,9,6
1268,32,7.709878803699001,8.389796200666703,0.9752932808321504,0.9673737871021484,15,25,11.612701416015625,10.322540283203125,17,7
1268,64,6.7695526117078675,8.321245441626914,0.9805454740482868,0.9718507706771649,29,52,11.996810913085938,10.322540283203125,35,12
1268,128,4.98465850047216,8.110984909159503,0.982403408041343,0.9818587564497689,55,116,12.40600299835205,10.322540283203125,73,12
1269,1,9.774004928438337,9.774004928438337,0.934472778274895,0.9344727782748974,0,0,9.965911865234375,9.965911865234375,1,1
1269,2,8.861836711144033,8.861836711144035,0.965386956138928,0.9653869561389291,0,0,11.078106880187988,9.965911865234375,2,2
1269,3,8.520969470763614,8.520969470763616,0.9730829363554531,0.9730829363554543,0,0,11.08101749420166,9.965911865234375,3,3
1269,4,8.386948148382348,8.38694814838235,0.9773620340116635,0.9773620340116654,0,0,11.417068481445312,9.965911865234375,4,4
1269,8,7.621455899001293,7.700465599200636,0.9959394439337634,0.996500878672889,1,1,11.946815490722656,9.965911865234375,7,7
1269,16,6.989546843117347,7.253407363431634,1.0146296487887212,1.0157313153750662,5,6,12.563173294067383,9.965911865234375,11,10
1269,32,5.701296264703626,7.111130051011284,1.0307246805451922,1.0233512273120713,12,20,13.000141143798828,9.965911865234375,20,12
1269,64,4.568025541866384,6.8923833261178835,1.0268069140415483,1.0270353610132241,29,53,13.496156692504883,9.965911865234375,35,11
1269,128,2.3373610387409296,6.588992275417917,1.008796374782825,1.0423765316400333,58,112,14.040680885314941,9.965911865234375,70,16
1270,1,4.622609990359929,4.622609990359929,0.9939298939578103,0.9939298939578114,0,0,4.626460552215576,4.626460552215576,1,1
1270,2,4.384979571724055,4.384979571724054,0.9962739684483172,0.9962739684483182,0,0,4.725400924682617,4.626460552215576,2,2
1270,3,4.382652006880839,4.38265200688084,0.9963773968100235,0.9963773968100242,0,0,4.761448860168457,4.626460552215576,3,3
1270,4,4.306837151017362,4.306837151017362,0.9975045662364551,0.997504566236455,0,0,4.769895076751709,4.626460552215576,4,4
1270,8,4.084536689759759,4.181114440003509,0.9996618892295304,0.9986885077033215,3,3,5.190484046936035,4.626460552215576,5,5
1270,16,2.973499436941678,3.9853625313414653,0.9985379057531225,1.0008560688721913,5,11,5.43342924118042,4.626460552215576,11,5
1270,32,1.696224949162662,3.9234452861209124,1.0007977181053773,1.003123962904053,12,26,5.841310501098633,4.626460552215576,20,6
1270,64,0.8584636225317273,3.258854507233262,1.0006664775331167,1.014558740692955,29,56,6.384822845458984,4.626460552215576,35,8
1270,128,0.0685510301293053,3.258854507233262,0.9995093186233093,1.014558740692955,75,120,7.074339389801025,4.626460552215576,53,8
1271,1,7.686720840035301,7.686720840035302,0.9686195357886919,0.9686195357886925,0,0,7.744139194488525,7.744139194488525,1,1
1271,2,7.167675924500552,7.167675924500553,0.9818236330911057,0.9818236330911061,0,0,9.627471923828125,7.744139194488525,2,2
1271,3,6.625073843929978,6.625073843929979,0.9928175948272038,0.9928175948272042,0,0,9.74937629699707,7.744139194488525,3,3
1271,4,6.461459784779074,6.461459784779074,0.9972740673640919,0.9972740673640916,0,0,9.983475685119629,7.744139194488525,4,4
1271,8,5.687762309118315,5.687762309118315,1.0133314632277892,1.0133314632277894,0,0,10.558771133422852,7.744139194488525,8,8
1271,16,5.068720906678601,5.338963075296605,1.0194736507985596,1.0212575941928734,6,6,11.14846420288086,7.744139194488525,10,10
1271,32,4.069249020322597,4.951650604938102,1.0208838797575766,1.0313458316819513,14,20,11.646210670471191,7.744139194488525,18,12
1271,64,3.121974828698989,4.906640956463227,1.0168673015319412,1.0339417437152423,28,49,12.433780670166016,7.744139194488525,36,15
1271,128,1.9299554194073514,4.786177730621,1.0016389983723217,1.0390973410001234,62,111,13.038776397705078,7.744139194488525,66,17
1272,1,7.194518870837919,7.1945188708379195,0.9690232160911808,0.9690232160911816,0,0,7.255178928375244,7.255178928375244,1,1
1272,2,6.6988356180188875,6.6988356180188875,0.9790657776701603,0.9790657776701603,0,0,7.484692096710205,7.255178928375244,2,2
1272,3,6.547444500413373,6.5474445004133734,0.9831588387105596,0.9831588387105601,0,0,7.934945583343506,7.255178928375244,3,3
1272,4,6.452246763481233,6.452246763481235,0.985324628043816,0.9853246280438163,0,0,8.488311767578125,7.255178928375244,4,4
1272,8,6.113818337990137,6.113818337990137,0.9953489044987444,0.9953489044987445,0,0,8.827753067016602,7.255178928375244,8,8
1272,16,5.414276093778421,5.5556630616069205,1.001547155070127,1.0033410136267924,3,4,9.273674964904785,7.255178928375244,13,12
1272,32,4.250050377789475,5.31882897406242,1.0082825203339252,1.0075126889361519,14,19,9.618487358093262,7.255178928375244,18,13
1272,64,2.9165056220040433,5.179666335169577,1.0081872403653205,1.0112157610783852,28,52,10.04408073425293,7.255178928375244,36,12
1272,128,1.3711732143668727,5.08167131105346,0.9997076368379015,1.0146237910794311,61,113,10.50103759765625,7.255178928375244,67,15
1273,1,10.773030683448917,10.77303068344892,0.9366969199999685,0.9366969199999704,0,0,10.937551498413086,10.937551498413086,1,1
1273,2,8.705009503324463,8.705009503324465,0.9836272868807714,0.9836272868807723,0,0,11.401559829711914,10.937551498413086,2,2
1273,3,8.70414730348158,8.705009503324465,0.9835469209716529,0.9836272868807723,1,1,11.87086296081543,10.937551498413086,2,2
1273,4,8.687009635755453,8.689726811507622,0.9838344010389408,0.9839544193130849,1,1,11.892290115356445,10.937551498413086,3,3
1273,8,7.366085537092813,7.509369105471289,1.0122149169631451,1.0103622423836822,2,2,12.011358261108398,10.937551498413086,6,6
1273,16,7.298922357484139,7.451582772088875,1.0132867873574292,1.0114031722402286,5,6,12.361251831054688,10.937551498413086,11,10
1273,32,6.332993461784736,7.036765640263006,1.0285967342653062,1.0256794396359203,14,18,12.846369743347168,10.937551498413086,18,14
1273,64,4.618382462853451,6.605952115874774,1.0191032155654547,1.033375893606038,31,50,13.295027732849121,10.937551498413086,33,14
1273,128,2.326650012134647,6.456968590392729,1.0084921953215926,1.0390274530375752,60,110,13.718355178833008,10.937551498413086,68,18
1274,1,7.3460401618329865,7.3460401618329865,0.9641152616468512,0.964115261646854,0,0,7.423495292663574,7.423495292663574,1,1
1274,2,5.98528438826341,5.98528438826341,0.9912535278731198,0.9912535278731216,0,0,7.786880970001221,7.423495292663574,2,2
1274,3,5.6339122489586835,5.633912248958684,0.9963497647685828,0.9963497647685841,0,0,7.833475589752197,7.423495292663574,3,3
1274,4,5.55319616232747,5.5531961623274695,0.9984502718402928,0.998450271840293,0,0,7.982147216796875,7.423495292663574,4,4
1274,8,4.982165557222441,4.98284560789665,1.0094370897581446,1.009560731547661,1,1,9.104523658752441,7.423495292663574,7,7
1274,16,4.618404423013936,4.689678641906664,1.0155108509366055,1.0162314533039696,5,5,9.64069652557373,7.423495292663574,11,11
1274,32,3.9453137487791476,4.50522908595546,1.0160618817266975,1.0231827326178764,10,18,10.08859634399414,7.423495292663574,22,14
1274,64,2.8685648223081452,4.353808241243915,1.0102527473959806,1.0269471095507603,29,47,10.77025032043457,7.423495292663574,35,17
1274,128,1.9901711403290383,4.332730375886997,1.004573177676739,1.0284278193588365,66,113,11.619816780090332,7.423495292663574,62,15
1275,1,9.670241906663222,9.670241906663225,0.9549559761586031,0.9549559761586051,0,0,9.761259078979492,9.761259078979492,1,1
1275,2,7.614381857818394,7.614381857818394,0.9930939711845876,0.9930939711845899,0,0,10.36607551574707,9.761259078979492,2,2
1275,3,7.610667401413238,7.614381857818394,0.9929452459764756,0.9930939711845899,1,1,10.453903198242188,9.761259078979492,2,2
1275,4,7.20886235049029,7.210432238411578,0.9980269709718357,0.9981322023652085,1,1,10.478931427001953,9.761259078979492,3,3
1275,8,6.858409369077688,6.96595393828187,1.0054470501143364,1.005968345139714,3,2,11.220793724060059,9.761259078979492,5,6
1275,16,6.477916955555104,6.809932344584788,1.0178615336322352,1.01724796702171,5,6,12.175131797790527,9.761259078979492,11,10
1275,32,5.214417195251329,6.456143747864239,1.028618553175189,1.0292554903123248,14,21,12.437963485717773,9.761259078979492,18,11
1275,64,4.066351934941436,6.412542352213097,1.0158197759621332,1.031222171637641,35,51,12.942444801330566,9.761259078979492,29,13
1275,128,2.550441507801054,6.348329795298954,1.0092958365456304,1.0347462675527832,64,108,13.720610618591309,9.761259078979492,64,20
1276,1,6.451329175426353,6.451329175426354,0.9793526165868791,0.9793526165868813,0,0,6.481429576873779,6.481429576873779,1,1
1276,2,5.317406243670101,5.317406243670101,0.9945031615543891,0.9945031615543907,0,0,6.559100151062012,6.481429576873779,2,2
1276,3,4.716497645837247,4.716497645837248,1.0017873077831085,1.001787307783109,0,0,7.016781806945801,6.481429576873779,3,3
1276,4,4.683313471992709,4.683313471992709,1.0029553681676067,1.002955368167607,0,0,7.665894985198975,6.481429576873779,4,4
1276,8,4.260099723733535,4.2801924912899585,1.010037389096266,1.0106283092510513,2,2,8.355098724365234,6.481429576873779,6,6
1276,16,3.9750133244385313,4.152972520918733,1.010217501201296,1.0138844667180154,6,10,8.759001731872559,6.481429576873779,10,6
1276,32,3.2520287097310017,4.027918159787697,1.021800090943676,1.019245440404831,9,21,9.218167304992676,6.481429576873779,23,11
1276,64,2.301711650336109,3.8596405735678005,1.0128418731055926,1.0254418753099155,31,48,9.67458438873291,6.481429576873779,33,16
1276,128,1.3224484832752617,3.790476691243151,1.0040213612919253,1.0286601964392639,58,107,10.356223106384277,6.481429576873779,70,21
1277,1,10.697940357898153,10.697940357898153,0.9387096340646427,0.938709634064644,0,0,10.857565879821777,10.857565879821777,1,1
1277,2,9.244733681495735,9.244733681495736,0.971400879277595,0.9714008792775966,0,0,10.95077896118164,10.857565879821777,2,2
1277,3,8.267544958660908,8.267544958660908,0.9906791219100167,0.9906791219100156,0,0,11.34248161315918,10.857565879821777,3,3
1277,4,8.11244563901976,8.112445639019763,0.9965230484564621,0.9965230484564609,0,0,12.199819564819336,10.857565879821777,4,4
1277,8,7.859709682922163,7.865571929605315,1.0083781030002474,1.009020791437747,2,2,12.455669403076172,10.857565879821777,6,6
1277,16,7.104442278880539,7.469767703838755,1.026008647577488,1.0242969276065959,4,6,12.717202186584473,10.857565879821777,12,10
1277,32,6.452455684724287,7.133298964017699,1.0357074283516379,1.0350574419207308,15,18,13.386799812316895,10.857565879821777,17,14
1277,64,5.197643414745359,6.797253273558663,1.0367480492038736,1.0466163190605045,28,48,13.797772407531738,10.857565879821777,36,16
1277,128,2.626665399749576,6.622546349731078,1.0089658507865154,1.0510104778814666,68,111,14.242452621459961,10.857565879821777,60,17
1278,1,10.164751526207663,10.164751526207663,0.9298065812695587,0.9298065812695601,0,0,10.383258819580078,10.383258819580078,1,1
1278,2,9.075410581184515,9.075410581184515,0.9602943113126263,0.9602943113126272,0,0,10.817703247070312,10.383258819580078,2,2
1278,3,7.09249655477877,7.092496554778768,1.001837175683542,1.0018371756835422,0,0,10.857624053955078,10.383258819580078,3,3
1278,4,6.769028641668733,6.769028641668733,1.0071625786646752,1.0071625786646752,0,0,11.235326766967773,10.383258819580078,4,4
1278,8,6.558350802453419,6.607641863031563,1.0128228656464218,1.0114395222412096,2,2,11.95450210571289,10.383258819580078,6,6
1278,16,6.282524019877725,6.4949676083303896,1.0194768529987428,1.0157561861248885,6,9,12.262036323547363,10.383258819580078,10,7
1278,32,5.375329292237191,6.416862808274019,1.0315101249063452,1.0200657320272177,12,22,12.62167739868164,10.383258819580078,20,10
1278,64,4.154005338163232,6.416850830547858,1.0222808160885244,1.020077446972451,30,53,13.171037673950195,10.383258819580078,34,11
1278,128,2.2133913685089173,6.376105186707137,1.0083408987084115,1.0235565303471226,59,115,13.776102066040039,10.383258819580078,69,13
1279,1,9.237234245376994,9.237234245376994,0.9448042197699832,0.9448042197699853,0,0,9.384706497192383,9.384706497192383,1,1
1279,2,7.388761902395774,7.388761902395774,0.9895949791007697,0.9895949791007697,0,0,9.453742027282715,9.384706497192383,2,2
1279,3,6.693932904550615,6.693932904550615,1.0017074126852124,1.0017074126852135,0,0,9.978418350219727,9.384706497192383,3,3
1279,4,6.598091512423772,6.598091512423771,1.0042657662495509,1.0042657662495509,0,0,10.30250072479248,9.384706497192383,4,4
1279,8,6.075640168675694,6.106581264023646,1.0125566284546506,1.0125533352710545,1,1,10.395256042480469,9.384706497192383,7,7
1279,16,5.711216592454149,5.8588919098074745,1.0215672162829952,1.0192691960845783,5,5,10.589424133300781,9.384706497192383,11,11
1279,32,4.966459982803445,5.721253979955426,1.025873754397005,1.0221940594243535,11,19,11.045289039611816,9.384706497192383,21,13
1279,64,3.909705849487061,5.636224117534995,1.0142991561837766,1.0255733060498051,33,52,11.65440559387207,9.384706497192383,31,12
1279,128,2.2409423388809526,5.498170118170177,1.0058788976640334,1.0335869703548197,63,109,12.33034610748291,9.384706497192383,65,19
1280,1,6.792832282838767,6.792832282838767,0.979719773705598,0.9797197737055984,0,0,6.820183753967285,6.820183753967285,1,1
1280,2,5.928874214808116,5.928874214808116,0.9914334840875606,0.9914334840875614,0,0,7.125345706939697,6.820183753967285,2,2
1280,3,4.8787874922760155,4.8787874922760155,1.0004446940201686,1.0004446940201697,0,0,7.197128772735596,6.820183753967285,3,3
1280,4,4.686315619680864,4.686315619680864,1.003298680687895,1.0032986806878954,0,0,7.262486934661865,6.820183753967285,4,4
1280,8,4.142021484277405,4.142103184878033,1.0096959660107854,1.0097290193985615,1,1,7.707550048828125,6.820183753967285,7,7
1280,16,3.7200892872370805,3.958879737129357,1.0101559302463687,1.012112415575571,7,9,8.11267375946045,6.820183753967285,9,7
1280,32,3.1927578160554777,3.895167786819506,1.0107931028713781,1.0136422462273995,15,23,8.534891128540039,6.820183753967285,17,9
1280,64,2.3961134279870846,3.670540195101794,1.0052579394301586,1.0191945325316167,32,54,9.192795753479004,6.820183753967285,32,10
1280,128,1.0499772068749962,3.631380205099339,0.9984712877030202,1.0202629122214637,65,115,9.826956748962402,6.820183753967285,63,13
1281,1,4.643515552382786,4.643515552382786,0.983508210146917,0.9835082101469176,0,0,4.670811653137207,4.670811653137207,1,1
1281,2,4.14757347318225,4.147573473182251,0.9881314917453984,0.9881314917453993,0,0,4.672060966491699,4.670811653137207,2,2
1281,3,3.2259111285255426,3.225911128525542,0.9961747612522075,0.9961747612522075,0,0,4.775217533111572,4.670811653137207,3,3
1281,4,3.12805856693231,3.12805856693231,0.9969458380096947,0.996945838009695,0,0,5.431663513183594,4.670811653137207,4,4
1281,8,2.991579228163998,3.0127915000896888,0.9986834013572372,0.999557538613678,2,2,6.206759452819824,4.670811653137207,6,6
1281,16,2.3237831840565915,2.6068582889420124,1.0016460031657635,1.0040388010733718,4,8,6.715873718261719,4.670811653137207,12,8
1281,32,1.905177437060847,2.443697606021564,1.0038053787551304,1.0078136987561037,11,21,7.184299945831299,4.670811653137207,21,11
1281,64,1.450255561107435,2.4436975800487404,1.0013430660807405,1.007814669417707,33,53,7.670791149139404,4.670811653137207,31,11
1281,128,0.6962124143564243,2.397252203918296,1.0002084727846579,1.0079849778270362,58,116,8.329035758972168,4.670811653137207,70,12
1282,1,8.940131181130518,8.94013118113052,0.9584518809397025,0.9584518809397048,0,0,9.024580955505371,9.024580955505371,1,1
1282,2,8.438363908809219,8.43836390880922,0.9692893522868874,0.9692893522868885,0,0,9.594841003417969,9.024580955505371,2,2
1282,3,7.7878025907960025,7.7878025907960025,0.9886209174364846,0.9886209174364851,0,0,10.078189849853516,9.024580955505371,3,3
1282,4,7.7850255109134565,7.7850255109134565,0.9889383652013988,0.988938365201399,0,0,10.12738037109375,9.024580955505371,4,4
1282,8,6.553836530505804,6.686415843961448,1.013625364325172,1.0119379652872644,3,3,10.3668794631958,9.024580955505371,5,5
1282,16,6.039618122784925,6.23462021261762,1.0272333409204923,1.0248691028037902,6,8,10.906149864196777,9.024580955505371,10,8
1282,32,4.51530308704712,5.970316312149776,1.026648002479401,1.031256996593248,13,20,11.872793197631836,9.024580955505371,19,12
1282,64,3.0851781884651035,5.91056393131829,1.0120621892238924,1.033490076871417,30,49,12.610573768615723,9.024580955505371,34,15
1282,128,2.019883268053054,5.718274360916765,1.0044785038545911,1.0396611469967412,56,112,13.261136054992676,9.024580955505371,72,16
1283,1,5.352450630938436,5.352450630938437,0.9854839369121333,0.9854839369121351,0,0,5.369860649108887,5.369860649108887,1,1
1283,2,4.880529239163244,4.880529239163245,0.9924693644757359,0.9924693644757372,0,0,6.521393299102783,5.369860649108887,2,2
1283,3,4.553261405575574,4.553261405575574,0.9980604822730184,0.9980604822730188,0,0,6.728814601898193,5.369860649108887,3,3
1283,4,4.381471782882822,4.381471782882822,1.0010004786350797,1.0010004786350797,0,0,7.115725517272949,5.369860649108887,4,4
1283,8,3.9846195405833678,3.9846195405833673,1.010986782579294,1.0109867825792938,0,0,8.212453842163086,5.369860649108887,8,8
1283,16,3.776187749918623,3.8483763024475386,1.0115707526044764,1.0140069096862052,5,5,8.90065860748291,5.369860649108887,11,11
1283,32,2.9348297365532647,3.742231618950938,1.0126895226761927,1.0181905612511366,13,18,9.686834335327148,5.369860649108887,19,14
1283,64,2.404837872496615,3.6701634002883643,1.0045248587731084,1.0205278985694255,31,48,10.576661109924316,5.369860649108887,33,16
1283,128,1.463407446352238,3.670163240284522,1.0015275636490633,1.0205322123095242,66,112,11.663225173950195,5.369860649108887,62,16
1284,1,10.074812295983806,10.074812295983804,0.937711955352561,0.9377119553525631,0,0,10.242600440979004,10.242600440979004,1,1
1284,2,6.745711429481724,6.745711429481723,1.0049243477643135,1.0049243477643133,0,0,10.59268569946289,10.242600440979004,2,2
1284,3,6.412834584529965,6.412834584529965,1.0119234524475622,1.011923452447562,0,0,10.650996208190918,10.242600440979004,3,3
1284,4,5.9399874745831545,5.939987474583154,1.0209825660307794,1.0209825660307783,0,0,10.661530494689941,10.242600440979004,4,4
1284,8,5.923985697440316,5.923985697440316,1.0215572869259497,1.02155728692595,0,0,10.922601699829102,10.242600440979004,8,8
1284,16,5.254674348842214,5.295612458817446,1.0318907579114356,1.0321214578997582,5,5,11.342704772949219,10.242600440979004,11,11
1284,32,4.863664524044255,5.07514454300737,1.0391694463646957,1.0386980532576802,10,16,11.986272811889648,10.242600440979004,22,16
1284,64,3.9121134134923854,5.028116153386855,1.0217915218764975,1.0413192442474937,28,43,12.531572341918945,10.242600440979004,36,21
1284,128,2.362022655714505,5.02747668027709,1.0097888662220407,1.0414216840740538,65,106,13.267792701721191,10.242600440979004,63,22
1285,1,6.557241535223808,6.557241535223809,0.9736117221138763,0.9736117221138773,0,0,6.605050563812256,6.605050563812256,1,1
1285,2,5.5207923524007825,5.520792352400783,0.988563334111872,0.9885633341118729,0,0,7.306405544281006,6.605050563812256,2,2
1285,3,5.149514686549479,5.14951468654948,0.9940258675183067,0.9940258675183065,0,0,7.413082599639893,6.605050563812256,3,3
1285,4,4.365402224731837,4.392821634731608,1.0052275409796252,1.0047815876116426,1,1,7.448073387145996,6.605050563812256,3,3
1285,8,4.057654537229126,4.272148439903038,1.0096529275742248,1.0069021627423527,2,3,7.91655969619751,6.605050563812256,6,5
1285,16,3.6656371164654593,4.1312684798341,1.013129288561504,1.010223581560067,5,8,8.53555965423584,6.605050563812256,11,8
1285,32,3.2470190144826203,3.9769663074785857,1.0120235653893475,1.0159447884109862,13,21,8.978797912597656,6.605050563812256,19,11
1285,64,2.5221744796956806,3.9431623268873293,1.0026962612410646,1.0170131922690397,33,51,9.695440292358398,6.605050563812256,31,13
1285,128,1.6716774561695242,3.922907741977632,1.0014122944408632,1.018038272638145,58,111,10.16375732421875,6.605050563812256,70,17
1286,1,9.343004836591513,9.343004836591517,0.9510700502444002,0.9510700502444018,0,0,9.459556579589844,9.459556579589844,1,1
1286,2,7.604942085542528,7.60494208554253,0.9851684659422354,0.985168465942237,0,0,9.857247352600098,9.459556579589844,2,2
1286,3,6.892876072835374,6.892876072835375,0.9951950388131066,0.995195038813108,0,0,9.89319133758545,9.459556579589844,3,3
1286,4,6.7544242187947745,6.754424218794774,0.9977095094623387,0.9977095094623395,0,0,9.91616439819336,9.459556579589844,4,4
1286,8,6.677937536683824,6.68769547834136,1.0005413313765579,1.0008113991791643,1,1,10.703378677368164,9.459556579589844,7,7
1286,16,6.135832539394238,6.476644239980976,1.0077959929822473,1.0094176745729286,5,5,10.977128982543945,9.459556579589844,11,11
1286,32,5.288214167010093,6.36428263023439,1.0096824726929916,1.0138133327102903,16,21,11.468945503234863,9.459556579589844,16,11
1286,64,4.032829922641383,6.172119184285264,1.001046000362846,1.019628452956825,30,49,12.139116287231445,9.459556579589844,34,15
1286,128,3.223524409843928,6.165390488903054,0.9920924251627266,1.0200906594321977,62,113,12.728890419006348,9.459556579589844,66,15
1287,1,10.60716868347305,10.60716868347305,0.9177817711006173,0.9177817711006179,0,0,10.888846397399902,10.888846397399902,1,1
1287,2,9.789578455413576,9.78957845541361,0.9414110554090958,0.9414110554090956,0,0,11.999757766723633,10.888846397399902,2,2
1287,3,8.760688255197529,8.760688255197529,0.9777129819926305,0.9777129819926305,0,0,12.062182426452637,10.888846397399902,3,3
1287,4,8.471052211583487,8.471052211583485,0.9856797700183675,0.9856797700183676,0,0,12.141202926635742,10.888846397399902,4,4
1287,8,7.709972848634021,7.711710258651171,1.0085980902972973,1.0079229880128289,1,1,12.395700454711914,10.888846397399902,7,7
1287,16,6.727120351627902,6.9832123424139745,1.0327714774687204,1.0300649499535088,4,5,12.826863288879395,10.888846397399902,12,11
1287,32,6.1751479628577535,6.899566887019718,1.0253258791171758,1.0329437815827347,17,21,13.243770599365234,10.888846397399902,15,11
1287,64,4.4510128506429405,6.701828764578917,1.0279509900143253,1.0436970849629825,30,46,13.710762977600098,10.888846397399902,34,18
1287,128,3.1123199259713807,6.637710841298243,1.0113874829327212,1.0481464313621536,56,109,14.267012596130371,10.888846397399902,72,19
1288,1,7.967117064634206,7.9671170646342055,0.9644567658393132,0.9644567658393141,0,0,8.039689064025879,8.039689064025879,1,1
1288,2,7.237323014394988,7.237323014394988,0.980359195748787,0.9803591957487872,0,0,8.228020668029785,8.039689064025879,2,2
1288,3,6.448787893916777,6.448787893916777,0.9954226080300996,0.9954226080301003,0,0,8.794588088989258,8.039689064025879,3,3
1288,4,6.251736492242771,6.251736492242771,0.9981284559288921,0.9981284559288921,0,0,8.802240371704102,8.039689064025879,4,4
1288,8,5.988331005942537,5.992336033417644,1.0040706186455783,1.0039937669705092,3,3,9.068472862243652,8.039689064025879,5,5
1288,16,5.648974610735959,5.8392792115221095,1.0142959280338606,1.0104914785181187,6,7,9.637016296386719,8.039689064025879,10,9
1288,32,4.869494872996005,5.660455534691849,1.0145666079769056,1.0136196639495747,16,21,10.14148235321045,8.039689064025879,16,11
1288,64,3.3620277841567314,5.375748956646071,1.0083636887223142,1.0229382198278647,29,49,10.91140365600586,8.039689064025879,35,15
1288,128,2.0764981894651475,5.37033501826966,1.001568293297805,1.023674607361191,70,111,11.831939697265625,8.039689064025879,58,17
1289,1,5.94840392758234,5.94840392758234,0.9762526362087747,0.9762526362087746,0,0,5.992449760437012,5.992449760437012,1,1
1289,2,4.775510068454887,4.775510068454886,0.9989840762571477,0.9989840762571478,0,0,6.860680103302002,5.992449760437012,2,2
1289,3,4.729780398485989,4.729780398485989,0.9995222714401126,0.9995222714401127,0,0,7.121066093444824,5.992449760437012,3,3
1289,4,4.578486949765333,4.578486949765332,1.0018159816642034,1.0018159816642034,0,0,7.274477005004883,5.992449760437012,4,4
1289,8,3.886670427629328,3.9003867609412723,1.0101711098181412,1.0099989717710978,2,1,7.609988689422607,5.992449760437012,6,7
1289,16,3.4123485409083654,3.4411750564671997,1.0170511137212654,1.0166253323378183,5,4,7.84915828704834,5.992449760437012,11,12
1289,32,2.851719291810938,3.3715626060746477,1.0170768875985359,1.018906566256255,14,16,8.651776313781738,5.992449760437012,18,16
1289,64,2.10989387339146,3.272882873659521,1.0078216228535863,1.0206950219987778,29,47,9.124347686767578,5.992449760437012,35,17
1289,128,1.0779748132885911,3.2638269248999086,1.0001560350710776,1.021006674254791,65,109,9.883095741271973,5.992449760437012,63,19
1290,1,8.767246302686514,8.767246302686518,0.9429492216629685,0.9429492216629701,0,0,8.934274673461914,8.934274673461914,1,1
1290,2,8.767213654034082,8.767213654034082,0.9430127029987225,0.9430127029987241,0,0,10.123428344726562,8.934274673461914,2,2
1290,3,8.68443446574088,8.684498208043847,0.9482960212748098,0.9483763892962854,1,1,10.187820434570312,8.934274673461914,2,2
1290,4,8.448310390413491,8.448310390413491,0.9568709612883602,0.9568709612883611,0,0,10.237915992736816,8.934274673461914,4,4
1290,8,8.235027900860189,8.235330223597128,0.9635999060642334,0.963725043944222,1,1,10.441666603088379,8.934274673461914,7,7
1290,16,7.499313236838749,8.005376233582396,0.9771329629909384,0.9723473008544259,7,7,10.91954517364502,8.934274673461914,9,9
1290,32,6.738903085244444,7.78603202230304,0.977863153931243,0.9827604504783227,16,21,11.346367835998535,8.934274673461914,16,11
1290,64,5.544440675382026,7.658952015212774,0.9812295229187074,0.9867358919072914,28,52,11.991084098815918,8.934274673461914,36,12
1290,128,4.143598057684107,7.385501069825764,0.9861892123192701,0.9968916673867798,65,114,12.48936653137207,8.934274673461914,63,14
1291,1,6.551095399544964,6.551095399544964,0.974110997501021,0.974110997501022,0,0,6.598208904266357,6.598208904266357,1,1
1291,2,6.356703206421001,6.356703206421001,0.9791567704680664,0.9791567704680673,0,0,7.635643482208252,6.598208904266357,2,2
1291,3,6.223925639854747,6.223925639854749,0.984310431731022,0.9843104317310233,0,0,7.998360633850098,6.598208904266357,3,3
1291,4,5.790715202706922,5.790715202706922,0.9925670586490825,0.9925670586490826,0,0,8.139669418334961,6.598208904266357,4,4
1291,8,5.022742997904123,5.085207859498227,1.0040879344055837,1.0043469813813892,1,2,8.340799331665039,6.598208904266357,7,6
1291,16,4.48992313208951,4.720709290923702,1.0118077069189528,1.0125085281353123,3,5,8.802574157714844,6.598208904266357,13,11
1291,32,3.9621311521163314,4.3891100539335,1.0152514769507035,1.017868092635371,16,20,9.202688217163086,6.598208904266357,16,12
1291,64,3.0381647485687266,4.254239714714595,1.0125727068196873,1.021038537437245,33,49,9.878467559814453,6.598208904266357,31,15
1291,128,1.701799135841366,4.201961548276362,1.0032763019514093,1.0247223690148077,61,110,10.808415412902832,6.598208904266357,67,18
1292,1,7.852776692002668,7.852776692002671,0.9612994684123097,0.9612994684123116,0,0,7.937374591827393,7.937374591827393,1,1
1292,2,6.409239748699934,6.409239748699935,1.0007272740100723,1.0007272740100732,0,0,11.35197639465332,7.937374591827393,2,2
1292,3,5.750630192819733,5.750630192819734,1.0133194545001531,1.0133194545001547,0,0,11.504664421081543,7.937374591827393,3,3
1292,4,5.737920593270114,5.750630192819734,1.0126095943203182,1.0133194545001547,1,1,11.537631034851074,7.937374591827393,3,3
1292,8,5.253014633286568,5.451060711855297,1.0163654946571112,1.0184944782997838,2,4,12.125872611999512,7.937374591827393,6,4
1292,16,4.557193823219368,5.234501193750473,1.0195335942212604,1.0251911645388565,6,10,12.796141624450684,7.937374591827393,10,6
1292,32,4.42538687489791,5.234501193750473,1.0127214708705252,1.0251911645388565,16,26,13.41562271118164,7.937374591827393,16,6
1292,64,3.6231504475102017,5.15650701026552,1.015323920955471,1.0303652204774463,35,55,13.963350296020508,7.937374591827393,29,9
1292,128,2.0476154459397593,5.15650701026552,1.0015729813599035,1.0303652204774463,69,119,14.863669395446777,7.937374591827393,59,9
1293,1,2.868553880275038,2.868553880275038,0.9962212325939432,0.9962212325939432,0,0,2.870950222015381,2.870950222015381,1,1
1293,2,2.110048653194583,2.110048653194583,1.0002681603007308,1.000268160300731,0,0,2.889138698577881,2.870950222015381,2,2
1293,3,1.8850116132992862,1.8850116132992862,1.0010239530878728,1.0010239530878726,0,0,2.977296829223633,2.870950222015381,3,3
1293,4,1.8848430030317935,1.8848430030317938,1.0010322325683412,1.0010322325683416,0,0,3.0036027431488037,2.870950222015381,4,4
1293,8,1.7522381252728023,1.7561033540143254,1.0018005371153809,1.0017681538862608,2,2,3.0470478534698486,2.870950222015381,6,6
1293,16,1.5143459061328874,1.580750574029171,1.003729098288637,1.003168310178694,6,8,3.3722410202026367,2.870950222015381,10,8
1293,32,1.1223717789437564,1.5475906597866014,1.001406747869381,1.0034725128005741,14,21,3.8075149059295654,2.870950222015381,18,11
1293,64,0.6448643809867851,1.5439925693421175,0.9994214097203231,1.0036504554086676,33,53,4.233879566192627,2.870950222015381,31,11
1293,128,0.11439723401649694,1.5322179774407438,0.9992484295491476,1.003966958842754,69,115,4.730987071990967,2.870950222015381,59,13
1294,1,8.772898565805045,8.772898565805043,0.9642465952185088,0.964246595218509,0,0,8.838838577270508,8.838838577270508,1,1
1294,2,8.13685257394291,8.13685257394291,0.9854155601971608,0.9854155601971604,0,0,11.078645706176758,8.838838577270508,2,2
1294,3,8.039188525525148,8.039188525525148,0.9891978731755013,0.9891978731755009,0,0,11.133804321289062,8.838838577270508,3,3
1294,4,7.7102401273811045,7.7102401273811045,0.9983257118435858,0.9983257118435849,0,0,11.14171028137207,8.838838577270508,4,4
1294,8,7.032958070951897,7.1154520782827975,1.0126744358829105,1.01508579076872,1,1,12.033114433288574,8.838838577270508,7,7
1294,16,6.392158922284098,6.776062158812627,1.021470500148232,1.027502737440657,4,5,12.798521995544434,8.838838577270508,12,11
1294,32,5.287151334979201,6.647709648882787,1.0292900720048812,1.0354548588224346,11,19,13.239812850952148,8.838838577270508,21,13
1294,64,4.170939994313915,6.386402758453045,1.036347883428961,1.0467396850937754,26,45,13.816490173339844,8.838838577270508,38,19
1294,128,2.6743466434957894,6.123871796829397,1.0262570178025885,1.054857724696668,58,113,14.467412948608398,8.838838577270508,70,15
1295,1,8.287904039693075,8.287904039693077,0.964307520004571,0.9643075200045726,0,0,8.357358932495117,8.357358932495117,1,1
1295,2,7.802215001643159,7.802215001643159,0.9773363550610711,0.9773363550610721,0,0,9.429306030273438,8.357358932495117,2,2
1295,3,6.973534529275903,6.973534529275904,0.9938083884347386,0.99380838843474,0,0,9.569986343383789,8.357358932495117,3,3
1295,4,6.954244327104805,6.973534529275903,0.9929371931910124,0.99380838843474,1,1,10.077811241149902,8.357358932495117,3,3
1295,8,6.143403688653855,6.287092305057829,1.005818493104397,1.0066861098400504,3,4,10.533987045288086,8.357358932495117,5,4
1295,16,5.347053781113575,5.745289671732501,1.0181438955327626,1.0191328335162444,8,9,10.818321228027344,8.357358932495117,8,7
1295,32,4.552291892063921,5.676709493100714,1.022744233825291,1.0218693159251966,14,24,11.292601585388184,8.357358932495117,18,8
1295,64,3.30518554516803,5.482770204244579,1.0203493705192825,1.0292663039494974,31,53,11.94320297241211,8.357358932495117,33,11
1295,128,1.861162212939328,5.401966342268427,1.0079698935507984,1.0344860178747737,63,114,12.705204963684082,8.357358932495117,65,14
1296,1,8.803342403411854,8.803342403411857,0.9582635199590799,0.9582635199590825,0,0,8.890082359313965,8.890082359313965,1,1
1296,2,7.67135780616764,7.6713578061676415,0.9827581639261731,0.9827581639261753,0,0,9.471906661987305,8.890082359313965,2,2
1296,3,7.0628429786154685,7.062842978615469,0.9932214546496604,0.9932214546496623,0,0,9.580342292785645,8.890082359313965,3,3
1296,4,6.264350228858923,6.264350228858924,1.0085406125016851,1.008540612501686,0,0,9.76083755493164,8.890082359313965,4,4
1296,8,5.648507159115537,5.648507159115536,1.0209231724560195,1.02092317245602,0,0,10.351816177368164,8.890082359313965,8,8
1296,16,4.7915620005239115,5.157501524282173,1.0322167696812927,1.0302187311388185,3,6,10.720123291015625,8.890082359313965,13,10
1296,32,4.3605706740562145,4.943204048987807,1.0372775542189403,1.0366127920921684,10,19,11.237762451171875,8.890082359313965,22,13
1296,64,3.188282122374134,4.842976110874001,1.0214884515065648,1.0415195648230067,28,48,11.884251594543457,8.890082359313965,36,16
1296,128,2.203003531022757,4.8375720776448725,1.0096462811667926,1.0420874013855974,63,111,12.609787940979004,8.890082359313965,65,17
1297,1,9.972151905611375,9.972151905611375,0.9467853182996573,0.94678531829966,0,0,10.09899616241455,10.09899616241455,1,1
1297,2,9.23349015682282,9.23349015682282,0.9650224765933895,0.9650224765933908,0,0,11.061081886291504,10.09899616241455,2,2
1297,3,8.56137620485237,8.56137620485237,0.9843207546391628,0.9843207546391639,0,0,11.121761322021484,10.09899616241455,3,3
1297,4,7.647069852947885,7.647069852947886,1.0062424813674649,1.0062424813674657,0,0,11.279818534851074,10.09899616241455,4,4
1297,8,7.480237056763626,7.559339135254474,1.0100848239095916,1.010063419812103,1,1,11.810542106628418,10.09899616241455,7,7
1297,16,6.0382779961962685,6.337944165375369,1.0307188646506724,1.0345860335269035,6,9,12.009390830993652,10.09899616241455,10,7
1297,32,5.29218636432442,5.9951698441894585,1.0399554313533628,1.0435230880198003,9,20,12.282525062561035,10.09899616241455,23,12
1297,64,4.043908322852937,5.951895673884568,1.0272377989025205,1.045906702421571,30,49,13.218667984008789,10.09899616241455,34,15
1297,128,2.7364717880925946,5.91377590975374,1.015734491910149,1.0493293977009777,60,111,14.096343994140625,10.09899616241455,68,17
1298,1,8.847704155810481,8.847704155810481,0.9547434310369985,0.9547434310370009,0,0,8.95142936706543,8.95142936706543,1,1
1298,2,8.31621349051105,8.31621349051105,0.9689130191442888,0.9689130191442902,0,0,9.312776565551758,8.95142936706543,2,2
1298,3,7.3559805019082045,7.355980501908205,0.9875309768652185,0.987530976865219,0,0,9.39942455291748,8.95142936706543,3,3
1298,4,6.8667656725556006,6.8667656725556006,1.0000488484135857,1.0000488484135854,0,0,9.889214515686035,8.95142936706543,4,4
1298,8,6.375651655116282,6.444871798124965,1.0082394309951719,1.0078440374543138,3,4,10.160907745361328,8.95142936706543,5,4
1298,16,5.170732844378038,6.057055760958167,1.0203124487154147,1.0153365753134629,7,9,10.70712947845459,8.95142936706543,9,7
1298,32,4.475872458822017,5.842337523064343,1.0212786708722668,1.0223259624070575,15,22,11.432374000549316,8.95142936706543,17,10
1298,64,3.3819749473066976,5.589224504586377,1.010153981823151,1.0296500030332616,32,53,12.30712890625,8.95142936706543,32,11
1298,128,1.8977046543812925,5.536140195220435,1.0028662381598221,1.033822004301757,60,113,13.356077194213867,8.95142936706543,68,15
1299,1,8.655124886373983,8.655124886373986,0.9525861906815865,0.9525861906815889,0,0,8.767057418823242,8.767057418823242,1,1
1299,2,7.177206733581484,7.177206733581485,0.9876721706736817,0.9876721706736828,0,0,9.635045051574707,8.767057418823242,2,2
1299,3,7.032125229833176,7.032125229833176,0.9918360410626197,0.9918360410626204,0,0,9.770783424377441,8.767057418823242,3,3
1299,4,6.850630863621748,6.850630863621747,0.9958351100685843,0.9958351100685845,0,0,9.84747314453125,8.767057418823242,4,4
1299,8,5.964502782488034,5.9950424168806915,1.012886885166765,1.012769480599262,1,1,10.730738639831543,8.767057418823242,7,7
1299,16,5.174818128078271,5.643881523669252,1.024355607026882,1.0252275434289584,5,8,11.150731086730957,8.767057418823242,11,8
1299,32,4.35753610988125,5.4827284179877385,1.0279262973546783,1.0314926641187334,15,20,11.692512512207031,8.767057418823242,17,12
1299,64,3.1695028797511955,5.261691006443602,1.0157414553638364,1.0391116132665315,31,52,12.73002815246582,8.767057418823242,33,12
1299,128,2.049006238759468,5.157648219067699,1.0062468911085591,1.0431306453135445,57,113,13.534995079040527,8.767057418823242,71,15
1300,1,9.951285268162152,9.951285268162152,0.9392690302550486,0.939269030255049,0,0,10.118802070617676,10.118802070617676,1,1
1300,2,8.925749613492151,8.925749613492153,0.9655689346489942,0.9655689346489937,0,0,10.279167175292969,10.118802070617676,2,2
1300,3,8.387407257529814,8.387407257529814,0.9753389810685058,0.9753389810685061,0,0,10.302346229553223,10.118802070617676,3,3
1300,4,6.902677739081951,6.90267773908195,1.0073929605963248,1.0073929605963248,0,0,10.92284107208252,10.118802070617676,4,4
1300,8,6.744017368281943,6.846848871843963,1.007855337471859,1.0083251861838602,2,2,11.290107727050781,10.118802070617676,6,6
1300,16,6.525368941022471,6.706772238952699,1.0110075954340034,1.0135828650120038,5,9,11.5867280960083,10.118802070617676,11,7
1300,32,6.031791573055563,6.665820240197673,1.0099981525462467,1.0164738312325203,17,22,12.026416778564453,10.118802070617676,15,10
1300,64,4.872116721833243,6.551501050335177,1.0039187597813404,1.0192116813831948,29,52,12.476700782775879,10.118802070617676,35,12
1300,128,3.4950487456424204,6.526786820571553,0.9901247584019952,1.0218583974833098,62,117,12.913751602172852,10.118802070617676,66,11
1301,1,7.267535576862088,7.267535576862088,0.966077343851851,0.9660773438518533,0,0,7.338596343994141,7.338596343994141,1,1
1301,2,7.0210246914557075,7.021024691455705,0.9710204896745396,0.9710204896745411,0,0,7.816961765289307,7.338596343994141,2,2
1301,3,6.4617794886897455,6.4617794886897455,0.9837556577021453,0.9837556577021465,0,0,7.837828159332275,7.338596343994141,3,3
1301,4,5.729094958876146,5.729094958876146,0.9948501521818699,0.9948501521818711,0,0,8.125009536743164,7.338596343994141,4,4
1301,8,5.135363427838817,5.142737276421733,1.0042126393707482,1.0042166604139693,2,2,8.790761947631836,7.338596343994141,6,6
1301,16,4.783948702962778,4.94923153746539,1.011577234134708,1.0097922925409306,5,6,9.298534393310547,7.338596343994141,11,10
1301,32,3.626423044365731,4.067560056583206,1.0178091112758916,1.0251760038656812,13,16,9.707045555114746,7.338596343994141,19,16
1301,64,2.626873040797193,4.03932200375204,1.0047541395363966,1.0265906091418462,27,43,10.273555755615234,7.338596343994141,37,21
1301,128,1.7010869270479692,4.012995277234629,1.0001779227854257,1.0283275954452986,65,108,10.977021217346191,7.338596343994141,63,20
1302,1,2.3003649279761116,2.300364927976111,0.9947929358871819,0.9947929358871831,0,0,2.306027889251709,2.306027889251709,1,1
1302,2,1.9203512771230524,1.9203512771230522,0.9974212902482165,0.9974212902482174,0,0,2.5223701000213623,2.306027889251709,2,2
1302,3,1.6294296347266088,1.6294296347266088,0.9989100978304392,0.9989100978304397,0,0,2.6351122856140137,2.306027889251709,3,3
1302,4,1.5933731775191224,1.5933731775191224,0.9994950452254551,0.9994950452254554,0,0,2.6760036945343018,2.306027889251709,4,4
1302,8,1.468579559882387,1.4834599862584685,0.9996144649358979,1.0000830789665045,2,2,2.922302007675171,2.306027889251709,6,6
1302,16,1.114876176941353,1.4337426012391596,0.9989704534062506,1.000477056138805,6,6,3.127225875854492,2.306027889251709,10,10
1302,32,0.7361964234323585,1.2823644405945687,1.0002304469733918,1.0021488547474426,17,22,3.4384076595306396,2.306027889251709,15,10
1302,64,0.43578104002941115,1.2174824687371393,0.9998263493124382,1.0029283659259374,32,54,4.060122489929199,2.306027889251709,32,10
1302,128,0.09179887463265142,1.176681331830536,0.9986484763596128,1.0037381882308956,67,114,4.582519054412842,2.306027889251709,61,14
1303,1,9.646332385258562,9.64633238525856,0.9368435971594808,0.9368435971594841,0,0,9.827810287475586,9.827810287475586,1,1
1303,2,8.574783706064661,8.574783706064661,0.9631574087362578,0.9631574087362602,0,0,10.343376159667969,9.827810287475586,2,2
1303,3,8.250177011786358,8.250177011786358,0.9723044220147774,0.9723044220147796,0,0,10.750092506408691,9.827810287475586,3,3
1303,4,8.244840125876422,8.244840125876422,0.9731439368080387,0.9731439368080399,0,0,11.011066436767578,9.827810287475586,4,4
1303,8,7.287072330111477,7.396156746135739,0.9991595030814313,0.9993615477381914,1,2,11.780248641967773,9.827810287475586,7,6
1303,16,6.438652728068695,6.591307536107523,1.0196378955024852,1.019860649541052,5,8,12.142731666564941,9.827810287475586,11,8
1303,32,5.53456074533957,6.257370825840223,1.035394636930662,1.0334189944236014,14,22,12.799480438232422,9.827810287475586,18,10
1303,64,4.486742030252339,6.108471147861677,1.0311735091928607,1.0425984665952313,31,46,13.425357818603516,9.827810287475586,33,18
1303,128,2.51676245749012,5.949247300060416,1.0049421653189254,1.048155766032211,58,107,14.170476913452148,9.827810287475586,70,21
1304,1,7.039082338446054,7.039082338446051,0.9683243914687979,0.9683243914688001,0,0,7.100587844848633,7.100587844848633,1,1
1304,2,6.174007464347117,6.174007464347117,0.9838739553617288,0.98387395536173,0,0,7.943242073059082,7.100587844848633,2,2
1304,3,5.717409944498732,5.7174099444987325,0.9918503325422878,0.9918503325422884,0,0,7.9945454597473145,7.100587844848633,3,3
1304,4,5.3701814918285695,5.370181491828569,0.9997326853720987,0.9997326853720991,0,0,9.046784400939941,7.100587844848633,4,4
1304,8,4.733459105035204,4.847916278901496,1.0114150966900226,1.0108641442347217,2,2,9.664897918701172,7.100587844848633,6,6
1304,16,4.4448908374248095,4.562125239657244,1.0145735736755412,1.01665883162652,5,8,10.316193580627441,7.100587844848633,11,8
1304,32,3.4421874562963986,4.350984183486243,1.0166311916633357,1.0218634499590307,15,21,11.083148956298828,7.100587844848633,17,11
1304,64,2.6235883601558805,4.308948947396542,1.0083612735398524,1.0242793988692371,30,52,12.027751922607422,7.100587844848633,34,12
1304,128,1.4949013701345353,4.29253529821287,0.9985852921787904,1.0260823802147738,65,116,13.149866104125977,7.100587844848633,63,12
1305,1,2.6269371685117573,2.626937168511758,0.9921501966351169,0.9921501966351182,0,0,2.638199806213379,2.638199806213379,1,1
1305,2,2.45115190165451,2.4511519016545105,0.9937523238757756,0.9937523238757764,0,0,2.785386323928833,2.638199806213379,2,2
1305,3,2.3779457504978985,2.377945750497898,0.9946919935368312,0.9946919935368314,0,0,3.112776279449463,2.638199806213379,3,3
1305,4,2.0054188787998686,2.0056319956444395,0.9986078720575282,0.9985526133897157,1,1,3.13254451751709,2.638199806213379,3,3
1305,8,1.8079216475786453,1.8230618729504022,1.0005601873948324,0.9999970760817327,2,2,3.2898812294006348,2.638199806213379,6,6
1305,16,1.5961971604159864,1.6483139816458707,1.0015843446981596,1.0011083637316385,5,8,3.6832830905914307,2.638199806213379,11,8
1305,32,1.1861505769531862,1.573157379458321,0.9995545112975112,1.0022398857506583,15,19,4.052334785461426,2.638199806213379,17,13
1305,64,0.6804368946441078,1.5063689910767735,1.000363147223006,1.0035885863504506,32,48,4.390789985656738,2.638199806213379,32,16
1305,128,0.10879709546847224,1.4712142675178292,0.9992249499407775,1.00382734971088,64,111,4.8809309005737305,2.638199806213379,64,17
1306,1,10.710821350310153,10.710821350310157,0.9390811759317719,0.9390811759317738,0,0,10.862275123596191,10.862275123596191,1,1
1306,2,9.213480563455661,9.213480563455661,0.9769997250367957,0.9769997250367969,0,0,11.083686828613281,10.862275123596191,2,2
1306,3,8.190597488787366,8.190597488787366,1.0020058079507526,1.0020058079507543,0,0,11.1936616897583,10.862275123596191,3,3
1306,4,7.475588788086581,7.475588788086582,1.0161798709497467,1.0161798709497463,0,0,11.279837608337402,10.862275123596191,4,4
1306,8,7.034079100417525,7.05004025006514,1.026942271329932,1.0273731406040802,1,1,11.989701271057129,10.862275123596191,7,7
1306,16,6.27542461374416,6.608537917602636,1.0349195161306706,1.037454479195281,7,9,12.465831756591797,10.862275123596191,9,7
1306,32,5.5116113157685485,6.0576846519649115,1.0452661383297779,1.0511117894176194,14,20,12.86984920501709,10.862275123596191,18,12
1306,64,4.044608924432387,5.703627381581053,1.0422340218199453,1.06164686009719,28,48,13.304998397827148,10.862275123596191,36,16
1306,128,2.5760128164797003,5.701707477710615,1.0133088267712316,1.0618196287414117,60,111,13.784841537475586,10.862275123596191,68,17
1307,1,4.283794753801247,4.283794753801249,0.9867275209055886,0.9867275209055906,0,0,4.302971363067627,4.302971363067627,1,1
1307,2,3.3738894210841073,3.373889421084108,0.9981015049922336,0.9981015049922354,0,0,4.549461841583252,4.302971363067627,2,2
1307,3,2.9197973975290905,2.9197973975290896,1.0015276545741714,1.0015276545741727,0,0,5.140216827392578,4.302971363067627,3,3
1307,4,2.6949983279247562,2.694998327924755,1.0040237157388965,1.0040237157388985,0,0,5.300666332244873,4.302971363067627,4,4
1307,8,2.2884501956954324,2.294329840016035,1.0091248714312537,1.009273360768501,1,1,5.726463794708252,4.302971363067627,7,7
1307,16,2.0397713787607143,2.2736500092469774,1.0066559561536625,1.0099951587695193,5,7,6.421750068664551,4.302971363067627,11,9
1307,32,1.6906111521188927,2.2497106290476783,1.0036166333720473,1.0107693391841706,15,22,7.309113502502441,4.302971363067627,17,10
1307,64,1.1364460498691304,2.235107158001528,1.0014097869353162,1.0118215456016784,30,53,8.08134937286377,4.302971363067627,34,11
1307,128,0.6842766618519076,2.1995358421393143,0.999542039511317,1.0126088721364626,65,115,8.839386940002441,4.302971363067627,63,13
1308,1,6.994431842526273,6.994431842526272,0.9730548438618364,0.9730548438618358,0,0,7.0416460037231445,7.0416460037231445,1,1
1308,2,5.421486607105211,5.421486607105211,0.9966337699659884,0.9966337699659877,0,0,7.194537162780762,7.0416460037231445,2,2
1308,3,5.250223947509172,5.250223947509172,0.9979091077084195,0.9979091077084193,0,0,7.270790100097656,7.0416460037231445,3,3
1308,4,5.13688718121493,5.13688718121493,0.9987945953680625,0.9987945953680623,0,0,7.387124538421631,7.0416460037231445,4,4
1308,8,4.995686882505121,5.1123880919675795,0.9992872225917186,0.999958194270564,2,2,8.230027198791504,7.0416460037231445,6,6
1308,16,4.393988859509271,4.5087316614603585,1.0089329157962517,1.0100134278315056,6,7,8.921039581298828,7.0416460037231445,10,9
1308,32,3.602029688617336,4.3396534603267245,1.013135090162906,1.0162444168576834,13,18,9.312468528747559,7.0416460037231445,19,14
1308,64,2.7819017957953305,4.2472018226242225,1.0065562077365315,1.0201123172397002,24,47,9.99680233001709,7.0416460037231445,40,17
1308,128,0.9451601237234489,4.20029972994008,1.0001135643053836,1.0226270094832308,61,109,10.922722816467285,7.0416460037231445,67,19
1309,1,8.185866267926523,8.185866267926524,0.9573689939480765,0.9573689939480781,0,0,8.284811019897461,8.284811019897461,1,1
1309,2,7.082176897702154,7.082176897702154,0.9821122117698151,0.9821122117698156,0,0,8.87641716003418,8.284811019897461,2,2
1309,3,6.59343386910678,6.593433869106781,0.9926625192204412,0.9926625192204415,0,0,9.23020076751709,8.284811019897461,3,3
1309,4,6.461659962057823,6.461659962057821,0.9938845236673245,0.9938845236673247,0,0,9.296601295471191,8.284811019897461,4,4
1309,8,6.375553456660677,6.375755172084332,0.9969332543194216,0.9969523061558115,1,1,9.932840347290039,8.284811019897461,7,7
1309,16,6.082234422406932,6.1446392115408175,1.0017241834046267,1.0035083962386757,5,6,11.078295707702637,8.284811019897461,11,10
1309,32,5.104094599119711,5.720009784643261,1.0136162233331607,1.0160953959756938,14,21,11.600198745727539,8.284811019897461,18,11
1309,64,3.2744798569123943,5.5621570892464485,1.010619024147096,1.0235222576299396,31,52,12.368961334228516,8.284811019897461,33,12
1309,128,2.016493906340735,5.504627153242486,1.002289637758859,1.0271859102875511,64,115,13.155862808227539,8.284811019897461,64,13
1310,1,3.5622626654114664,3.562262665411467,0.9883554480954989,0.9883554480955,0,0,3.5803449153900146,3.5803449153900146,1,1
1310,2,2.99344967689776,2.9934496768977596,0.9954444718100117,0.9954444718100126,0,0,4.532132148742676,3.5803449153900146,2,2
1310,3,2.9932497935800755,2.9932497935800755,0.99551504161161,0.995515041611611,0,0,4.532197952270508,3.5803449153900146,3,3
1310,4,2.866383246078126,2.874719742735162,0.9976148347633622,0.9978859189792683,1,1,4.754726409912109,3.5803449153900146,3,3
1310,8,2.66859256361857,2.740380850650105,0.9994067012593111,0.9998191483398824,2,2,5.039639472961426,3.5803449153900146,6,6
1310,16,2.247260630942194,2.645326859094056,0.999902882876479,1.001566768724636,6,9,5.3980631828308105,3.5803449153900146,10,7
1310,32,1.5355609774792347,2.630605342715248,0.9999450543331823,1.0017092229180669,15,24,6.049997329711914,3.5803449153900146,17,8
1310,64,1.1045700219731756,2.5866811161886756,0.9992588646214022,1.0028331560071457,31,56,6.673249244689941,3.5803449153900146,33,8
1310,128,0.45237651306043486,2.563804986258559,0.9989346916632094,1.004178914977338,69,118,7.334266662597656,3.5803449153900146,59,10
1311,1,7.527110630172536,7.527110630172535,0.958701471381576,0.9587014713815765,0,0,7.628206729888916,7.628206729888916,1,1
1311,2,6.5623971107399885,6.562397110739988,0.9768532972615502,0.9768532972615498,0,0,7.97739839553833,7.628206729888916,2,2
1311,3,6.186724078533713,6.186724078533713,0.9876513044117543,0.9876513044117525,0,0,8.81485652923584,7.628206729888916,3,3
1311,4,5.956838183429489,5.956838183429489,0.9942289425178736,0.9942289425178719,0,0,9.057687759399414,7.628206729888916,4,4
1311,8,5.571061189570081,5.57131776764123,1.0025924016125647,1.0027612220569713,1,1,9.76994800567627,7.628206729888916,7,7
1311,16,4.960265342659432,5.113475237988445,1.0148732087513797,1.0151650255623963,4,6,10.218799591064453,7.628206729888916,12,10
1311,32,4.380950737707294,4.971183135999321,1.0187277577763976,1.0190054444760697,15,19,10.912206649780273,7.628206729888916,17,13
1311,64,3.429425217250416,4.840169438237672,1.0133320878993233,1.0244113201670748,28,52,11.631682395935059,7.628206729888916,36,12
1311,128,2.3359482433303764,4.827524533545232,1.003226558671404,1.0258053082832594,55,111,12.598153114318848,7.628206729888916,73,17
1312,1,8.098426571754826,8.09842657175483,0.9581916706949442,0.9581916706949462,0,0,8.194684028625488,8.194684028625488,1,1
1312,2,7.153906734276349,7.153906734276349,0.982814743474743,0.9828147434747445,0,0,9.372276306152344,8.194684028625488,2,2
1312,3,7.089463822059026,7.089463822059027,0.9855946963627835,0.9855946963627852,0,0,9.532659530639648,8.194684028625488,3,3
1312,4,6.771709149014495,6.771709149014495,0.9954909105525613,0.9954909105525624,0,0,9.719970703125,8.194684028625488,4,4
1312,8,6.541842657645922,6.589517770733103,1.0015138170608253,1.0022641152143499,2,2,10.485352516174316,8.194684028625488,6,6
1312,16,5.843624687247215,6.559761130591346,1.006068948298978,1.0049370397343023,4,8,11.164648056030273,8.194684028625488,12,8
1312,32,4.995764331398094,6.439823070351106,1.0061104397820784,1.0132459938339864,12,20,11.694066047668457,8.194684028625488,20,12
1312,64,3.3262735449505283,5.5883757009035095,1.0154361446156275,1.037914148515368,28,49,12.368840217590332,8.194684028625488,36,15
1312,128,2.0524444676621094,5.533647525931994,1.004778336214133,1.0401887455188095,63,107,13.14433479309082,8.194684028625488,65,21
1313,1,8.756552569141753,8.756552569141757,0.9382659365966706,0.938265936596672,0,0,8.953208923339844,8.953208923339844,1,1
1313,2,8.304863023230876,8.304863023230878,0.9560655778815906,0.9560655778815914,0,0,9.924330711364746,8.953208923339844,2,2
1313,3,7.953713366219456,7.953713366219457,0.9658508539559676,0.9658508539559685,0,0,10.14323902130127,8.953208923339844,3,3
1313,4,7.793084878518076,7.793220946933214,0.9721000366162077,0.9721258013498993,1,1,10.188651084899902,8.953208923339844,3,3
1313,8,7.440357992226867,7.45953474172134,0.9812060147871101,0.981215832607815,2,3,10.710590362548828,8.953208923339844,6,5
1313,16,6.583392926541788,6.79767953202176,1.0073704150326326,1.0068027879350112,5,6,11.908896446228027,8.953208923339844,11,10
1313,32,5.086812722057427,6.299932846565697,1.0124414693262,1.0195858981589587,12,23,12.75546932220459,8.953208923339844,20,9
1313,64,3.5778724226708523,5.823472306577485,1.0082277603202854,1.0347134648900573,29,50,13.437294006347656,8.953208923339844,35,14
1313,128,2.3847684255148276,5.789496781924951,1.003985846647424,1.037100669903746,57,113,14.340672492980957,8.953208923339844,71,15
1314,1,3.771167568767597,3.7711675687675976,0.99369724041798,0.993697240417981,0,0,3.776165008544922,3.776165008544922,1,1
1314,2,2.9832014405194367,2.983201440519437,0.9999857244868721,0.9999857244868724,0,0,4.126487731933594,3.776165008544922,2,2
1314,3,2.6843948765154604,2.684394876515461,1.000930099593628,1.0009300995936277,0,0,4.1701436042785645,3.776165008544922,3,3
1314,4,2.6843170986134237,2.6843170986134237,1.0009061925012905,1.0009061925012892,0,0,4.280539035797119,3.776165008544922,4,4
1314,8,2.3016673153897074,2.3016673153897074,1.0039599990794867,1.003959999079486,0,0,4.500131607055664,3.776165008544922,8,8
1314,16,2.0847687283021297,2.1463938123410107,1.0047240976758303,1.0058012333043505,4,8,4.926913261413574,3.776165008544922,12,8
1314,32,1.6825364556778482,2.0967131915187918,1.0034756399754956,1.0072211857648037,13,21,5.331816673278809,3.776165008544922,19,11
1314,64,0.8758299644475467,2.060871359257467,1.0010742102709005,1.0075613309296836,30,51,5.893670558929443,3.776165008544922,34,13
1314,128,0.12350192107663761,2.0256806749012157,0.9997603172679115,1.0085636612976105,63,113,6.527350902557373,3.776165008544922,65,15
1315,1,7.362817659157866,7.362817659157868,0.9693485250951668,0.9693485250951682,0,0,7.421238899230957,7.421238899230957,1,1
1315,2,6.471235436673983,6.471235436673984,0.9860943386759181,0.9860943386759194,0,0,7.649763107299805,7.421238899230957,2,2
1315,3,6.002491512813428,6.002491512813427,0.9925872087191199,0.9925872087191212,0,0,7.725596904754639,7.421238899230957,3,3
1315,4,5.45976571133571,5.45976571133571,0.998982032591323,0.998982032591324,0,0,7.765588760375977,7.421238899230957,4,4
1315,8,4.308530434926128,4.548958237691417,1.0164924327284877,1.0138345304821128,2,2,8.199018478393555,7.421238899230957,6,6
1315,16,3.8951262268831046,4.2748932680099925,1.0194687603238084,1.0177579248812494,6,11,8.723637580871582,7.421238899230957,10,5
1315,32,3.299969643479234,4.2531966580459635,1.0150414778470496,1.0188421448173317,15,21,9.36800765991211,7.421238899230957,17,11
1315,64,2.649936255586253,4.1820843891654915,1.0095510149504523,1.021736433067979,34,52,9.88984489440918,7.421238899230957,30,12
1315,128,1.55479894452861,4.084667267277314,1.002596224179396,1.0249109352359005,62,115,10.688579559326172,7.421238899230957,66,13
1316,1,9.508337182357792,9.508337182357792,0.9400361791341636,0.940036179134165,0,0,9.67918586730957,9.67918586730957,1,1
1316,2,8.941285683101386,8.941285683101384,0.9539768797782887,0.9539768797782896,0,0,10.413951873779297,9.67918586730957,2,2
1316,3,8.492655682578324,8.492655682578325,0.9697932330374384,0.9697932330374385,0,0,10.609846115112305,9.67918586730957,3,3
1316,4,8.092560541137185,8.092560541137185,0.9795025478161382,0.9795025478161392,0,0,10.95894718170166,9.67918586730957,4,4
1316,8,7.428883994592386,7.442476793917063,0.9993384708109141,0.99781474056937,1,1,11.241293907165527,9.67918586730957,7,7
1316,16,6.694215895706142,6.839082409102324,1.0147991957651283,1.0157772691959166,6,6,11.645230293273926,9.67918586730957,10,10
1316,32,5.875408968934984,6.548403047027321,1.0192701469582173,1.023970422688767,16,20,11.920187950134277,9.67918586730957,16,12
1316,64,4.973770093866899,6.517870900576805,1.0156603624100697,1.0264866597068187,31,48,12.2507963180542,9.67918586730957,33,16
1316,128,2.98140851563079,6.23816632425174,1.0084448857055153,1.0363807023302465,70,111,12.677127838134766,9.67918586730957,58,17
1317,1,10.76837548590566,10.76837548590566,0.912885968763903,0.9128859687639048,0,0,11.08588981628418,11.08588981628418,1,1
1317,2,8.816098414472933,8.816098414472934,0.9703171660845267,0.9703171660845266,0,0,11.201605796813965,11.08588981628418,2,2
1317,3,8.538499699830119,8.53849969983012,0.9774209641524008,0.9774209641524013,0,0,11.860249519348145,11.08588981628418,3,3
1317,4,8.46835940373299,8.468359403732988,0.9802049776944635,0.9802049776944632,0,0,11.894632339477539,11.08588981628418,4,4
1317,8,8.119817020282579,8.189900008454305,0.9911594314629235,0.9923045889908613,1,1,12.402541160583496,11.08588981628418,7,7
1317,16,7.544421436210018,7.7794226238937565,1.0008939791596234,1.0023832463191211,5,8,12.895087242126465,11.08588981628418,11,8
1317,32,5.645475239511608,7.509264611880447,1.0234753590139816,1.0148112210960853,13,20,13.395631790161133,11.08588981628418,19,12
1317,64,4.662212950246695,7.000128985943775,1.021722083820582,1.0371186289003411,29,52,14.014382362365723,11.08588981628418,35,12
1317,128,2.8665386431743856,6.6610713982592396,1.0091548382930005,1.04886062727311,65,111,14.64696979522705,11.08588981628418,63,17
1318,1,8.337858695069915,8.337858695069915,0.9630275686559091,0.9630275686559089,0,0,8.41238021850586,8.41238021850586,1,1
1318,2,7.756806507768675,7.756806507768674,0.9741145208105357,0.9741145208105354,0,0,8.756077766418457,8.41238021850586,2,2
1318,3,6.979038513818472,6.979038513818471,0.9877150386521173,0.9877150386521161,0,0,8.790392875671387,8.41238021850586,3,3
1318,4,6.864755822295336,6.864755822295336,0.9892644974669949,0.989264497466994,0,0,8.797375679016113,8.41238021850586,4,4
1318,8,6.45974326347395,6.459743263473949,0.9961305305041397,0.9961305305041416,0,0,8.98232364654541,8.41238021850586,8,8
1318,16,5.580549218597693,5.711153895153192,1.010698422460531,1.009952574714819,5,8,9.711183547973633,8.41238021850586,11,8
1318,32,5.147088481423694,5.547094973832368,1.0129016587187603,1.0175338552730908,14,18,10.325751304626465,8.41238021850586,18,14
1318,64,3.1574836223918146,5.296994062270952,1.00597345563099,1.024632793427578,32,51,10.892364501953125,8.41238021850586,32,13
1318,128,1.8326430918831087,5.259594707427184,1.0027390191555663,1.0272628149757947,57,113,11.522994041442871,8.41238021850586,71,15
1319,1,6.271050210391075,6.271050210391077,0.9804797561207734,0.9804797561207746,0,0,6.298858165740967,6.298858165740967,1,1
1319,2,4.971065064146693,4.971065064146692,0.9980815496434061,0.9980815496434063,0,0,6.644122123718262,6.298858165740967,2,2
1319,3,4.437457760055442,4.437457760055441,1.0049747917979286,1.0049747917979288,0,0,6.803465366363525,6.298858165740967,3,3
1319,4,4.318070600738816,4.318070600738816,1.0056541871735598,1.0056541871735603,0,0,6.8278937339782715,6.298858165740967,4,4
1319,8,4.171025681111083,4.1745080423386645,1.008634955465909,1.0083877663282899,1,1,7.17913293838501,6.298858165740967,7,7
1319,16,3.5108385928422106,3.6705577148079414,1.0130106818824227,1.0150256040245083,4,5,7.930201053619385,6.298858165740967,12,11
1319,32,2.8438119883914714,3.582490844549372,1.0121120102038852,1.0170055511106109,12,18,8.398059844970703,6.298858165740967,20,14
1319,64,1.9686374068336316,3.5204953365546205,1.0037756040809542,1.018332985324486,29,46,9.098442077636719,6.298858165740967,35,18
1319,128,1.1894851043766623,3.5031407901827794,1.0005986760333618,1.0199409613367374,56,108,9.77060604095459,6.298858165740967,72,20
1320,1,8.995007515805764,8.995007515805767,0.9531870370412525,0.9531870370412547,0,0,9.102057456970215,9.102057456970215,1,1
1320,2,7.234131454099417,7.2341314540994155,0.9909089152003377,0.9909089152003395,0,0,9.24557113647461,9.102057456970215,2,2
1320,3,6.57259972896762,6.57259972896762,1.0017874623132006,1.0017874623132013,0,0,9.873080253601074,9.102057456970215,3,3
1320,4,5.9055514589238,5.9055514589237985,1.015266352678423,1.0152663526784234,0,0,10.2604398727417,9.102057456970215,4,4
1320,8,5.770957605570236,5.865915071292192,1.017720451961253,1.0176970804071583,1,2,11.42706298828125,9.102057456970215,7,6
1320,16,5.30435857548895,5.586218060901036,1.0271897143408322,1.027728778367165,4,7,11.898993492126465,9.102057456970215,12,9
1320,32,4.948382630292612,5.500667349771684,1.0263846955026392,1.0320971052930612,14,21,12.614496231079102,9.102057456970215,18,11
1320,64,4.05183940916457,5.413588749899333,1.0214353077084923,1.036847566204059,30,51,13.370932579040527,9.102057456970215,34,13
1320,128,2.506810541830187,5.397630790417342,1.0048207048074007,1.03945021263849,68,115,14.0899019241333,9.102057456970215,60,13
1321,1,7.977020456926502,7.977020456926501,0.963248526336771,0.9632485263367738,0,0,8.052611351013184,8.052611351013184,1,1
1321,2,7.2552083329992465,7.2552083329992465,0.9766127874765935,0.9766127874765959,0,0,8.15891170501709,8.052611351013184,2,2
1321,3,6.046208849176597,6.046208849176597,0.9953422551091926,0.9953422551091929,0,0,8.166571617126465,8.052611351013184,3,3
1321,4,6.009348705625614,6.009348705625613,0.9956604111587055,0.9956604111587055,0,0,8.397833824157715,8.052611351013184,4,4
1321,8,4.372246391161962,4.372246391161962,1.0168275261611746,1.016827526161174,0,0,8.761401176452637,8.052611351013184,8,8
1321,16,4.100672143657035,4.1709664985495705,1.020834470857055,1.0217638683847183,3,6,8.995870590209961,8.052611351013184,13,10
1321,32,3.3630265475321814,3.9384689971466895,1.022558082586214,1.0254695394573126,15,21,9.406893730163574,8.052611351013184,17,11
1321,64,2.46853369800477,3.8988529598020736,1.0114273723992488,1.0264768756596847,34,51,9.930864334106445,8.052611351013184,30,13
1321,128,1.3431516461336648,3.898852959802074,1.0026497623306874,1.0264768756596847,64,115,10.664559364318848,8.052611351013184,64,13
1322,1,9.831195869487717,9.831195869487718,0.9400730099424934,0.9400730099424954,0,0,9.986868858337402,9.986868858337402,1,1
1322,2,8.685594943492598,8.685594943492598,0.9705215270709582,0.9705215270709591,0,0,10.723394393920898,9.986868858337402,2,2
1322,3,8.475447260503898,8.685594943492598,0.9694143614917698,0.9705215270709591,1,1,11.940707206726074,9.986868858337402,2,2
1322,4,8.08009442963304,8.226076221690516,0.9814963894788769,0.9833544563026229,1,1,12.290270805358887,9.986868858337402,3,3
1322,8,7.854539043013252,8.187000056435462,0.9877963971619714,0.9864485974370948,3,4,13.326844215393066,9.986868858337402,5,4
1322,16,6.848107761607763,7.987854361579224,1.0035877977416163,0.9973409242015218,5,10,13.64830207824707,9.986868858337402,11,6
1322,32,5.86776741662818,7.661866021522482,1.0000067758157698,1.009127273903595,16,24,14.247220039367676,9.986868858337402,16,8
1322,64,4.518019169689172,7.351049603504549,1.0126764821563312,1.0194081577901302,28,52,14.760412216186523,9.986868858337402,36,12
1322,128,3.035315972893295,6.833157730479155,1.002378567409051,1.0305520690379404,61,119,15.398628234863281,9.986868858337402,67,9
1323,1,8.403481041630071,8.403481041630075,0.9631646295622802,0.9631646295622823,0,0,8.47620964050293,8.47620964050293,1,1
1323,2,7.625893457090836,7.625893457090837,0.9767266735952631,0.9767266735952634,0,0,8.79697322845459,8.47620964050293,2,2
1323,3,6.766703278227622,6.766703278227621,0.9922093968486849,0.9922093968486843,0,0,9.444840431213379,8.47620964050293,3,3
1323,4,6.3984822691654175,6.3984822691654175,1.0001888781395714,1.0001888781395714,0,0,9.743061065673828,8.47620964050293,4,4
1323,8,5.600352532184485,5.77781829841243,1.0111749691980307,1.0130983861334206,3,3,10.680893898010254,8.47620964050293,5,5
1323,16,5.095180747534413,5.568438979972521,1.0155920154382783,1.0190466157088611,5,9,11.356817245483398,8.47620964050293,11,7
1323,32,3.9829689613462875,5.487677213289937,1.0173427921742255,1.0253011466973105,12,23,12.291645050048828,8.47620964050293,20,9
1323,64,3.000734807822502,5.4572007174076385,1.0060166229713623,1.0269428426294567,31,51,13.130687713623047,8.47620964050293,33,13
1323,128,2.1311456449123027,5.44465572106477,1.0033440778892289,1.028314113532724,63,114,14.130796432495117,8.47620964050293,65,14
1324,1,8.615187736361618,8.61518773636162,0.9569322420274113,0.9569322420274121,0,0,8.711357116699219,8.711357116699219,1,1
1324,2,7.523342112687379,7.523342112687378,0.9760586069286742,0.9760586069286745,0,0,9.677511215209961,8.711357116699219,2,2
1324,3,7.483238875005847,7.483238875005849,0.9781166885186087,0.9781166885186092,0,0,10.171682357788086,8.711357116699219,3,3
1324,4,7.232873894376096,7.232873894376097,0.9866876921984462,0.9866876921984469,0,0,10.423674583435059,8.711357116699219,4,4
1324,8,6.163839574631265,6.430167570133681,1.0011273095876105,1.002988427561179,2,3,10.843469619750977,8.711357116699219,6,5
1324,16,5.967228255591814,6.380674433307268,1.000781577162342,1.0063133498659858,7,8,11.559001922607422,8.711357116699219,9,8
1324,32,4.815287598540951,6.255916630157727,1.0095470842493088,1.0118424818239302,15,21,12.20745849609375,8.711357116699219,17,11
1324,64,3.389602529988763,6.160645143179337,1.0038797373047739,1.0182128088135016,27,51,12.692524909973145,8.711357116699219,37,13
1324,128,1.9777321110148351,6.144347196705243,0.9999684328417442,1.0189736621438792,62,115,13.222959518432617,8.711357116699219,66,13
1325,1,8.928335514402791,8.928335514402793,0.9540138963086772,0.9540138963086789,0,0,9.032111167907715,9.032111167907715,1,1
1325,2,8.193852701723355,8.193852701723355,0.9701156385864456,0.9701156385864462,0,0,9.568570137023926,9.032111167907715,2,2
1325,3,7.435378477852009,7.435378477852009,0.9875177099979782,0.9875177099979793,0,0,9.907832145690918,9.032111167907715,3,3
1325,4,7.051521321876564,7.051521321876564,0.9943187338502074,0.9943187338502085,0,0,10.057029724121094,9.032111167907715,4,4
1325,8,6.3066275674274985,6.314259738376696,1.007146338142469,1.0070825342760024,1,1,10.31453800201416,9.032111167907715,7,7
1325,16,5.567787147598004,5.7029684720102845,1.0296973975679413,1.0278503088343176,4,5,11.114571571350098,9.032111167907715,12,11
1325,32,4.870674566465705,5.666294361761391,1.0283862750134436,1.0293605821520502,10,21,11.583372116088867,9.032111167907715,22,11
1325,64,3.780587605303483,5.454384278224058,1.0210694651805157,1.0379069753053043,26,49,12.216021537780762,9.032111167907715,38,15
1325,128,2.423102086228212,5.3989917165173225,1.008964552398294,1.042216113555564,62,112,12.991029739379883,9.032111167907715,66,16
1326,1,7.34082730657082,7.340827306570821,0.9693666473571213,0.9693666473571242,0,0,7.39750337600708,7.39750337600708,1,1
1326,2,6.484388845249431,6.484388845249432,0.9869905548870485,0.9869905548870499,0,0,9.05075454711914,7.39750337600708,2,2
1326,3,6.152045193101793,6.1520451931017925,0.9949915697757438,0.994991569775745,0,0,9.607956886291504,7.39750337600708,3,3
1326,4,6.150000720153695,6.150000720153695,0.9949913144627378,0.994991314462739,0,0,9.674792289733887,7.39750337600708,4,4
1326,8,5.346178120048189,5.372689078389821,1.0100360086493512,1.0094863341886489,2,1,10.09310531616211,7.39750337600708,6,7
1326,16,4.570640248482759,5.249955439666539,1.0156203799011128,1.0152405006735525,3,9,10.600848197937012,7.39750337600708,13,7
1326,32,4.022164071157765,4.812999195791886,1.0177468346005205,1.0206401784261014,12,24,11.17298698425293,7.39750337600708,20,8
1326,64,3.208831356126887,4.768734289562184,1.006139825361739,1.021690793529003,32,55,12.00592041015625,7.39750337600708,32,9
1326,128,1.5479966864788421,4.7675501639357885,0.9989634689478648,1.0222413481801405,66,118,12.936718940734863,7.39750337600708,62,10
1327,1,9.654309216345986,9.654309216345988,0.9416278824894454,0.9416278824894484,0,0,9.809041023254395,9.809041023254395,1,1
1327,2,8.419606320856966,8.419606320856968,0.972531856315614,0.9725318563156158,0,0,9.935768127441406,9.809041023254395,2,2
1327,3,7.0257632318590595,7.0257632318590595,0.9971986268471869,0.9971986268471889,0,0,10.021835327148438,9.809041023254395,3,3
1327,4,6.850448520226587,6.850448520226587,1.000863231438986,1.0008632314389883,0,0,10.141525268554688,9.809041023254395,4,4
1327,8,6.430762420077099,6.43275191019219,1.0115132546324777,1.0113434875481997,1,1,11.029412269592285,9.809041023254395,7,7
1327,16,6.178869896401116,6.358648746538528,1.0150262960863585,1.0133811982234378,3,7,11.726845741271973,9.809041023254395,13,9
1327,32,5.395009282716865,5.928542037902974,1.0279561500017973,1.0265410428774568,12,18,12.128173828125,9.809041023254395,20,14
1327,64,4.459555914532338,5.801895157808593,1.0296652768924033,1.0327412254485995,27,45,12.75568962097168,9.809041023254395,37,19
1327,128,2.9526612275879756,5.580631675222006,1.0130958998500135,1.0427609610618165,58,108,13.64321517944336,9.809041023254395,70,20
1328,1,8.225273924002767,8.22527392400277,0.963103904687126,0.9631039046871274,0,0,8.298358917236328,8.298358917236328,1,1
1328,2,7.416226602721695,7.416226602721695,0.982361609412693,0.9823616094126931,0,0,9.829399108886719,8.298358917236328,2,2
1328,3,6.190548565935611,6.190548565935611,0.9997189663751269,0.9997189663751267,0,0,9.89099407196045,8.298358917236328,3,3
1328,4,5.936312119522792,5.9363121195227935,1.005863917237727,1.0058639172377264,0,0,10.096701622009277,8.298358917236328,4,4
1328,8,5.6841010280033295,5.725632207089716,1.0106030035849558,1.0112433478927014,2,2,11.048949241638184,8.298358917236328,6,6
1328,16,5.264095324557138,5.496205261844018,1.0183815205295526,1.0184443300971118,7,9,11.342056274414062,8.298358917236328,9,7
1328,32,4.716848484100114,5.226251273776876,1.0247581551258116,1.028515856615168,12,21,11.894943237304688,8.298358917236328,20,11
1328,64,3.6522346541051,5.149518481326688,1.0165812544098505,1.0316577506968387,30,48,12.428712844848633,8.298358917236328,34,16
1328,128,2.08917977738369,5.131696540876328,1.0066050174119598,1.033594775095706,60,109,13.065934181213379,8.298358917236328,68,19
1329,1,10.110186835586266,10.110186835586267,0.9393491857127062,0.939349185712708,0,0,10.269224166870117,10.269224166870117,1,1
1329,2,8.602337951737622,8.602337951737622,0.9788887772032695,0.9788887772032702,0,0,10.837530136108398,10.269224166870117,2,2
1329,3,8.245611029762076,8.245611029762074,0.9898102090880587,0.9898102090880592,0,0,10.903491020202637,10.269224166870117,3,3
1329,4,7.965806876013793,7.965806876013793,0.997387013158358,0.9973870131583583,0,0,10.907670974731445,10.269224166870117,4,4
1329,8,7.2398804759449,7.263789709884549,1.0154535872873605,1.0136436830749007,2,2,11.291586875915527,10.269224166870117,6,6
1329,16,6.564420556443755,6.869305293734616,1.0269316662229664,1.0205240058011171,3,6,11.626031875610352,10.269224166870117,13,10
1329,32,5.577511945951884,6.489997041968987,1.0247102295439623,1.0259134924009317,12,21,12.118637084960938,10.269224166870117,20,11
1329,64,3.97639632847131,6.334272630054862,1.0189039481376332,1.031873271825539,29,49,12.820466041564941,10.269224166870117,35,15
1329,128,2.0564815615320757,6.2653490707048025,1.0029221000646582,1.0351931855268584,61,110,13.504247665405273,10.269224166870117,67,18
1330,1,5.387670077812011,5.387670077812012,0.9800134030042025,0.9800134030042035,0,0,5.421142578125,5.421142578125,1,1
1330,2,4.852236857442386,4.852236857442386,0.9895412643820694,0.9895412643820694,0,0,6.421596527099609,5.421142578125,2,2
1330,3,4.413761022118543,4.413761022118543,0.9973751471134233,0.9973751471134241,0,0,7.245481491088867,5.421142578125,3,3
1330,4,4.260555993918951,4.260555993918951,0.9993389814643191,0.9993389814643189,0,0,7.541784763336182,5.421142578125,4,4
1330,8,4.0962599088687055,4.0987795046558935,1.0022756800710653,1.002637013660547,1,2,8.119962692260742,5.421142578125,7,6
1330,16,3.5285704630509422,3.786701958127803,1.0066928300470779,1.0107083414732072,5,6,8.679679870605469,5.421142578125,11,10
1330,32,3.1796847923210527,3.7765191962899687,1.004686626597609,1.0117808596605098,13,19,9.265908241271973,5.421142578125,19,13
1330,64,2.6637528698219035,3.638143018048823,1.0000773228910802,1.016221100602357,33,50,9.838229179382324,5.421142578125,31,14
1330,128,2.048999572506954,3.630496495443375,0.9929427138393433,1.0162151274694236,64,111,10.692757606506348,5.421142578125,64,17
1331,1,3.090645529935247,3.0906455299352475,0.9896328020364794,0.9896328020364804,0,0,3.107353687286377,3.107353687286377,1,1
1331,2,2.8803952270069235,2.8803952270069235,0.9917507621495705,0.9917507621495707,0,0,3.462385416030884,3.107353687286377,2,2
1331,3,2.4864795642188855,2.4864795642188855,0.9952967694865484,0.9952967694865489,0,0,3.4805729389190674,3.107353687286377,3,3
1331,4,2.4362245155787514,2.4362245155787514,0.995273714198863,0.9952737141988629,0,0,3.556365489959717,3.107353687286377,4,4
1331,8,2.2319505391872188,2.2643350347511926,0.9965799667945534,0.996239447188706,1,2,3.801561117172241,3.107353687286377,7,6
1331,16,2.0639111281656137,2.2102126356680976,0.9975864355906132,0.9967947152423314,7,8,4.189901351928711,3.107353687286377,9,8
1331,32,1.4048006767533139,2.1758410417631797,0.9967339858185529,0.9972007978214122,11,24,4.4828691482543945,3.107353687286377,21,8
1331,64,1.160989105750936,2.1400447248783285,0.9956062763403584,0.9985347492859282,33,52,4.790599346160889,3.107353687286377,31,12
1331,128,0.6269951186401643,2.1103851998905725,0.9960444521362524,0.9997775340060275,66,112,5.263599872589111,3.107353687286377,62,16
1332,1,8.95720885287808,8.95720885287808,0.955489906628533,0.9554899066285338,0,0,9.055917739868164,9.055917739868164,1,1
1332,2,7.472052883566098,7.472052883566098,0.9821903097905667,0.9821903097905663,0,0,9.122411727905273,9.055917739868164,2,2
1332,3,7.243295431462373,7.243295431462373,0.9864140295577821,0.9864140295577809,0,0,9.247001647949219,9.055917739868164,3,3
1332,4,5.656997042037845,5.656997042037847,1.0136169155311787,1.0136169155311776,0,0,10.09457778930664,9.055917739868164,4,4
1332,8,5.359210324071043,5.40852437121371,1.019038892242679,1.0190548829190729,1,1,10.577754974365234,9.055917739868164,7,7
1332,16,5.229829704853981,5.356110863643056,1.02126597229556,1.0217330706253742,5,6,10.990096092224121,9.055917739868164,11,10
1332,32,4.557141562844996,5.295358162382545,1.0246845558329034,1.0236193762772188,11,20,11.428807258605957,9.055917739868164,21,12
1332,64,3.355437226055929,5.252873380556402,1.0098645452564854,1.0254969472956925,31,50,12.000449180603027,9.055917739868164,33,14
1332,128,2.1946233828679507,5.1434563608067005,1.0019485252765488,1.0300626453203718,55,113,12.554336547851562,9.055917739868164,73,15
1333,1,8.236338058430714,8.236338058430716,0.9643045146571819,0.9643045146571837,0,0,8.306796073913574,8.306796073913574,1,1
1333,2,6.2857115480027534,6.2857115480027534,0.9975300158675187,0.9975300158675204,0,0,8.43759536743164,8.306796073913574,2,2
1333,3,6.1540249526764805,6.154024952676481,0.9990153378367146,0.9990153378367147,0,0,8.684401512145996,8.306796073913574,3,3
1333,4,6.150510818721863,6.1505108187218624,0.9990954091710028,0.999095409171003,0,0,9.279707908630371,8.306796073913574,4,4
1333,8,5.270125883394643,5.349699325265944,1.013411017829939,1.011918675295589,2,3,9.422182083129883,8.306796073913574,6,5
1333,16,4.582876336013296,4.926185882481417,1.0210684538350323,1.0182506932779387,6,7,10.16600227355957,8.306796073913574,10,9
1333,32,4.1271103894233,4.779808989147319,1.0170748031246153,1.0220672934032842,15,20,10.839787483215332,8.306796073913574,17,12
1333,64,2.8946308526494136,4.6265850936608395,1.0114118208057779,1.028580615548113,29,49,11.45154857635498,8.306796073913574,35,15
1333,128,1.8856575084594218,4.416426510927591,1.0067159227263458,1.0332830206180477,66,110,11.92269515991211,8.306796073913574,62,18
1334,1,8.822366521230508,8.822366521230508,0.9488600004741541,0.9488600004741551,0,0,8.952384948730469,8.952384948730469,1,1
1334,2,6.920067870476816,6.920067870476817,0.9837384072190523,0.9837384072190529,0,0,9.207159042358398,8.952384948730469,2,2
1334,3,6.269392272249068,6.269392272249067,0.9944044676871423,0.9944044676871426,0,0,9.337528228759766,8.952384948730469,3,3
1334,4,6.268016250317023,6.269392272249067,0.9944034313088572,0.9944044676871426,1,1,9.444073677062988,8.952384948730469,3,3
1334,8,5.80063049298765,5.931440267713033,1.0074385425462813,1.0035218031376734,1,1,9.842082977294922,8.952384948730469,7,7
1334,16,4.95897785228996,5.0003867286280315,1.0224127982709383,1.0216472672730355,2,5,10.426563262939453,8.952384948730469,14,11
1334,32,4.0488116125411135,4.982084681474322,1.0175772739046218,1.022756747309054,13,20,11.093581199645996,8.952384948730469,19,12
1334,64,3.0833463285940934,4.886409248493163,1.0108465016281019,1.027353687628539,29,50,11.819390296936035,8.952384948730469,35,14
1334,128,1.9537431375898002,4.843830883665282,1.0030291986930377,1.030045643392139,61,111,12.429422378540039,8.952384948730469,67,17
1335,1,6.070316470274781,6.070316470274781,0.9725481401763729,0.9725481401763753,0,0,6.125791072845459,6.125791072845459,1,1
1335,2,5.7246476134292035,5.7246476134292035,0.9813918407658275,0.9813918407658293,0,0,7.312127590179443,6.125791072845459,2,2
1335,3,5.464177016804381,5.464177016804382,0.9882877670517554,0.9882877670517564,0,0,7.757270812988281,6.125791072845459,3,3
1335,4,4.997681390802211,4.997681390802212,0.9971506571470563,0.9971506571470579,0,0,7.774558067321777,6.125791072845459,4,4
1335,8,4.775460962741635,4.854302035808146,1.0012737761934383,1.0006115014240944,2,1,8.244211196899414,6.125791072845459,6,7
1335,16,4.116889476064437,4.503992623558944,1.0065365410699165,1.0078116697262463,6,7,8.95901107788086,6.125791072845459,10,9
1335,32,3.631731509673825,4.490053771980463,1.0070810833724997,1.0097824146171597,15,20,9.616344451904297,6.125791072845459,17,12
1335,64,2.6328901366421955,4.433314728417629,1.0044580473815898,1.0121901295298947,33,52,10.20279312133789,6.125791072845459,31,12
1335,128,1.2226323137634127,4.3958328206460076,1.0009574337937652,1.0136774833084483,61,113,10.854395866394043,6.125791072845459,67,15
1336,1,6.582973017651213,6.582973017651212,0.975112143578818,0.9751121435788196,0,0,6.625097751617432,6.625097751617432,1,1
1336,2,5.592860832426293,5.592860832426293,0.9887318030807197,0.9887318030807203,0,0,7.310230255126953,6.625097751617432,2,2
1336,3,5.4644172910988225,5.4644172910988225,0.9916188158691093,0.9916188158691094,0,0,7.652923107147217,6.625097751617432,3,3
1336,4,5.407557392752604,5.407557392752604,0.9927086189102649,0.992708618910265,0,0,7.806755542755127,6.625097751617432,4,4
1336,8,5.222515726004922,5.2761750254161335,0.9960264543423025,0.996599290292476,1,1,8.89229965209961,6.625097751617432,7,7
1336,16,4.17424617578465,4.398505212579506,1.0145108613463267,1.0157173778295419,5,6,9.391871452331543,6.625097751617432,11,10
1336,32,3.606814656620011,4.305391278413364,1.0142467752225717,1.0165149649713376,12,19,9.920450210571289,6.625097751617432,20,13
1336,64,2.1661452968753445,4.237847764678217,1.003966991348323,1.0187099585591985,32,52,10.465033531188965,6.625097751617432,32,12
1336,128,1.2468769518863454,4.218010056279043,1.000281793984641,1.0197032541978337,64,114,11.083700180053711,6.625097751617432,64,14
1337,1,6.715514696192899,6.7155146961929,0.9638366591632753,0.963836659163277,0,0,6.805768013000488,6.805768013000488,1,1
1337,2,5.368573889489761,5.368573889489761,0.9881573109073329,0.9881573109073329,0,0,6.990896701812744,6.805768013000488,2,2
1337,3,5.110030281334517,5.110030281334517,0.9927319611109074,0.9927319611109078,0,0,7.370355606079102,6.805768013000488,3,3
1337,4,5.110029447800102,5.110029447800103,0.9927354265286776,0.9927354265286784,1,1,7.637204170227051,6.805768013000488,3,3
1337,8,4.248620886614489,4.757854595128039,1.000535386650276,0.9998121939809291,3,3,8.278921127319336,6.805768013000488,5,5
1337,16,3.9195874285009764,4.621206848068945,1.002791095333441,1.0044228454890645,5,9,9.109990119934082,6.805768013000488,11,7
1337,32,3.4104726302921535,4.446329541723947,1.0049011898913078,1.0098149011815445,16,22,9.627960205078125,6.805768013000488,16,10
1337,64,2.1735029098809644,4.327864924039829,1.0029675181896596,1.0141196714161682,32,51,10.170429229736328,6.805768013000488,32,13
1337,128,1.1051924829108544,4.3229925012629264,1.0006034218245898,1.0144824327961928,57,113,10.755444526672363,6.805768013000488,71,15
1338,1,7.271919125918044,7.271919125918043,0.9705071182158247,0.9705071182158249,0,0,7.3272600173950195,7.3272600173950195,1,1
1338,2,6.583672325687485,6.583672325687485,0.9875076755985903,0.9875076755985903,0,0,8.062796592712402,7.3272600173950195,2,2
1338,3,6.341062463983073,6.341062463983074,0.9936585784972667,0.9936585784972662,0,0,8.60293960571289,7.3272600173950195,3,3
1338,4,6.117625316783157,6.117625316783157,0.9997255784145103,0.9997255784145094,0,0,8.690616607666016,7.3272600173950195,4,4
1338,8,5.687030475339592,5.7528579555670945,1.005769599293202,1.006428330674674,1,1,9.132780075073242,7.3272600173950195,7,7
1338,16,4.979738991733823,5.319355786124821,1.0217055219918496,1.0191959160797823,5,6,9.4989595413208,7.3272600173950195,11,10
1338,32,4.273887877805618,5.31014851117486,1.0187600916149755,1.019769080873385,13,20,10.17523193359375,7.3272600173950195,19,12
1338,64,3.470299771754185,5.308767565713913,1.006325877020267,1.0201913108849143,28,51,10.88885498046875,7.3272600173950195,36,13
1338,128,1.9126097255263517,5.002033162964925,1.001837390717022,1.0305178362758234,58,115,11.566885948181152,7.3272600173950195,70,13
1339,1,6.3465163358312,6.346516335831198,0.9778449055629657,0.9778449055629683,0,0,6.3806867599487305,6.3806867599487305,1,1
1339,2,5.961989972977946,5.961989972977944,0.9865377245973538,0.986537724597356,0,0,8.088475227355957,6.3806867599487305,2,2
1339,3,5.067124980900187,5.067124980900187,1.0039858411025735,1.0039858411025755,0,0,8.210480690002441,6.3806867599487305,3,3
1339,4,5.052554886836559,5.052554886836559,1.0047479603171647,1.004747960317167,0,0,8.622523307800293,6.3806867599487305,4,4
1339,8,4.615826482640113,4.667642757579292,1.0104651158121412,1.0122651033783459,2,2,9.487842559814453,6.3806867599487305,6,6
1339,16,4.3406257842153435,4.580396425405283,1.0136357472229998,1.0148165430777758,8,9,9.883875846862793,6.3806867599487305,8,7
1339,32,3.7206222241217723,4.274197945725243,1.016853203353514,1.0235357577193893,12,21,10.652751922607422,6.3806867599487305,20,11
1339,64,2.8412935287388583,4.213057225771684,1.0084653335899474,1.0279369222322448,30,51,11.460748672485352,6.3806867599487305,34,13
1339,128,1.6932100865533568,4.208372419040249,0.9995951460725785,1.028831158329229,62,112,12.355816841125488,6.3806867599487305,66,16
1340,1,6.9349484887313935,6.934948488731395,0.9742030410554754,0.9742030410554765,0,0,6.978824138641357,6.978824138641357,1,1
1340,2,5.940671984992357,5.940671984992357,0.9910413127980418,0.991041312798042,0,0,7.260495662689209,6.978824138641357,2,2
1340,3,5.763417559922902,5.763417559922902,0.9948442699943415,0.9948442699943421,0,0,7.996295928955078,6.978824138641357,3,3
1340,4,5.7146446609205555,5.7146446609205555,0.9963270997509135,0.9963270997509135,0,0,8.49400806427002,6.978824138641357,4,4
1340,8,5.298651142807306,5.392149118776878,1.0034994567284685,1.0024491794604322,3,3,9.20842456817627,6.978824138641357,5,5
1340,16,4.491838042594086,5.0513182177621685,1.0099941841874363,1.0099673541977126,6,9,9.72501277923584,6.978824138641357,10,7
1340,32,3.7756765935423426,5.031748237009105,1.0028103821657717,1.011442841534582,13,25,10.753599166870117,6.978824138641357,19,7
1340,64,2.6529076973679953,4.9842855042406855,1.0045613716728603,1.0164034240077355,29,52,11.607124328613281,6.978824138641357,35,12
1340,128,1.5284366564762464,4.9695171368214925,1.0010101632857158,1.0172497461067929,61,117,12.488027572631836,6.978824138641357,67,11
1341,1,11.173014357518435,11.173014357518438,0.9332123978537825,0.9332123978537847,0,0,11.350754737854004,11.350754737854004,1,1
1341,2,9.168007372841986,9.168007372841986,0.9799346816471286,0.9799346816471302,0,0,11.657726287841797,11.350754737854004,2,2
1341,3,7.991689225301246,7.991689225301247,1.0033050332536064,1.0033050332536084,0,0,12.271594047546387,11.350754737854004,3,3
1341,4,7.988386070488741,7.991689225301247,1.0032143160377238,1.0033050332536084,1,1,12.660704612731934,11.350754737854004,3,3
1341,8,7.532786780003048,7.637838252521773,1.0170261789787025,1.015334456469971,2,2,12.90908432006836,11.350754737854004,6,6
1341,16,6.97265479330569,7.637838252521773,1.0199211829726216,1.015334456469971,5,10,13.14749526977539,11.350754737854004,11,6
1341,32,6.042769827529215,7.092699442565455,1.0386628844076595,1.0351415370914858,14,20,13.543378829956055,11.350754737854004,18,12
1341,64,4.421455416448716,6.6652915078330555,1.034829231585422,1.0442475482886708,29,49,14.024985313415527,11.350754737854004,35,15
1341,128,2.9201683874598783,6.6368182100458455,1.0115653042710924,1.0474873672292704,62,111,14.722318649291992,11.350754737854004,66,17
1342,1,11.397954993040381,11.397954993040369,0.9159053223126573,0.9159053223126598,0,0,11.671043395996094,11.671043395996094,1,1
1342,2,9.794978947096427,9.794978947096425,0.9607472096277365,0.9607472096277387,0,0,11.87318229675293,11.671043395996094,2,2
1342,3,9.793279364250258,9.79327936425026,0.9609422563474644,0.9609422563474667,0,0,12.091595649719238,11.671043395996094,3,3
1342,4,9.595033677629013,9.613884893973067,0.9673874462913159,0.9672024493522896,1,1,12.13451099395752,11.671043395996094,3,3
1342,8,8.869735104881958,8.888482793686265,0.9841553398142617,0.984330951205982,3,3,12.721848487854004,11.671043395996094,5,5
1342,16,7.704796921512544,8.441519252819125,1.0087859497011897,0.9999177643177672,7,10,13.376248359680176,11.671043395996094,9,6
1342,32,6.7658248236764935,8.264461342321551,1.020714899525488,1.0071848860487187,11,24,13.725251197814941,11.671043395996094,21,8
1342,64,5.718975832628757,7.943378471227384,1.021180580798875,1.0224818892057184,26,55,14.23165512084961,11.671043395996094,38,9
1342,128,3.4477146158911647,7.791948698701928,1.0058508778988051,1.0290255612124857,66,114,14.930903434753418,11.671043395996094,62,14
1343,1,10.669125543365892,10.669125543365897,0.920422265669777,0.92042226566978,0,0,10.9266996383667,10.9266996383667,1,1
1343,2,9.193945852236403,9.193945852236403,0.9637640466947194,0.9637640466947208,0,0,11.207489013671875,10.9266996383667,2,2
1343,3,8.647867002984023,8.647867002984023,0.9755938917388967,0.9755938917388978,0,0,11.291614532470703,10.9266996383667,3,3
1343,4,8.24974137715616,8.24974137715616,0.9857985815214281,0.9857985815214287,0,0,11.33621597290039,10.9266996383667,4,4
1343,8,7.890201266850876,7.891547587626404,0.9935455395860728,0.9938642150179613,1,1,11.970240592956543,10.9266996383667,7,7
1343,16,6.876839533559613,7.035461380877966,1.0141617292116414,1.0152824831751572,5,5,12.222796440124512,10.9266996383667,11,11
1343,32,5.935102000854378,6.522808568129005,1.0323452367164445,1.0275074659033705,14,19,12.652762413024902,10.9266996383667,18,13
1343,64,4.947099671277691,6.398745859416127,1.0315551029766934,1.03552597824582,27,46,13.478029251098633,10.9266996383667,37,18
1343,128,2.7421453534464173,6.312362511027913,1.0039152593934908,1.0411750421935433,63,108,14.077252388000488,10.9266996383667,65,20
1344,1,2.5585499454355167,2.558549945435517,0.9953678020615319,0.9953678020615326,0,0,2.5625267028808594,2.5625267028808594,1,1
1344,2,2.1281841405603044,2.128184140560304,0.9978255634415584,0.9978255634415585,0,0,3.0100767612457275,2.5625267028808594,2,2
1344,3,2.085857762203803,2.085857762203803,0.998166437558854,0.9981664375588545,0,0,3.0814990997314453,2.5625267028808594,3,3
1344,4,2.0626685883752502,2.0626685883752502,0.9983006578508464,0.9983006578508464,0,0,3.089567184448242,2.5625267028808594,4,4
1344,8,1.78934174704449,1.8001324887293357,0.9997510919119801,0.999936830368205,1,2,3.1682047843933105,2.5625267028808594,7,6
1344,16,1.3662480625006315,1.6432093276851185,1.0011251846056917,1.000860508719898,6,8,3.749441385269165,2.5625267028808594,10,8
1344,32,1.0194844461270405,1.594479111644877,1.0001761419563011,1.0015147995114346,16,24,4.208340167999268,2.5625267028808594,16,8
1344,64,0.6742387448014623,1.5807449453507665,0.9992193971391512,1.002446732394004,31,53,4.696118354797363,2.5625267028808594,33,11
1344,128,0.10679435410302313,1.5128276936391696,0.9991020808218252,1.0043979141234285,69,114,5.33413553237915,2.5625267028808594,59,14
1345,1,9.226120872399338,9.22612087239934,0.9466527843016486,0.9466527843016503,0,0,9.365355491638184,9.365355491638184,1,1
1345,2,7.680751671733166,7.680751671733167,0.9790968043284862,0.979096804328488,0,0,10.108121871948242,9.365355491638184,2,2
1345,3,7.577952673578023,7.577952673578025,0.9818907592522454,0.9818907592522476,0,0,10.248908996582031,9.365355491638184,3,3
1345,4,7.221363479478534,7.221363479478534,0.99173762781736,0.9917376278173611,0,0,10.251382827758789,9.365355491638184,4,4
1345,8,6.937881772550899,6.937942467695317,0.9979451109997152,0.9979379684813122,1,1,10.563603401184082,9.365355491638184,7,7
1345,16,6.323496964718087,6.3576620530719,1.012745285358662,1.0123848401076918,6,6,10.93770980834961,9.365355491638184,10,10
1345,32,5.364116118065028,6.201004198865635,1.0161263017467002,1.016057541902088,16,22,11.351224899291992,9.365355491638184,16,10
1345,64,4.276756337375772,6.003766672564008,1.0179785520376086,1.0250053471814267,31,49,12.043373107910156,9.365355491638184,33,15
1345,128,2.2786275867553876,5.916821985367606,1.0051817590217689,1.0271120939505167,62,111,12.788127899169922,9.365355491638184,66,17
1346,1,10.453948629445575,10.453948629445575,0.9361413182520383,0.9361413182520409,0,0,10.625982284545898,10.625982284545898,1,1
1346,2,10.13305144745622,10.133051447456221,0.9436773092869488,0.9436773092869494,0,0,10.683985710144043,10.625982284545898,2,2
1346,3,8.96260670083411,8.962606700834108,0.9725203133205578,0.9725203133205581,0,0,10.790456771850586,10.625982284545898,3,3
1346,4,8.450160975328805,8.45060571504184,0.9854250550420837,0.9853801934366819,1,1,11.189298629760742,10.625982284545898,3,3
1346,8,8.402983190120347,8.444910740042411,0.9863709037634665,0.9859006077024306,2,2,11.626402854919434,10.625982284545898,6,6
1346,16,7.7639877735801495,8.057419893182825,1.0013887417776424,0.9987142560485511,7,8,11.817171096801758,10.625982284545898,9,8
1346,32,7.219701621583029,8.040644149485393,1.0085633658914452,0.9995147035039186,14,21,12.144935607910156,10.625982284545898,18,11
1346,64,5.32168300312246,7.588475799138836,1.0112788210626684,1.0160413754230293,30,50,12.545272827148438,10.625982284545898,34,14
1346,128,3.232466859131921,7.464889891977122,1.0019329423883647,1.0232743381291438,60,111,13.00190544128418,10.625982284545898,68,17
1347,1,10.384303102000503,10.384303102000507,0.9341620223417143,0.9341620223417161,0,0,10.561052322387695,10.561052322387695,1,1
1347,2,8.569224902383166,8.569224902383166,0.9807631319726244,0.9807631319726254,0,0,11.64011287689209,10.561052322387695,2,2
1347,3,7.584380166877836,7.584380166877837,1.002393704730132,1.002393704730133,0,0,11.76246452331543,10.561052322387695,3,3
1347,4,7.566905730164666,7.566905730164664,1.0026688078379757,1.002668807837977,0,0,11.882415771484375,10.561052322387695,4,4
1347,8,6.501017533523773,6.531888696480605,1.0313321636988761,1.0302178818859153,1,1,12.529661178588867,10.561052322387695,7,7
1347,16,6.35456879219689,6.453529784430396,1.037638756433089,1.0339472275360808,5,6,13.413544654846191,10.561052322387695,11,10
1347,32,5.677599454686824,6.370907832643987,1.0368725227903806,1.0398216547104142,13,19,14.068536758422852,10.561052322387695,19,13
1347,64,4.190587826500499,6.178939761497113,1.021593870338561,1.0488231856003798,27,48,14.717426300048828,10.561052322387695,37,16
1347,128,2.549384534732327,6.090470129576951,1.0051120718530835,1.049579543936931,64,111,15.6397123336792,10.561052322387695,64,17
1348,1,9.066851173308919,9.066851173308919,0.9491271826909112,0.949127182690913,0,0,9.189842224121094,9.189842224121094,1,1
1348,2,6.911633095404801,6.9116330954048,0.990066813670439,0.9900668136704395,0,0,9.235008239746094,9.189842224121094,2,2
1348,3,6.80951154282515,6.80951154282515,0.9913662120058714,0.9913662120058713,0,0,9.524203300476074,9.189842224121094,3,3
1348,4,5.805496198236187,5.805496198236187,1.0062028743951346,1.0062028743951352,0,0,9.723370552062988,9.189842224121094,4,4
1348,8,5.513792873164665,5.649093172081093,1.0097394712550058,1.0108117865034902,2,2,10.761013984680176,9.189842224121094,6,6
1348,16,5.190555822264716,5.576148692779524,1.0157522762858255,1.0156104766111946,5,7,11.229111671447754,9.189842224121094,11,9
1348,32,4.471436582243999,5.363318898108688,1.023850505147097,1.0213705850913422,13,21,11.71324634552002,9.189842224121094,19,11
1348,64,3.583013722413253,5.305547775420646,1.0180766765639564,1.026903657401691,30,50,12.48080825805664,9.189842224121094,34,14
1348,128,2.399884240563771,5.170725793275226,1.0028324028725641,1.0325756447798988,63,110,13.522512435913086,9.189842224121094,65,18
1349,1,9.312317818109834,9.312317818109836,0.9448527842474542,0.944852784247457,0,0,9.457262992858887,9.457262992858887,1,1
1349,2,8.264664309552977,8.264664309552979,0.9685614922556762,0.9685614922556771,0,0,9.466325759887695,9.457262992858887,2,2
1349,3,6.746872675997578,6.746872675997577,1.0000946310084369,1.0000946310084373,0,0,9.988924026489258,9.457262992858887,3,3
1349,4,6.200865696979989,6.200865696979988,1.007186989397932,1.0071869893979324,0,0,9.990974426269531,9.457262992858887,4,4
1349,8,6.017483836334878,6.07658039254124,1.010632178618242,1.0116212517986392,2,2,10.860533714294434,9.457262992858887,6,6
1349,16,5.708171121507877,6.07658039254124,1.0078898429881056,1.0116212517986392,8,10,11.487497329711914,9.457262992858887,8,6
1349,32,4.678727512562777,5.902851745784663,1.0108396474108974,1.0196563169822188,14,21,12.041911125183105,9.457262992858887,18,11
1349,64,3.7065065944641207,5.750991182283128,1.0073633165413527,1.0281489990315125,27,51,12.965051651000977,9.457262992858887,37,13
1349,128,1.9242016906488206,5.538078928080146,1.0018946374486581,1.0380761236665483,61,113,13.83187198638916,9.457262992858887,67,15
1350,1,9.678767437954177,9.678767437954177,0.9348242927010312,0.9348242927010326,0,0,9.869529724121094,9.869529724121094,1,1
1350,2,9.34344344425467,9.34344344425467,0.9432799996902566,0.9432799996902571,0,0,10.036178588867188,9.869529724121094,2,2
1350,3,8.476535062743812,8.476535062743812,0.9624621770577526,0.9624621770577532,0,0,10.749835968017578,9.869529724121094,3,3
1350,4,8.457053338607828,8.45705333860783,0.9640324613230881,0.964032461323088,0,0,11.202693939208984,9.869529724121094,4,4
1350,8,7.878049034338807,8.047403047846704,0.974554766969339,0.9754642402472408,3,2,11.572992324829102,9.869529724121094,5,6
1350,16,7.041398591993166,7.663413077653728,0.9915789383782092,0.9870109097490597,4,8,12.196311950683594,9.869529724121094,12,8
1350,32,5.755586229282678,7.632154373844006,0.9959466843793372,0.9885242154541065,16,22,12.553786277770996,9.869529724121094,16,10
1350,64,4.677496990578339,7.510979746231721,0.9957382585621873,0.9959931578774364,33,53,12.989914894104004,9.869529724121094,31,11
1350,128,3.005839590124164,7.212009519954616,0.9985926021389262,1.0082644369849971,61,115,13.360003471374512,9.869529724121094,67,13
1351,1,9.485596876787227,9.485596876787236,0.9511877444178838,0.9511877444178863,0,0,9.598135948181152,9.598135948181152,1,1
1351,2,7.627933107094019,7.627933107094019,0.9955457968572867,0.9955457968572887,0,0,9.7764892578125,9.598135948181152,2,2
1351,3,7.244252377899637,7.244252377899638,1.0013362249288011,1.0013362249288023,0,0,9.854219436645508,9.598135948181152,3,3
1351,4,7.243116222592645,7.244252377899638,1.001360271567194,1.0013362249288023,1,1,9.962224960327148,9.598135948181152,3,3
1351,8,6.559368832772322,6.715053703569412,1.0128200142097519,1.0105881997112107,2,2,10.761152267456055,9.598135948181152,6,6
1351,16,6.248763381011256,6.540936943568745,1.0154396452197505,1.0159474030986395,7,10,11.201508522033691,9.598135948181152,9,6
1351,32,5.032833328953794,6.409571072594628,1.0277926674725473,1.0216823265701493,16,23,11.746190071105957,9.598135948181152,16,9
1351,64,4.05671860472095,6.265837797144522,1.0201103704347907,1.0295729926096637,31,49,12.338312149047852,9.598135948181152,33,15
1351,128,2.236183283945592,6.210559055058533,1.0028028861678373,1.0317152585297804,61,113,12.886075019836426,9.598135948181152,67,15
1352,1,9.337948685424745,9.337948685424745,0.930048735474858,0.9300487354748589,0,0,9.576160430908203,9.576160430908203,1,1
1352,2,9.099249521163621,9.099249521163621,0.9354805187187578,0.9354805187187583,0,0,9.714115142822266,9.576160430908203,2,2
1352,3,8.849725270784681,8.849725270784681,0.9409813406756846,0.9409813406756847,0,0,9.786303520202637,9.576160430908203,3,3
1352,4,8.61635032900011,8.61635032900011,0.9468099371179322,0.9468099371179327,0,0,9.85494613647461,9.576160430908203,4,4
1352,8,8.153379468850014,8.27745747171479,0.958203137168013,0.9559219361907196,1,1,10.317784309387207,9.576160430908203,7,7
1352,16,7.920898142420917,8.214910548703305,0.964365188027494,0.959128174616991,6,8,10.966179847717285,9.576160430908203,10,8
1352,32,7.605743010362953,8.19251961194314,0.9608854980715149,0.9608063525051536,15,24,11.404128074645996,9.576160430908203,17,8
1352,64,6.4594383094283865,7.827045130324789,0.9725972364900421,0.9764452343554736,31,53,11.977680206298828,9.576160430908203,33,11
1352,128,4.388987090358701,6.967767105206782,0.9950736357341561,1.0074347338159908,64,113,12.668011665344238,9.576160430908203,64,15
1353,1,8.299915395291816,8.299915395291809,0.9578426751453273,0.9578426751453304,0,0,8.391663551330566,8.391663551330566,1,1
1353,2,7.864188855088297,7.864188855088284,0.970819722468848,0.9708197224688501,0,0,9.643655776977539,8.391663551330566,2,2
1353,3,6.083490535520316,6.083490535520316,1.0037693586241867,1.0037693586241891,0,0,9.65427017211914,8.391663551330566,3,3
1353,4,5.3376873373433575,5.337687337343356,1.0162577842465577,1.0162577842465594,0,0,9.824413299560547,8.391663551330566,4,4
1353,8,4.944748603156027,4.9574165229316955,1.021692454822781,1.0217969220501388,1,1,10.296513557434082,8.391663551330566,7,7
1353,16,4.652035651123075,4.852745367595257,1.0237370084944148,1.0251435572447898,5,5,10.943750381469727,8.391663551330566,11,11
1353,32,4.176063444290292,4.6909614887575355,1.025992702939709,1.0321957220639737,11,14,11.636392593383789,8.391663551330566,21,18
1353,64,3.4908675702450305,4.555908939777758,1.0184456301371982,1.0396972869468688,28,42,12.29481029510498,8.391663551330566,36,22
1353,128,2.268650370777993,4.513352480498832,1.0055026862550545,1.0424451109853874,65,106,13.127055168151855,8.391663551330566,63,22
1354,1,5.8109487508698505,5.81094875086985,0.9763904153132222,0.9763904153132238,0,0,5.854862689971924,5.854862689971924,1,1
1354,2,4.369635400170807,4.369635400170807,0.9949948083444407,0.9949948083444415,0,0,5.981130123138428,5.854862689971924,2,2
1354,3,4.185368559522921,4.185368559522921,0.9980230265049864,0.9980230265049874,0,0,6.751445293426514,5.854862689971924,3,3
1354,4,3.911356495088119,3.911356495088119,1.0016853039436453,1.0016853039436469,0,0,6.924798488616943,5.854862689971924,4,4
1354,8,3.538294713147833,3.538294713147832,1.0077000068815392,1.0077000068815403,0,0,7.038071632385254,5.854862689971924,8,8
1354,16,2.7790045317165926,2.94984940012342,1.0137248825113916,1.0145211434900268,3,5,7.667264461517334,5.854862689971924,13,11
1354,32,2.4792570463455834,2.7156881829896977,1.0148455558544776,1.017775184742424,11,16,7.951622009277344,5.854862689971924,21,16
1354,64,1.7790011062313311,2.7117841861122547,1.006203756120491,1.0183271895643413,28,46,8.536190032958984,5.854862689971924,36,18
1354,128,0.992766438257233,2.690544561428517,0.997903772061766,1.0192263491259252,60,107,9.334752082824707,5.854862689971924,68,21
1355,1,12.442430693992844,12.442430693992844,0.8998155315715726,0.8998155315715765,0,0,12.782872200012207,12.782872200012207,1,1
1355,2,11.052862429947407,11.052862429947409,0.9430471896167955,0.9430471896167976,0,0,13.136302947998047,12.782872200012207,2,2
1355,3,10.181514532543458,10.181514532543458,0.965633887697336,0.9656338876973378,0,0,13.13825511932373,12.782872200012207,3,3
1355,4,9.668213541100709,9.668213541100707,0.980656413110803,0.9806564131108042,0,0,13.482314109802246,12.782872200012207,4,4
1355,8,9.259989413226693,9.266444298727071,0.9941136913591361,0.9942537099397648,2,2,13.961587905883789,12.782872200012207,6,6
1355,16,8.74975208594537,9.044843581322322,1.0047032682997215,1.0047866807530217,5,7,15.024917602539062,12.782872200012207,11,9
1355,32,7.8712985569008405,8.791087488019002,1.0124329161211134,1.0147524584937542,12,20,15.807136535644531,12.782872200012207,20,12
1355,64,6.2935348912978135,8.68859215344075,1.0077931857010367,1.0216813560311975,28,53,16.631908416748047,12.782872200012207,36,11
1355,128,4.42260438510264,8.683647046636947,0.995475869082679,1.0240478170240792,56,115,17.361230850219727,12.782872200012207,72,13
1356,1,2.873855807923993,2.873855807923993,0.9909049200175483,0.9909049200175488,0,0,2.8875420093536377,2.8875420093536377,1,1
1356,2,2.781125662888581,2.781125662888581,0.9910007961934215,0.9910007961934216,0,0,2.9275238513946533,2.8875420093536377,2,2
1356,3,2.5717239306620394,2.5717239306620394,0.9925284474033294,0.9925284474033294,0,0,3.020272731781006,2.8875420093536377,3,3
1356,4,2.34246411533795,2.342464115337949,0.9937419068735072,0.9937419068735077,0,0,3.080359935760498,2.8875420093536377,4,4
1356,8,2.2730375255475224,2.2743873662682437,0.9945479725410168,0.9946526107087206,3,3,3.390145778656006,2.8875420093536377,5,5
1356,16,2.0662793278243883,2.1497049214087998,0.9963245036953817,0.9963390396647845,5,7,3.5965735912323,2.8875420093536377,11,9
1356,32,1.8680742526252454,2.077547393718249,0.9957586623503965,0.9975650078026301,12,21,3.830385446548462,2.8875420093536377,20,11
1356,64,1.6087067834020605,1.989568055692725,0.9966774246176386,0.9988774000711705,28,48,4.2026567459106445,2.8875420093536377,36,16
1356,128,1.502918944753486,1.9774993107667682,0.995006919475073,0.9992294914169011,68,107,4.803728103637695,2.8875420093536377,60,21
1357,1,7.126165690066213,7.126165690066212,0.9659224527862812,0.965922452786282,0,0,7.199961185455322,7.199961185455322,1,1
1357,2,6.335469424067744,6.335469424067745,0.982661553240521,0.9826615532405218,0,0,8.07858657836914,7.199961185455322,2,2
1357,3,5.837206651672837,5.837206651672836,0.9882337579058567,0.9882337579058571,0,0,8.109659194946289,7.199961185455322,3,3
1357,4,4.750367833497011,4.750367833497011,1.0054047147619083,1.005404714761908,0,0,8.175581932067871,7.199961185455322,4,4
1357,8,4.580569618449153,4.584044636586292,1.0086366481332705,1.0087004518558897,1,2,8.455888748168945,7.199961185455322,7,6
1357,16,4.358017195173872,4.44831183656216,1.0128297581171504,1.012825448120844,5,5,8.699748992919922,7.199961185455322,11,11
1357,32,3.980122477290183,4.328713549574398,1.0154281197836381,1.0170607676053551,11,16,9.153757095336914,7.199961185455322,21,16
1357,64,2.852446143847093,4.287267758916457,1.0114550598955983,1.0189330812601147,25,47,9.899085998535156,7.199961185455322,39,17
1357,128,1.3730079115389233,4.27713185395748,1.0002846105141594,1.0203774918499162,63,105,10.617426872253418,7.199961185455322,65,23
1358,1,9.196503342008274,9.196503342008276,0.9540432614222364,0.9540432614222366,0,0,9.297111511230469,9.297111511230469,1,1
1358,2,7.911666405754564,7.9116664057545645,0.9809147783785142,0.9809147783785135,0,0,9.598711013793945,9.297111511230469,2,2
1358,3,6.94050123790788,6.94050123790788,0.9968963686027508,0.9968963686027519,0,0,9.775647163391113,9.297111511230469,3,3
1358,4,6.338731852368567,6.338731852368566,1.0080763020099979,1.0080763020099994,0,0,9.921599388122559,9.297111511230469,4,4
1358,8,6.1071514244839555,6.174708606410609,1.0113670085993323,1.0110499217960438,2,1,10.711938858032227,9.297111511230469,6,7
1358,16,5.586796020959396,5.731196639088256,1.0248319370958643,1.0241514082919618,5,8,11.418560981750488,9.297111511230469,11,8
1358,32,4.402204990958523,5.7152322083300655,1.021211435031164,1.0255082948351744,14,22,12.238992691040039,9.297111511230469,18,10
1358,64,3.4320760167076494,5.7151459327089915,1.0116124732589784,1.0255366333537124,27,53,12.739424705505371,9.297111511230469,37,11
1358,128,2.247367241701383,5.692772071624783,1.003022529767033,1.0279753724732827,62,117,13.44593334197998,9.297111511230469,66,11
1359,1,7.0081408190731365,7.0081408190731365,0.977035655488442,0.9770356554884443,0,0,7.041447639465332,7.041447639465332,1,1
1359,2,6.088099753872399,6.088099753872399,0.9922281808257118,0.9922281808257134,0,0,7.716091632843018,7.041447639465332,2,2
1359,3,5.109660302138135,5.109660302138135,1.0037340506953063,1.0037340506953072,0,0,7.761416912078857,7.041447639465332,3,3
1359,4,4.7487200813254,4.7487200813254,1.0069489972739067,1.0069489972739067,0,0,7.79757833480835,7.041447639465332,4,4
1359,8,4.484231510977644,4.4842315109776445,1.0129868697702742,1.0129868697702742,0,0,8.038418769836426,7.041447639465332,8,8
1359,16,4.082569831106103,4.179811460720634,1.0197626351916926,1.0198484705438862,5,4,8.62077808380127,7.041447639465332,11,12
1359,32,3.620303842476996,4.048639777309164,1.018566617139657,1.023659468935937,13,17,9.491194725036621,7.041447639465332,19,15
1359,64,2.5059043834868384,3.988163043032236,1.0098623715178396,1.0259620804865186,28,48,10.130694389343262,7.041447639465332,36,16
1359,128,1.626807141749211,3.9880209178549273,1.0026012776294169,1.0260951064701498,62,110,11.06546688079834,7.041447639465332,66,18
1360,1,8.678628884579966,8.678628884579968,0.963243878258403,0.9632438782584043,0,0,8.749038696289062,8.749038696289062,1,1
1360,2,6.990445384057332,6.990445384057332,0.9962117561905137,0.9962117561905139,0,0,9.761887550354004,8.749038696289062,2,2
1360,3,6.621183269360591,6.621183269360591,1.003091224834265,1.003091224834266,0,0,9.852436065673828,8.749038696289062,3,3
1360,4,5.884264916053146,5.884264916053146,1.015128351660299,1.0151283516603002,0,0,9.856812477111816,8.749038696289062,4,4
1360,8,5.491761961285571,5.601166065926296,1.021715421683915,1.0216774798724884,1,2,10.415176391601562,8.749038696289062,7,6
1360,16,5.0443154917555395,5.268871705926331,1.027312053832843,1.0272644788215906,5,7,10.823287963867188,8.749038696289062,11,9
1360,32,4.4694496061161395,5.238998628498184,1.027516076106847,1.0287340501467064,14,19,11.474625587463379,8.749038696289062,18,13
1360,64,2.8178453191717825,5.103410529741276,1.0105459945733264,1.0330386411107908,34,52,12.288732528686523,8.749038696289062,30,12
1360,128,1.6687877278968528,5.075078606276204,1.0024010195788167,1.034585396024838,65,114,13.013520240783691,8.749038696289062,63,14
1361,1,7.517140384002455,7.517140384002455,0.9674869251623643,0.9674869251623662,0,0,7.581573486328125,7.581573486328125,1,1
1361,2,6.679711622843538,6.679711622843539,0.9812998822097541,0.9812998822097554,0,0,7.838313102722168,7.581573486328125,2,2
1361,3,6.463515311462899,6.463515311462899,0.9839019590411098,0.9839019590411102,0,0,7.988523960113525,7.581573486328125,3,3
1361,4,6.376531828555536,6.376531828555537,0.9864449642572101,0.98644496425721,0,0,7.9948554039001465,7.581573486328125,4,4
1361,8,6.004062011443035,6.00600521638321,0.9922785134536809,0.9923161125385713,2,2,8.242175102233887,7.581573486328125,6,6
1361,16,4.3952437293674205,4.868368652880075,1.0165724917179237,1.009378510141155,5,9,8.532618522644043,7.581573486328125,11,7
1361,32,3.9445183462647413,4.745766839499838,1.0174339584975662,1.012314041069265,12,19,8.91265869140625,7.581573486328125,20,13
1361,64,2.4878024334371975,4.520452649899736,1.0117427198926423,1.0182241856637981,28,50,9.322989463806152,7.581573486328125,36,14
1361,128,1.1871651387988111,4.470729971365064,1.000757331687951,1.0214531478076208,62,109,9.820075988769531,7.581573486328125,66,19
1362,1,8.27524140367075,8.27524140367075,0.9586358322944294,0.95863583229443,0,0,8.36802864074707,8.36802864074707,1,1
1362,2,6.844803322435315,6.844803322435314,0.9883871258914694,0.9883871258914687,0,0,8.66083812713623,8.36802864074707,2,2
1362,3,6.491813524740253,6.4918135247402535,0.9949196792040638,0.9949196792040628,0,0,8.840895652770996,8.36802864074707,3,3
1362,4,6.116863856592706,6.116863856592705,1.002736257899007,1.0027362578990069,0,0,9.12774658203125,8.36802864074707,4,4
1362,8,5.839405584040743,5.936902120811178,1.0087754039887833,1.0086908615436554,2,2,10.281389236450195,8.36802864074707,6,6
1362,16,5.22789477569475,5.66173704008954,1.0104905173472616,1.0157971212918775,6,7,10.869491577148438,8.36802864074707,10,9
1362,32,4.726682451679946,5.210706809769374,1.0167815354296632,1.0262745951699443,13,18,11.575179100036621,8.36802864074707,19,14
1362,64,3.3926666162342953,5.001893076209229,1.0084326818260454,1.0319451331540015,31,46,12.394397735595703,8.36802864074707,33,18
1362,128,2.1520085740948853,4.9981611869672795,1.0040469805815277,1.0323934851382583,57,111,13.371236801147461,8.36802864074707,71,17
1363,1,10.87728172874219,10.87728172874219,0.9371270341788763,0.9371270341788782,0,0,11.036006927490234,11.036006927490234,1,1
1363,2,8.895149220701036,8.895149220701036,0.9861060044665138,0.9861060044665149,0,0,11.648466110229492,11.036006927490234,2,2
1363,3,8.877692940421593,8.877692940421593,0.9870795188635847,0.9870795188635857,0,0,12.368142127990723,11.036006927490234,3,3
1363,4,8.849443009607858,8.849443009607858,0.9886881206132025,0.9886881206132042,0,0,12.496079444885254,11.036006927490234,4,4
1363,8,8.580058124627344,8.64657690007921,0.9975407333469462,0.9973315827884001,3,3,12.676712036132812,11.036006927490234,5,5
1363,16,7.67775782165217,8.521676300638704,0.9968147312798772,1.0004277217689257,5,10,13.569544792175293,11.036006927490234,11,6
1363,32,6.33731061185392,7.8754935855682895,1.0187678533962266,1.0279024176416711,14,24,14.225214958190918,11.036006927490234,18,8
1363,64,5.242606798748187,7.691439664135313,1.0086023183147128,1.0336013736819434,32,55,15.1550931930542,11.036006927490234,32,9
1363,128,3.440218945774519,7.555738989556417,1.0037357668562754,1.042032904443878,61,117,15.796734809875488,11.036006927490234,67,11
1364,1,9.77709723382864,9.777097233828641,0.9453406943480507,0.9453406943480526,0,0,9.912832260131836,9.912832260131836,1,1
1364,2,8.21608560743062,8.21608560743062,0.9837641430166528,0.9837641430166534,0,0,10.053421974182129,9.912832260131836,2,2
1364,3,7.540286579811536,7.540286579811537,0.9968659840683081,0.9968659840683091,0,0,10.33849811553955,9.912832260131836,3,3
1364,4,7.466603230987131,7.466603230987132,0.9983576074645872,0.9983576074645881,0,0,10.803150177001953,9.912832260131836,4,4
1364,8,7.071888922486684,7.185573339167696,1.0090052447955242,1.0059828072481443,2,2,11.189702033996582,9.912832260131836,6,6
1364,16,6.584819845402096,6.9140627583920695,1.0216634488612268,1.013371617090628,5,6,11.91613483428955,9.912832260131836,11,10
1364,32,5.841159601468886,6.762400280207816,1.0202144600952354,1.019086921864682,14,20,12.553092002868652,9.912832260131836,18,12
1364,64,3.8941212122679483,6.4855172075703,1.0137730405939667,1.0309049128116532,33,50,13.366665840148926,9.912832260131836,31,14
1364,128,2.312769239362084,6.259563291451205,1.0018642186972955,1.0408553000956673,61,111,14.141022682189941,9.912832260131836,67,17
1365,1,8.222532931963304,8.222532931963304,0.9636609649267932,0.9636609649267943,0,0,8.293450355529785,8.293450355529785,1,1
1365,2,7.358208754950802,7.358208754950802,0.9799145730035802,0.9799145730035808,0,0,9.261573791503906,8.293450355529785,2,2
1365,3,6.840091305224866,6.840091305224864,0.9912427622919253,0.9912427622919258,0,0,9.52768611907959,8.293450355529785,3,3
1365,4,5.883679621234136,5.883679621234136,1.0075988858923355,1.0075988858923355,0,0,9.65789794921875,8.293450355529785,4,4
1365,8,5.589275489971703,5.606732766124131,1.0154143256665225,1.0152326158372034,2,2,10.194619178771973,8.293450355529785,6,6
1365,16,4.948292840183683,5.1698901702254165,1.0257946538861091,1.0247013747952125,6,7,10.897872924804688,8.293450355529785,10,9
1365,32,3.979436569199458,5.074312069586008,1.020229013285332,1.0274420008148692,14,20,11.754867553710938,8.293450355529785,18,12
1365,64,3.17772556165236,5.072209771339893,1.0109234198468067,1.028092098186963,31,49,12.603691101074219,8.293450355529785,33,15
1365,128,1.8327581195194302,5.0592191225553025,1.0038369128260194,1.0297660910077169,62,112,13.569668769836426,8.293450355529785,66,16
1366,1,11.098677512951951,11.098677512951953,0.9226290384572322,0.9226290384572337,0,0,11.333860397338867,11.333860397338867,1,1
1366,2,8.241715386828574,8.241715386828574,0.9934313169584552,0.9934313169584565,0,0,12.305782318115234,11.333860397338867,2,2
1366,3,7.8304172662360285,7.8304172662360285,0.9981185195402102,0.9981185195402096,0,0,12.537595748901367,11.333860397338867,3,3
1366,4,7.79879702227879,7.798797022278788,0.9994625984879698,0.9994625984879685,0,0,12.622662544250488,11.333860397338867,4,4
1366,8,7.346985739677,7.481685391970236,1.0118735383861732,1.0121906876349445,1,2,13.3441801071167,11.333860397338867,7,6
1366,16,6.754623957265565,6.89912727373459,1.0284802634498034,1.0301356016907177,6,9,14.039030075073242,11.333860397338867,10,7
1366,32,6.0440608181223885,6.779760189362524,1.031070459037588,1.0358448538791607,13,21,14.55091381072998,11.333860397338867,19,11
1366,64,4.812934796061789,6.623615714167904,1.0188668477937226,1.0431230557443787,34,52,15.218344688415527,11.333860397338867,30,12
1366,128,2.793695991070427,6.5654139379630125,1.004498677185903,1.0482192735526532,62,115,16.242111206054688,11.333860397338867,66,13
1367,1,7.450383604154516,7.450383604154514,0.9672434906464895,0.9672434906464915,0,0,7.515899181365967,7.515899181365967,1,1
1367,2,6.695390904104461,6.695390904104463,0.9857037908510702,0.9857037908510713,0,0,9.7366304397583,7.515899181365967,2,2
1367,3,6.265267762864408,6.265267762864409,0.9978205286034827,0.9978205286034845,0,0,9.958264350891113,7.515899181365967,3,3
1367,4,6.258752879984411,6.265267762864409,0.9971137795690344,0.9978205286034845,1,1,10.711265563964844,7.515899181365967,3,3
1367,8,5.329466522557306,5.370110691313684,1.0182441558481978,1.0202409344301677,2,2,11.402262687683105,7.515899181365967,6,6
1367,16,5.09049513036659,5.326806037120041,1.0183462519897966,1.022192645793489,5,8,11.710689544677734,7.515899181365967,11,8
1367,32,4.51226821709381,5.251796773570921,1.023137839392116,1.0253663577206047,12,23,12.244678497314453,7.515899181365967,20,9
1367,64,3.4996809762721517,5.248550966502656,1.0142741057253213,1.0261816675665583,33,53,12.771194458007812,7.515899181365967,31,11
1367,128,2.16255510593031,5.126887677523486,1.0078090223852083,1.0290182126568408,67,118,13.236226081848145,7.515899181365967,61,10
1368,1,9.411844099366801,9.411844099366803,0.9492468340247541,0.9492468340247555,0,0,9.532849311828613,9.532849311828613,1,1
1368,2,7.578427488162959,7.578427488162958,0.9909234896852342,0.9909234896852359,0,0,9.869200706481934,9.532849311828613,2,2
1368,3,6.6100265190710825,6.6100265190710825,1.0085275343131872,1.008527534313188,0,0,10.668025016784668,9.532849311828613,3,3
1368,4,6.5043446011357124,6.504344601135712,1.0116418908274551,1.0116418908274556,0,0,10.788135528564453,9.532849311828613,4,4
1368,8,5.517857362850713,5.889438520579076,1.0255098135537657,1.025337237440646,2,2,11.36043930053711,9.532849311828613,6,6
1368,16,5.213627798704306,5.8808028471628635,1.0235561212618285,1.0260108489871067,6,9,11.761425018310547,9.532849311828613,10,7
1368,32,4.60662499543367,5.667322691013078,1.028175432414043,1.032911639364762,17,20,12.363924026489258,9.532849311828613,15,12
1368,64,3.7558990590532093,5.608544849213583,1.020201674177299,1.0362531440536127,32,51,12.935501098632812,9.532849311828613,32,13
1368,128,2.511385051290769,5.556744718013542,1.0072820114050123,1.0397766678214124,64,111,13.808799743652344,9.532849311828613,64,17
1369,1,10.671543632175684,10.671543632175686,0.9289628981999494,0.9289628981999513,0,0,10.876885414123535,10.876885414123535,1,1
1369,2,9.189161344865132,9.189161344865134,0.9713728968001787,0.9713728968001785,0,0,11.371078491210938,10.876885414123535,2,2
1369,3,8.839674990683633,8.839674990683632,0.9782661265286594,0.978266126528659,0,0,11.460288047790527,10.876885414123535,3,3
1369,4,8.71973925664719,8.71973925664719,0.982066742517095,0.9820667425170954,0,0,11.573832511901855,10.876885414123535,4,4
1369,8,7.9449887491845645,7.945887123827801,1.0026223151218232,1.0026887863891936,1,1,11.733217239379883,10.876885414123535,7,7
1369,16,7.792574672116216,7.822606467616045,1.0077011660234527,1.007665966583792,5,6,12.274633407592773,10.876885414123535,11,10
1369,32,6.575545887371156,7.57222121400901,1.014719335608015,1.018614259367967,12,20,13.074870109558105,10.876885414123535,20,12
1369,64,4.972359337776404,7.186034370719447,1.0081307545817666,1.0309484383000778,22,48,13.762661933898926,10.876885414123535,42,16
1369,128,2.760131762858063,6.973262367140161,1.0038465659180882,1.040018168646828,58,109,14.591533660888672,10.876885414123535,70,19
1370,1,6.165296400163037,6.165296400163037,0.9773143075918963,0.9773143075918977,0,0,6.203908920288086,6.203908920288086,1,1
1370,2,5.490358595950519,5.490358595950519,0.9887154316539701,0.988715431653971,0,0,6.768396377563477,6.203908920288086,2,2
1370,3,5.224855191777001,5.224855191777001,0.9938497044898205,0.9938497044898215,0,0,7.282576560974121,6.203908920288086,3,3
1370,4,5.094111998968893,5.094111998968893,0.9959748131853561,0.9959748131853572,0,0,7.3105058670043945,6.203908920288086,4,4
1370,8,4.489955441282422,4.54927184492412,0.9999502367991062,1.0008457204311898,3,2,7.9379496574401855,6.203908920288086,5,6
1370,16,4.009909529122778,4.201632032282294,1.0067286566241544,1.0090715319899402,7,8,8.933029174804688,6.203908920288086,9,8
1370,32,3.1159073802551243,4.17344788215386,1.0048951996115756,1.0110914793058652,15,22,9.634993553161621,6.203908920288086,17,10
1370,64,2.2140787963356936,4.157709615352104,1.0023725473609102,1.012881685400141,34,50,10.243879318237305,6.203908920288086,30,14
1370,128,1.2255035936448233,4.100156685716917,1.0007798777205155,1.0142179797852457,68,112,11.037071228027344,6.203908920288086,60,16
1371,1,7.800434816964676,7.800434816964676,0.9598506110003324,0.9598506110003324,0,0,7.893801689147949,7.893801689147949,1,1
1371,2,6.502908710915649,6.502908710915649,0.9830833213807348,0.9830833213807342,0,0,8.228924751281738,7.893801689147949,2,2
1371,3,6.032192846829355,6.032192846829355,0.9905466577596889,0.9905466577596884,0,0,8.293876647949219,7.893801689147949,3,3
1371,4,6.025098808822318,6.0250988088223165,0.9907376376224932,0.990737637622493,0,0,8.40751838684082,7.893801689147949,4,4
1371,8,4.483888062056026,4.483888062056027,1.0163975397227474,1.0163975397227472,0,0,8.565773963928223,7.893801689147949,8,8
1371,16,4.171606911290739,4.24337686312944,1.020501618651037,1.0200852919406178,5,7,8.95241641998291,7.893801689147949,11,9
1371,32,3.7749571173345426,4.015811349292525,1.0245730442640846,1.0269902265184894,12,14,9.717185974121094,7.893801689147949,20,18
1371,64,2.940377159134326,3.936531347667263,1.0209158369558042,1.028597849429397,31,45,10.205543518066406,7.893801689147949,33,19
1371,128,1.3989079899440244,3.84802435402,1.0033843656554373,1.0323090468742755,62,104,11.041912078857422,7.893801689147949,66,24
1372,1,9.976290132432709,9.976290132432712,0.9449749388426848,0.9449749388426882,0,0,10.11160945892334,10.11160945892334,1,1
1372,2,9.238629962782593,9.238629962782591,0.9682229820748405,0.9682229820748428,0,0,11.649101257324219,10.11160945892334,2,2
1372,3,9.016362370397118,9.01636237039712,0.9792763984581889,0.9792763984581909,0,0,13.357927322387695,10.11160945892334,3,3
1372,4,8.253192553010306,8.253192553010305,0.9995697231028553,0.999569723102858,0,0,13.502351760864258,10.11160945892334,4,4
1372,8,7.5907546475033,8.194255533223265,1.0031275594073388,1.0028126737085183,1,2,13.896275520324707,10.11160945892334,7,6
1372,16,6.426132014996713,7.3240879906581755,1.0247698893891013,1.0305842661479954,6,8,14.663273811340332,10.11160945892334,10,8
1372,32,5.373534583603144,7.307798336860407,1.0123968981362408,1.0329665873367437,14,22,15.625364303588867,10.11160945892334,18,10
1372,64,4.5132008841820905,7.028812548881325,1.017776290466628,1.0526479710878633,28,48,16.5590763092041,10.11160945892334,36,16
1372,128,3.32482738810552,6.723695080774215,1.005986340668277,1.0581475758276406,66,114,17.3536434173584,10.11160945892334,62,14
1373,1,7.523997829422275,7.5239978294222745,0.9680962982493386,0.9680962982493407,0,0,7.584664344787598,7.584664344787598,1,1
1373,2,6.509672412178211,6.509672412178212,0.9844040606878189,0.9844040606878217,0,0,7.611072063446045,7.584664344787598,2,2
1373,3,5.691941064078336,5.691941064078336,0.9979912854631847,0.9979912854631866,0,0,8.22675609588623,7.584664344787598,3,3
1373,4,5.378021286077517,5.378021286077518,1.0030879693732977,1.0030879693732995,0,0,8.3405122756958,7.584664344787598,4,4
1373,8,4.641892315063407,4.641892315063407,1.0141013758110635,1.0141013758110646,0,0,8.521711349487305,7.584664344787598,8,8
1373,16,4.29323857519887,4.447486235324076,1.0193831584544475,1.0173523543316978,5,6,9.587313652038574,7.584664344787598,11,10
1373,32,3.498326143051979,4.407148271054782,1.0137546991925848,1.0200335622881744,15,19,10.169733047485352,7.584664344787598,17,13
1373,64,2.489574612018079,4.330889957175843,1.00476212127963,1.0233712976866338,31,51,10.87504768371582,7.584664344787598,33,13
1373,128,1.3863286392712364,4.284461600155309,0.9981498972716518,1.0258530956255711,64,112,11.706266403198242,7.584664344787598,64,16
1374,1,12.225911201063804,12.225911201063802,0.8946429115140043,0.8946429115140047,0,0,12.627908706665039,12.627908706665039,1,1
1374,2,11.352713355354341,11.352713355354341,0.9237660877386981,0.9237660877386986,0,0,12.684855461120605,12.627908706665039,2,2
1374,3,10.637978017682748,10.637978017682748,0.9473888634772948,0.9473888634772949,0,0,12.827030181884766,12.627908706665039,3,3
1374,4,9.895360166490027,9.895360166490027,0.973357641638386,0.9733576416383868,0,0,13.109835624694824,12.627908706665039,4,4
1374,8,8.275524759234367,8.275524759234369,1.0183611951665668,1.018361195166567,0,0,13.634038925170898,12.627908706665039,8,8
1374,16,8.15523502948659,8.206280504675158,1.026324024177094,1.0219379937366386,6,5,14.212265014648438,12.627908706665039,10,11
1374,32,7.237557156079494,7.921721515785037,1.0326415599267387,1.0295518119899432,12,15,14.552030563354492,12.627908706665039,20,17
1374,64,5.135561647151733,7.581524028712462,1.0234084954532563,1.0423396220872703,33,48,15.036249160766602,12.627908706665039,31,16
1374,128,3.539675678629267,7.553759201318316,1.0146958750218074,1.0449803466101546,62,109,15.60547924041748,12.627908706665039,66,19
1375,1,9.32245506132284,9.32245506132284,0.9492775181123727,0.9492775181123739,0,0,9.446864128112793,9.446864128112793,1,1
1375,2,7.991263041003336,7.991263041003337,0.977989452811901,0.9779894528119006,0,0,9.728206634521484,9.446864128112793,2,2
1375,3,7.394836795452198,7.394836795452198,0.9877595898493381,0.9877595898493381,0,0,9.812278747558594,9.446864128112793,3,3
1375,4,7.167151274940236,7.1671512749402355,0.9925305495950559,0.9925305495950559,0,0,10.08949089050293,9.446864128112793,4,4
1375,8,6.728347055717346,6.738657529006311,1.001714800523241,1.001205478554691,1,1,10.335479736328125,9.446864128112793,7,7
1375,16,5.990732964727688,6.428101780376363,1.0127362558977184,1.0089112709504846,6,7,10.79789924621582,9.446864128112793,10,9
1375,32,4.778724270466455,5.9846028018910005,1.0155591695721247,1.0174887226503873,13,21,11.875908851623535,9.446864128112793,19,11
1375,64,3.1645532045657543,5.846868125350107,1.0086100461125032,1.027548947475817,34,49,12.599922180175781,9.446864128112793,30,15
1375,128,1.992183187990029,5.7225889488162816,1.004397852146145,1.031318576391356,64,115,13.181979179382324,9.446864128112793,64,13
1376,1,10.540228167645255,10.540228167645235,0.933607111129659,0.9336071111296625,0,0,10.728484153747559,10.728484153747559,1,1
1376,2,9.653838339033364,9.653838339033365,0.9577010884506625,0.9577010884506649,0,0,10.767049789428711,10.728484153747559,2,2
1376,3,8.703420626295546,8.70342062629555,0.9830458008092485,0.98304580080925,0,0,10.842055320739746,10.728484153747559,3,3
1376,4,6.775976510574753,6.775976510574751,1.013956514186617,1.0139565141866203,0,0,10.868170738220215,10.728484153747559,4,4
1376,8,6.3430021886093515,6.345747188533354,1.0229994968742622,1.0228039381535257,2,2,11.145956993103027,10.728484153747559,6,6
1376,16,6.010742854391483,6.222347076117361,1.0310542924569355,1.0256467490565868,4,6,11.56194019317627,10.728484153747559,12,10
1376,32,5.0718512512705,5.8131130620060505,1.035551156412068,1.0345429319876698,14,19,12.343422889709473,10.728484153747559,18,13
1376,64,3.598238123223275,5.615361960061231,1.021865970332227,1.0442570209332809,25,49,13.106664657592773,10.728484153747559,39,15
1376,128,2.016273150432339,5.594956669949135,1.0056147576431589,1.0458972827248965,62,112,13.880685806274414,10.728484153747559,66,16
1377,1,7.40778677672221,7.407786776722192,0.9749172522103257,0.9749172522103279,0,0,7.446329116821289,7.446329116821289,1,1
1377,2,6.412097164396651,6.41209716439665,0.9907542144120949,0.9907542144120964,0,0,8.096090316772461,7.446329116821289,2,2
1377,3,6.354712207868018,6.354712207868017,0.9905348954390103,0.9905348954390119,0,0,8.165748596191406,7.446329116821289,3,3
1377,4,6.349777966168151,6.349777966168152,0.990590001525175,0.9905900015251765,0,0,8.439167022705078,7.446329116821289,4,4
1377,8,5.988912118852372,6.122763240977334,0.9984207933067623,0.9969638670069687,3,4,9.819449424743652,7.446329116821289,5,4
1377,16,5.12984318901333,6.115842854267741,0.9909882808742654,0.9975216475569314,7,11,10.63793659210205,7.446329116821289,9,5
1377,32,4.050362533776174,5.536547177944605,1.0024163134730353,1.0188399999295359,14,26,11.287643432617188,7.446329116821289,18,6
1377,64,3.229598997415864,5.5243370284357765,1.0006207493817882,1.0205086215685155,34,56,12.053226470947266,7.446329116821289,30,8
1377,128,2.1942541174403303,5.520920629627222,0.9979168584338783,1.0217205769969622,65,118,12.753165245056152,7.446329116821289,63,10
1378,1,11.46427201870902,11.464272018709021,0.9162371613762227,0.9162371613762249,0,0,11.73275375366211,11.73275375366211,1,1
1378,2,10.895796680361643,10.895796680361645,0.9330114106505651,0.9330114106505671,0,0,12.013066291809082,11.73275375366211,2,2
1378,3,9.935758579735165,9.935758579735166,0.9608018566331398,0.9608018566331407,0,0,12.309074401855469,11.73275375366211,3,3
1378,4,8.533699639301952,8.533699639301952,1.0005968640906904,1.0005968640906926,0,0,13.386953353881836,11.73275375366211,4,4
1378,8,8.447284935869884,8.516841673591754,0.9991117767683011,1.0020266090671306,3,3,13.621506690979004,11.73275375366211,5,5
1378,16,7.392092089124986,8.212496532436134,1.0245906891450594,1.0174589615008578,6,8,14.113083839416504,11.73275375366211,10,8
1378,32,6.21306218867623,7.874448701557706,1.0371752987065128,1.0295071963665516,15,23,14.788817405700684,11.73275375366211,17,9
1378,64,5.059086542394058,7.819139922337855,1.0217415226995041,1.0354212696917202,33,52,15.302911758422852,11.73275375366211,31,12
1378,128,2.8617593437571305,7.466256414511949,1.0117833687563262,1.050522074329088,53,114,16.12491226196289,11.73275375366211,75,14
1379,1,8.478946798315901,8.478946798315905,0.9546747689865888,0.9546747689865913,0,0,8.584896087646484,8.584896087646484,1,1
1379,2,6.529336724657849,6.529336724657849,0.9963339428952225,0.9963339428952235,0,0,8.842259407043457,8.584896087646484,2,2
1379,3,6.389687865060859,6.389687865060857,0.9992196056443279,0.9992196056443288,0,0,9.554155349731445,8.584896087646484,3,3
1379,4,6.249091823296628,6.249091823296629,1.0019143511267883,1.0019143511267876,0,0,9.860411643981934,8.584896087646484,4,4
1379,8,5.864597070724902,5.868968921064969,1.0139398978718877,1.013896181176512,2,2,11.022677421569824,8.584896087646484,6,6
1379,16,4.969892379448962,5.762381145614339,1.0131096524404148,1.0173252082958397,5,9,11.94754409790039,8.584896087646484,11,7
1379,32,4.484616117113177,5.720800618979063,1.012307426308106,1.0202634202574608,14,23,12.45362663269043,8.584896087646484,18,9
1379,64,3.58708388809984,5.677307794795433,1.0095501082993406,1.0236648255831857,33,52,13.043724060058594,8.584896087646484,31,12
1379,128,2.1304305115497835,5.6281030878337175,1.0023319821584717,1.0271805998494563,62,114,13.937178611755371,8.584896087646484,66,14
1380,1,15.79072983715094,15.790729837150941,0.8273880201489742,0.8273880201489753,0,0,16.619625091552734,16.619625091552734,1,1
1380,2,15.405375613299652,15.40537561329965,0.8481683197312585,0.8481683197312586,0,0,17.403249740600586,16.619625091552734,2,2
1380,3,15.344655475782432,15.344655475782433,0.8533242989409563,0.8533242989409571,0,0,17.418676376342773,16.619625091552734,3,3
1380,4,13.252396974327628,13.252396974327628,0.9492147990507671,0.9492147990507669,0,0,17.57491111755371,16.619625091552734,4,4
1380,8,12.888174936081736,12.909949425031998,0.9656890883503251,0.9654315192376619,1,1,17.801237106323242,16.619625091552734,7,7
1380,16,11.575134088256211,12.118252689559444,1.0076281604600554,1.004621363900733,6,6,18.16156768798828,16.619625091552734,10,10
1380,32,9.766686280709077,10.968902155938666,1.0570916815389135,1.048596859852851,15,21,18.419397354125977,16.619625091552734,17,11
1380,64,7.872476318320689,10.842538540558348,1.0499300316121747,1.0571071539326717,31,51,18.93525505065918,16.619625091552734,33,13
1380,128,5.477019391311216,10.51038063306373,1.0329437425846357,1.0740711439955994,70,109,19.45686912536621,16.619625091552734,58,19
1381,1,10.239057833524107,10.239057833524107,0.9357978973777089,0.9357978973777105,0,0,10.419452667236328,10.419452667236328,1,1
1381,2,8.631547955170511,8.631547955170511,0.9783571679173284,0.9783571679173293,0,0,10.535587310791016,10.419452667236328,2,2
1381,3,8.285124806423385,8.285124806423385,0.9846341478361669,0.9846341478361671,0,0,10.742521286010742,10.419452667236328,3,3
1381,4,7.909741523718191,7.909741523718192,0.9963571457631848,0.9963571457631848,0,0,10.794394493103027,10.419452667236328,4,4
1381,8,6.776617294954741,6.7857346849382765,1.0140352532540193,1.0142005771037526,2,2,11.246894836425781,10.419452667236328,6,6
1381,16,6.124932333823761,6.555788262068356,1.0220929221083503,1.0219818830226597,7,8,11.580038070678711,10.419452667236328,9,8
1381,32,5.400467038218732,6.412439161572901,1.0295165855324753,1.0269766910895943,17,20,12.118249893188477,10.419452667236328,15,12
1381,64,4.632595662977532,6.389892509977701,1.0249082047712559,1.0292216898548858,33,49,12.720986366271973,10.419452667236328,31,15
1381,128,2.6450765250342503,6.24283071897157,1.0055102592208995,1.0376882287046314,61,112,13.2936372756958,10.419452667236328,67,16
1382,1,8.714564008693813,8.714564008693813,0.9501668537473337,0.9501668537473359,0,0,8.837668418884277,8.837668418884277,1,1
1382,2,7.928929794955007,7.928929794955006,0.9634200354689486,0.9634200354689488,0,0,8.999236106872559,8.837668418884277,2,2
1382,3,6.909535837571858,6.909535837571856,0.9827568142141265,0.9827568142141258,0,0,9.21805191040039,8.837668418884277,3,3
1382,4,6.414277114444531,6.414277114444531,0.9932175464129114,0.9932175464129117,0,0,9.336153030395508,8.837668418884277,4,4
1382,8,5.949506821810814,5.976401221509747,1.0070251941042474,1.005464053405027,2,2,9.915884017944336,8.837668418884277,6,6
1382,16,5.553221551081627,5.63490468302571,1.014602446255465,1.0115109184586288,4,7,10.132872581481934,8.837668418884277,12,9
1382,32,4.650434805089464,5.347285821301072,1.0253680991045078,1.0212525468020839,13,19,10.8848876953125,8.837668418884277,19,13
1382,64,3.3308299028761135,5.172277774223322,1.0114217315915066,1.02661858321833,29,47,11.556025505065918,8.837668418884277,35,17
1382,128,2.141065681032527,5.162234555569253,1.003913607163505,1.0280125471266497,63,109,12.18436050415039,8.837668418884277,65,19
1383,1,8.472379244808089,8.47237924480809,0.9585190977721595,0.958519097772162,0,0,8.561361312866211,8.561361312866211,1,1
1383,2,7.5682027974162756,7.568202797416276,0.9755857972372812,0.9755857972372826,0,0,8.747422218322754,8.561361312866211,2,2
1383,3,6.898791071481813,6.898791071481813,0.9887660110368528,0.9887660110368532,0,0,8.801032066345215,8.561361312866211,3,3
1383,4,6.173885428869819,6.173885428869819,1.0016665262498745,1.001666526249875,0,0,8.88989543914795,8.561361312866211,4,4
1383,8,5.819209992798148,5.930195229279508,1.0079535289493298,1.005338281762177,2,2,9.399889945983887,8.561361312866211,6,6
1383,16,5.132604845103619,5.6765028059896725,1.011811402391559,1.0102768442551449,7,10,10.110249519348145,8.561361312866211,9,6
1383,32,4.33177786481683,5.311037133822168,1.0156633401689126,1.021385351310619,13,19,10.669502258300781,8.561361312866211,19,13
1383,64,3.315698910368616,5.196939472537905,1.006913782273948,1.026235097453098,34,50,11.535073280334473,8.561361312866211,30,14
1383,128,1.9968543266828482,5.192455419710785,0.9984409437976711,1.0268649399513499,68,113,12.364194869995117,8.561361312866211,60,15
1384,1,10.170345771074274,10.170345771074276,0.9474644131349524,0.9474644131349552,0,0,10.291925430297852,10.291925430297852,1,1
1384,2,7.745097781480437,7.745097781480435,0.9979371804871839,0.9979371804871846,0,0,10.651947021484375,10.291925430297852,2,2
1384,3,7.279888498113987,7.279888498113986,1.0088012944295044,1.0088012944295053,0,0,10.84444522857666,10.291925430297852,3,3
1384,4,6.618692067999962,6.618692067999961,1.0198688876938609,1.0198688876938613,0,0,11.24280071258545,10.291925430297852,4,4
1384,8,6.151369083155008,6.151369083155011,1.0340681159042902,1.034068115904288,0,0,12.271268844604492,10.291925430297852,8,8
1384,16,5.678306508078678,5.839563324991996,1.0392412573632486,1.043805792142705,6,7,13.246760368347168,10.291925430297852,10,9
1384,32,5.007907688791329,5.800015220552317,1.0340939160837088,1.047766132897119,13,21,13.738038063049316,10.291925430297852,19,11
1384,64,4.213583030914967,5.795684147146689,1.0239110720580946,1.0482562981869747,35,52,14.706597328186035,10.291925430297852,29,12
1384,128,3.0413595772573134,5.792248600361229,1.012257440704898,1.048867729074491,56,116,15.661686897277832,10.291925430297852,72,12
1385,1,8.237144850355197,8.237144850355198,0.9618006151737577,0.961800615173759,0,0,8.316797256469727,8.316797256469727,1,1
1385,2,7.248672023707761,7.24867202370776,0.9823719861976052,0.9823719861976061,0,0,8.709968566894531,8.316797256469727,2,2
1385,3,7.176278801034289,7.176278801034289,0.9841904484173913,0.9841904484173923,0,0,9.183944702148438,8.316797256469727,3,3
1385,4,6.979076283286827,6.979076283286826,0.9894338707199557,0.989433870719956,0,0,9.184898376464844,8.316797256469727,4,4
1385,8,6.123828095311748,6.123832193518473,1.004516531990417,1.004510964553448,1,1,9.716562271118164,8.316797256469727,7,7
1385,16,5.748468680464293,5.967388759941954,1.0089241957499793,1.0091025819810169,6,8,10.061655044555664,8.316797256469727,10,8
1385,32,4.792473239993995,5.8385597706620285,1.0111981846038725,1.0111486264089655,15,22,10.370437622070312,8.316797256469727,17,10
1385,64,3.054073868955584,5.492942002794991,1.0068587063002883,1.0178119626043005,32,53,10.969352722167969,8.316797256469727,32,11
1385,128,1.77871869548676,5.434579295818091,1.0024521740205032,1.0212392672043331,60,115,11.402724266052246,8.316797256469727,68,13
1386,1,10.861206229671666,10.861206229671664,0.9326193094316427,0.9326193094316456,0,0,11.045892715454102,11.045892715454102,1,1
1386,2,8.292051638355797,8.292051638355797,1.0022342663661303,1.002234266366132,0,0,13.33972454071045,11.045892715454102,2,2
1386,3,7.677573694633293,7.677573694633297,1.0201931847915184,1.0201931847915207,0,0,13.501289367675781,11.045892715454102,3,3
1386,4,7.595785570803926,7.595785570803925,1.0240816884709514,1.0240816884709525,0,0,13.764185905456543,11.045892715454102,4,4
1386,8,6.902206546137228,6.902206546137226,1.042774683419847,1.0427746834198501,0,0,14.289238929748535,11.045892715454102,8,8
1386,16,6.597206651632681,6.690946417718154,1.051724799906793,1.054321774577694,6,6,14.742544174194336,11.045892715454102,10,10
1386,32,6.044345920002408,6.4407750187428965,1.0555086018253133,1.060985356830678,17,20,15.109933853149414,11.045892715454102,15,12
1386,64,5.394374783608389,6.42693009449802,1.045927096125825,1.063659452160496,31,48,15.789347648620605,11.045892715454102,33,16
1386,128,3.532004437550526,6.308873751664759,1.0262207051138983,1.071902255279893,67,112,16.465560913085938,11.045892715454102,61,16
1387,1,10.583460803242223,10.58346080324222,0.928256778928099,0.9282567789281007,0,0,10.803519248962402,10.803519248962402,1,1
1387,2,9.039754171146075,9.039754171146077,0.9743206385308293,0.9743206385308307,0,0,11.079657554626465,10.803519248962402,2,2
1387,3,8.21062834014886,8.210628340148858,0.9911718814468623,0.9911718814468631,0,0,11.2853364944458,10.803519248962402,3,3
1387,4,8.152216404441306,8.152216404441306,0.9908993222697949,0.9908993222697955,0,0,11.289252281188965,10.803519248962402,4,4
1387,8,7.696013923946048,7.696013923946047,0.9979840206725277,0.997984020672527,0,0,11.464406967163086,10.803519248962402,8,8
1387,16,7.033355745707892,7.1648058647516235,1.0148892422274833,1.0113918419664856,4,4,11.75854206085205,10.803519248962402,12,12
1387,32,6.462384946788045,6.852575368536843,1.0200627474128332,1.0175240473106764,13,18,12.003023147583008,10.803519248962402,19,14
1387,64,5.1570580683042175,6.821221922204553,1.014094893847025,1.0198210335977826,26,50,12.240970611572266,10.803519248962402,38,14
1387,128,3.497134438597575,6.692315244910444,1.0113152752513879,1.0241820583464147,64,111,12.429831504821777,10.803519248962402,64,17
1388,1,8.378477670753105,8.378477670753107,0.9544843449478916,0.9544843449478932,0,0,8.489277839660645,8.489277839660645,1,1
1388,2,6.474846542024689,6.4748465420246895,0.9891291390098378,0.9891291390098393,0,0,8.513876914978027,8.489277839660645,2,2
1388,3,6.39987332124759,6.399873321247591,0.9904094127460967,0.9904094127460973,0,0,9.002674102783203,8.489277839660645,3,3
1388,4,6.225854736001646,6.225854736001646,0.9920983402692536,0.9920983402692527,0,0,9.087267875671387,8.489277839660645,4,4
1388,8,5.675696115228409,5.675696115228409,1.0051654239934307,1.00516542399343,0,0,9.759376525878906,8.489277839660645,8,8
1388,16,5.3344428866778495,5.49259798680104,1.0120352604697205,1.0098606533452164,5,6,10.387639045715332,8.489277839660645,11,10
1388,32,4.1290445671098635,5.058000382198169,1.0176554390629642,1.0248966805525725,12,19,10.862692832946777,8.489277839660645,20,13
1388,64,3.1518116472268285,4.720688583561365,1.01361990015707,1.0296364157650872,30,46,11.415841102600098,8.489277839660645,34,18
1388,128,1.856199398742791,4.664054561128385,1.0031699299857322,1.0318013743135106,65,108,12.023330688476562,8.489277839660645,63,20
1389,1,6.410532726770105,6.410532726770107,0.9816947232654272,0.9816947232654316,0,0,6.433588027954102,6.433588027954102,1,1
1389,2,5.648727650975503,5.648727650975504,0.9957477131841981,0.9957477131842012,0,0,7.456810474395752,6.433588027954102,2,2
1389,3,5.53035549196692,5.53035549196692,0.9987033224631203,0.9987033224631225,0,0,7.864275932312012,6.433588027954102,3,3
1389,4,5.399693091805864,5.399693091805864,0.9996219646960683,0.9996219646960705,0,0,8.056023597717285,6.433588027954102,4,4
1389,8,4.918470465863779,4.987202994243777,1.005810288698441,1.0076022740350141,2,2,8.723755836486816,6.433588027954102,6,6
1389,16,4.697736925426873,4.8655393677923096,1.0111748266906317,1.0138125497813182,4,6,9.528837203979492,6.433588027954102,12,10
1389,32,3.6105200441815355,4.704174845616383,1.0141635184573192,1.0225357273839468,14,19,10.21562385559082,6.433588027954102,18,13
1389,64,2.8302920934640947,4.333665078602919,1.013548608407761,1.0292038197181674,28,48,10.89884090423584,6.433588027954102,36,16
1389,128,1.7407832887293346,4.273198700642983,1.003706068461639,1.0349016651456935,59,110,11.844480514526367,6.433588027954102,69,18
1390,1,2.8879921266899693,2.8879921266899697,0.9989193725615282,0.998919372561529,0,0,2.888190507888794,2.888190507888794,1,1
1390,2,2.3095710562535867,2.3095710562535863,1.000759042559073,1.0007590425590729,0,0,3.15539288520813,2.888190507888794,2,2
1390,3,2.2587714681699524,2.2587714681699524,1.0013157041730985,1.0013157041730982,0,0,3.314258098602295,2.888190507888794,3,3
1390,4,2.096129463679946,2.096129463679946,1.0027004861378424,1.0027004861378424,0,0,3.5250091552734375,2.888190507888794,4,4
1390,8,1.9852857988599653,2.004577370052337,1.0036820082452897,1.0035530871943021,1,1,3.7823848724365234,2.888190507888794,7,7
1390,16,1.787173224600265,1.8222440889387719,1.0055377584798137,1.005426968446002,5,5,4.063648223876953,2.888190507888794,11,11
1390,32,1.391693899623968,1.688974846249961,1.003458058616749,1.0058860183479097,13,16,4.372890472412109,2.888190507888794,19,16
1390,64,0.5988472418174295,1.623369681404206,1.0007816613565348,1.0066432245988177,33,48,4.697220325469971,2.888190507888794,31,16
1390,128,0.07537195535688994,1.5929598072043947,0.9998244947720236,1.006651828701146,64,113,5.1126627922058105,2.888190507888794,64,15
1391,1,12.205619078335909,12.205619078335905,0.9025081180576179,0.9025081180576209,0,0,12.537646293640137,12.537646293640137,1,1
1391,2,10.165445372246774,10.165445372246776,0.9672281489644399,0.9672281489644423,0,0,12.834100723266602,12.537646293640137,2,2
1391,3,9.112521794385403,9.1125217943854,0.9972480290783371,0.9972480290783392,0,0,13.19570255279541,12.537646293640137,3,3
1391,4,8.64704211727547,8.647042117275472,1.0071504293051878,1.007150429305189,0,0,13.451282501220703,12.537646293640137,4,4
1391,8,8.313484126006182,8.313484126006182,1.0162774118645286,1.01627741186453,0,0,13.983491897583008,12.537646293640137,8,8
1391,16,7.298845798141193,7.596856911257849,1.0397685365417657,1.0407710749077501,3,4,14.698055267333984,12.537646293640137,13,12
1391,32,6.5739027616081,7.303667793003071,1.0475465847804604,1.053614662059046,14,19,15.16549015045166,12.537646293640137,18,13
1391,64,5.281611275816736,7.218759517119692,1.0396483747759742,1.0580008246826504,32,49,15.746912002563477,12.537646293640137,32,15
1391,128,3.2204163600506863,7.214885244502328,1.00764604634952,1.0578872766656044,61,113,16.414669036865234,12.537646293640137,67,15
1392,1,8.889266385109558,8.88926638510956,0.9498696236787679,0.9498696236787693,0,0,9.017706871032715,9.017706871032715,1,1
1392,2,8.267916912716046,8.267916912716046,0.9631108978039873,0.9631108978039882,0,0,9.01917552947998,9.017706871032715,2,2
1392,3,7.011251356268568,7.011251356268568,0.9894038100584317,0.9894038100584325,0,0,9.183454513549805,9.017706871032715,3,3
1392,4,6.992871899073586,6.992871899073585,0.9898840991868316,0.989884099186832,0,0,9.404884338378906,9.017706871032715,4,4
1392,8,6.144729349548763,6.219976304781631,1.0063487918373726,1.0058315484436269,1,1,9.827250480651855,9.017706871032715,7,7
1392,16,5.624301443033174,5.917336383122729,1.0160307533561936,1.0130917302920435,6,8,10.042856216430664,9.017706871032715,10,8
1392,32,4.954075989954552,5.686369625300484,1.0184122975609946,1.0204644683602897,12,21,10.898383140563965,9.017706871032715,20,11
1392,64,3.3633915239557552,5.5054977660276725,1.0073729200309507,1.0235744331258827,27,52,11.642006874084473,9.017706871032715,37,12
1392,128,1.7308166906670583,5.261747725315907,1.00008121166998,1.0323968769067857,62,113,12.324355125427246,9.017706871032715,66,15
1393,1,5.43553845409254,5.43553845409254,0.9850891188052894,0.9850891188052894,0,0,5.454726696014404,5.454726696014404,1,1
1393,2,4.899313688935295,4.899313688935294,0.9924144480635855,0.9924144480635849,0,0,6.130001544952393,5.454726696014404,2,2
1393,3,4.474161919182331,4.474161919182331,0.9975209244393399,0.9975209244393393,0,0,6.61016321182251,5.454726696014404,3,3
1393,4,4.400074656659975,4.400074656659975,0.9983235564278932,0.998323556427892,0,0,6.9456915855407715,5.454726696014404,4,4
1393,8,4.133809949954083,4.142870152141658,1.0008511159520164,1.000958809869109,1,1,7.215061664581299,5.454726696014404,7,7
1393,16,3.6223867098417966,3.9714258221133445,1.0072534981210493,1.0054390142220941,6,9,7.779139518737793,5.454726696014404,10,7
1393,32,3.087688884465745,3.8476350587794887,1.0073328893733962,1.0070708037848175,15,21,8.26352596282959,5.454726696014404,17,11
1393,64,1.9349353236934486,3.737066079195076,1.001617314361709,1.0099321639336998,26,55,9.35035514831543,5.454726696014404,38,9
1393,128,0.8968483288567063,3.4943016884369076,0.9999611779328685,1.0149347667913393,61,119,10.294746398925781,5.454726696014404,67,9
1394,1,9.147785720275495,9.147785720275499,0.9554306721585129,0.9554306721585153,0,0,9.245906829833984,9.245906829833984,1,1
1394,2,7.36027861708696,7.36027861708696,1.0044672274412978,1.0044672274412998,0,0,11.023282051086426,9.245906829833984,2,2
1394,3,6.892027293805009,6.892027293805009,1.0109448109002668,1.010944810900268,0,0,11.188667297363281,9.245906829833984,3,3
1394,4,6.557940347702831,6.557940347702832,1.0174583998367739,1.0174583998367732,0,0,11.30185604095459,9.245906829833984,4,4
1394,8,5.974504449080085,5.97607474453804,1.0261608409601308,1.0263946196847278,1,1,11.554028511047363,9.245906829833984,7,7
1394,16,5.610453122038348,5.735434227406091,1.03010293264348,1.0327577374535126,4,4,12.185731887817383,9.245906829833984,12,12
1394,32,5.041310907162528,5.709392114112418,1.0286201913368602,1.0342778600426914,12,19,12.754343032836914,9.245906829833984,20,13
1394,64,4.241914063711967,5.691334923333291,1.0191408900903225,1.0373635938650079,32,49,13.376913070678711,9.245906829833984,32,15
1394,128,2.731487412734821,5.666526603347037,1.0081131730977257,1.0394424579983443,59,110,13.828446388244629,9.245906829833984,69,18
1395,1,9.325580366585875,9.325580366585875,0.9422478502119516,0.942247850211953,0,0,9.479864120483398,9.479864120483398,1,1
1395,2,8.141717534423021,8.141717534423021,0.9810369618989578,0.9810369618989585,0,0,12.579314231872559,9.479864120483398,2,2
1395,3,8.138309655593474,8.138309655593474,0.9822115526780241,0.9822115526780245,0,0,12.911998748779297,9.479864120483398,3,3
1395,4,7.9992405687796895,8.010370557862082,0.989308365961528,0.9903656175980603,1,1,13.08903980255127,9.479864120483398,3,3
1395,8,7.679636314739554,7.740438050893899,1.0050646042414297,1.0060248132323282,1,1,13.641380310058594,9.479864120483398,7,7
1395,16,7.299687660738039,7.517777556064481,1.018990994583362,1.0159895453576169,4,7,13.976665496826172,9.479864120483398,12,9
1395,32,6.705504285775179,7.3364341155666,1.0253221293658425,1.0240672369991475,13,23,14.67898941040039,9.479864120483398,19,9
1395,64,4.812837461094422,7.126865701167398,1.0203670265012366,1.0364294051419765,29,51,15.32760238647461,9.479864120483398,35,13
1395,128,3.110138202724442,7.103707110985379,1.0083043205155753,1.0385370548259885,65,111,15.91812801361084,9.479864120483398,63,17
1396,1,12.208660655912196,12.208660655912198,0.9088745464756758,0.9088745464756786,0,0,12.501460075378418,12.501460075378418,1,1
1396,2,11.335827447618797,11.335827447618795,0.9334698948811331,0.9334698948811339,0,0,13.08588695526123,12.501460075378418,2,2
1396,3,10.802062728983518,10.802062728983516,0.9508288127576501,0.9508288127576501,0,0,13.3471097946167,12.501460075378418,3,3
1396,4,9.751611825021234,9.751611825021234,0.9828626253817367,0.9828626253817367,0,0,13.360721588134766,12.501460075378418,4,4
1396,8,9.401400230309868,9.464489354570071,0.9924022197776172,0.990201885489737,1,2,13.725769996643066,12.501460075378418,7,6
1396,16,8.873656454565564,9.21139654398725,1.007329127300323,1.0000327907372768,4,8,14.051983833312988,12.501460075378418,12,8
1396,32,7.623131988938958,8.57422391421465,1.0389819819342225,1.022774365720157,13,20,14.559697151184082,12.501460075378418,19,12
1396,64,5.7180353872825584,8.195867487356729,1.037183817361167,1.0388245339874338,29,48,14.979985237121582,12.501460075378418,35,16
1396,128,3.9008581088399454,7.741221131895279,1.0140647657727129,1.0553629030476266,57,112,15.463096618652344,12.501460075378418,71,16
1397,1,10.426791011250058,10.426791011250067,0.9300919090179856,0.93009190901799,0,0,10.630069732666016,10.630069732666016,1,1
1397,2,8.257556904235058,8.257556904235058,0.9830982588655911,0.9830982588655935,0,0,11.283866882324219,10.630069732666016,2,2
1397,3,7.708853941197811,7.708853941197812,0.9970006550718313,0.9970006550718331,0,0,11.61302661895752,10.630069732666016,3,3
1397,4,7.673632530571646,7.6736325305716475,0.9980207007546054,0.9980207007546071,0,0,11.933305740356445,10.630069732666016,4,4
1397,8,6.532715181665906,6.738591700852122,1.0227687165811878,1.0201036382711814,2,2,12.606461524963379,10.630069732666016,6,6
1397,16,6.213977400082537,6.503494008193102,1.0274309295917141,1.0282135641164398,6,7,13.265157699584961,10.630069732666016,10,9
1397,32,5.447611629368798,6.388381995614326,1.0295234067208139,1.036374435619813,15,20,13.998190879821777,10.630069732666016,17,12
1397,64,4.463768702429371,6.329752040320801,1.0251461279404408,1.0406383965990185,25,49,14.69992733001709,10.630069732666016,39,15
1397,128,2.9233804921639854,6.206486226303652,1.0085614566374723,1.047388530814366,58,109,15.439180374145508,10.630069732666016,70,19
1398,1,7.923752345847656,7.923752345847647,0.9630788295084257,0.9630788295084286,0,0,8.00076675415039,8.00076675415039,1,1
1398,2,5.888494549366539,5.8884945493665395,0.9967945019713541,0.9967945019713551,0,0,8.093306541442871,8.00076675415039,2,2
1398,3,5.556042047776204,5.556042047776203,1.00071231122919,1.0007123112291907,0,0,8.16461181640625,8.00076675415039,3,3
1398,4,4.893331659835454,4.893331659835454,1.0095753755166923,1.0095753755166932,0,0,8.362980842590332,8.00076675415039,4,4
1398,8,4.642936978122464,4.665671658365094,1.0127230407618815,1.0132362636193633,2,2,9.186226844787598,8.00076675415039,6,6
1398,16,4.047584927181686,4.348578995318883,1.0200089758773776,1.0233537245876392,5,6,9.843179702758789,8.00076675415039,11,10
1398,32,3.6421947773826306,4.259201983038626,1.0170854273044396,1.026060673670974,15,17,10.566100120544434,8.00076675415039,17,15
1398,64,2.829284644795295,4.228589570741235,1.0088477308187696,1.0285355215060328,30,48,11.403646469116211,8.00076675415039,34,16
1398,128,1.8162692339396818,4.203350644859118,1.0028010065988142,1.0305904977561136,70,110,12.239618301391602,8.00076675415039,58,18
1399,1,6.182798142064188,6.182798142064189,0.9765038753409787,0.9765038753409794,0,0,6.222607135772705,6.222607135772705,1,1
1399,2,5.032217709539635,5.032217709539635,0.9958900540659974,0.9958900540659978,0,0,7.180593967437744,6.222607135772705,2,2
1399,3,4.7810582139018845,4.7810582139018845,0.9999449984064377,0.9999449984064378,0,0,7.598360538482666,6.222607135772705,3,3
1399,4,3.98068663326305,3.9806866332630495,1.0101441238361635,1.0101441238361648,0,0,7.624322414398193,6.222607135772705,4,4
1399,8,3.778117726425074,3.783834810055069,1.0120988303280742,1.0123911519915885,1,2,8.522517204284668,6.222607135772705,7,6
1399,16,3.6833668155799733,3.779733761539977,1.0109026901778706,1.013041218720168,5,7,9.108084678649902,6.222607135772705,11,9
1399,32,3.0481875597746266,3.5627082929477365,1.0086623232865775,1.0180336984433354,14,23,10.106575965881348,6.222607135772705,18,9
1399,64,2.023553387469665,3.540438257056574,1.0032411281090496,1.020203795282268,30,54,10.996909141540527,6.222607135772705,34,10
1399,128,1.2543757753384577,3.5282613324417222,1.0010003477782434,1.0220310681322724,64,114,12.081170082092285,6.222607135772705,64,14
1400,1,7.706089544506226,7.706089544506226,0.9631485670907104,0.9631485670907098,0,0,7.7862548828125,7.7862548828125,1,1
1400,2,6.345717422321398,6.345717422321398,0.989983898971682,0.9899838989716812,0,0,8.325185775756836,7.7862548828125,2,2
1400,3,5.6456845518644325,5.645684551864432,1.002086356896716,1.002086356896715,0,0,8.67802906036377,7.7862548828125,3,3
1400,4,5.345548084874615,5.345548084874616,1.0086085953461634,1.008608595346163,0,0,8.810434341430664,7.7862548828125,4,4
1400,8,5.020039843680043,5.020713768135948,1.014116718800372,1.014208847508424,1,1,9.45868968963623,7.7862548828125,7,7
1400,16,4.704648812814374,4.776494929950647,1.0185433597216285,1.0202030698070457,6,7,10.036684036254883,7.7862548828125,10,9
1400,32,4.104959327183251,4.729052984610657,1.0124978515390488,1.0221931643725388,13,20,10.719561576843262,7.7862548828125,19,12
1400,64,3.1220720583114985,4.706779638447187,1.005992914212591,1.0256678147876612,32,48,11.490927696228027,7.7862548828125,32,16
1400,128,1.408379767744653,4.705425452953168,0.9993181750256481,1.0258458134517716,63,111,12.330060958862305,7.7862548828125,65,17
1401,1,8.42822110047403,8.428221100474032,0.9557626778511987,0.9557626778512001,0,0,8.53396224975586,8.53396224975586,1,1
1401,2,6.293438375197822,6.293438375197822,0.9884023831728758,0.9884023831728775,0,0,8.582147598266602,8.53396224975586,2,2
1401,3,6.209707344416999,6.209707344417,0.9899707373065205,0.9899707373065213,0,0,9.130428314208984,8.53396224975586,3,3
1401,4,5.9083354864984825,5.911144602087372,0.9950321439326832,0.995003669194651,1,1,9.153095245361328,8.53396224975586,3,3
1401,8,5.653654113941963,5.701085578736982,1.001769448420883,1.001499804514204,2,2,10.039996147155762,8.53396224975586,6,6
1401,16,5.303767089183819,5.645246311914767,1.0073614945837621,1.0051964697054967,6,8,10.747486114501953,8.53396224975586,10,8
1401,32,4.59586913095763,5.461770869611289,1.0116246282624997,1.0134068803578224,14,20,11.231793403625488,8.53396224975586,18,12
1401,64,3.4783155315984127,4.966456715806181,1.0141053361912182,1.0283913889643166,33,51,11.999334335327148,8.53396224975586,31,13
1401,128,1.9691245536883666,4.8859263214584105,1.0023616258846184,1.02933247386926,64,113,12.631850242614746,8.53396224975586,64,15
1402,1,9.23610781325026,9.236107813250262,0.9494833894207848,0.9494833894207867,0,0,9.355860710144043,9.355860710144043,1,1
1402,2,8.34744504351092,8.34744504351092,0.9749888999470473,0.9749888999470488,0,0,10.469195365905762,9.355860710144043,2,2
1402,3,7.336571191611013,7.336571191611012,0.9949856656412563,0.9949856656412582,0,0,10.692607879638672,9.355860710144043,3,3
1402,4,7.325657371203208,7.325657371203208,0.9954874936797317,0.9954874936797334,0,0,11.052499771118164,9.355860710144043,4,4
1402,8,5.743529279497043,5.788290319673969,1.025698036719682,1.0266526677420083,2,2,11.484820365905762,9.355860710144043,6,6
1402,16,5.594602854430724,5.694157879148907,1.0289910596676046,1.0301786688510535,4,9,12.143004417419434,9.355860710144043,12,7
1402,32,4.487907584768232,5.672738043459072,1.0147002216242211,1.0318767406975216,18,24,12.87718391418457,9.355860710144043,14,8
1402,64,3.47922514666479,5.639173748753504,1.0088342088820006,1.0343618050783487,33,52,13.814743041992188,9.355860710144043,31,12
1402,128,2.0638744000245235,5.619481205253768,1.0052802294860919,1.0369447568016426,59,113,14.572182655334473,9.355860710144043,69,15
1403,1,9.283112683404715,9.283112683404715,0.9509865021399542,0.9509865021399555,0,0,9.396280288696289,9.396280288696289,1,1
1403,2,8.351388735633334,8.351388735633334,0.9706246087771306,0.9706246087771307,0,0,10.211983680725098,9.396280288696289,2,2
1403,3,7.536976264978179,7.536976264978179,0.9919481175190455,0.9919481175190452,0,0,10.243175506591797,9.396280288696289,3,3
1403,4,7.429967951860864,7.4299679518608635,0.9935526313067722,0.9935526313067716,0,0,10.76880168914795,9.396280288696289,4,4
1403,8,7.065152378572065,7.079959745468234,1.0021670708722847,1.003431432840689,1,2,11.52436351776123,9.396280288696289,7,6
1403,16,6.361654730837462,6.709480063429045,1.0187380028252038,1.0162987832476094,5,8,11.99635124206543,9.396280288696289,11,8
1403,32,5.398615168449567,6.65594189439969,1.0171675013305121,1.0178187559812382,13,21,12.543374061584473,9.396280288696289,19,11
1403,64,4.387728418637918,6.537216253899013,1.019012578449585,1.0249676263242342,31,50,13.394513130187988,9.396280288696289,33,14
1403,128,2.4920522973228936,6.331669575004587,1.0049509651904422,1.037666608394734,65,113,14.383981704711914,9.396280288696289,63,15
1404,1,9.443493646289042,9.443493646289038,0.9540329676524183,0.95403296765242,0,0,9.543508529663086,9.543508529663086,1,1
1404,2,8.156890809693293,8.156890809693294,0.9825744193905149,0.9825744193905159,0,0,9.687199592590332,9.543508529663086,2,2
1404,3,7.172159521481386,7.172159521481385,1.0046382079821243,1.0046382079821246,0,0,10.6702880859375,9.543508529663086,3,3
1404,4,6.353429982066361,6.353429982066361,1.0185582236869457,1.0185582236869457,0,0,10.749484062194824,9.543508529663086,4,4
1404,8,6.188152783990736,6.218572231400479,1.0239564063764364,1.0239482402106796,1,1,11.650660514831543,9.543508529663086,7,7
1404,16,5.770721405957437,6.158201101375519,1.0268507217379959,1.026356813851278,6,8,12.12594223022461,9.543508529663086,10,8
1404,32,5.435048637912237,6.075570194356084,1.0260911661786682,1.0315975479036474,16,22,12.639078140258789,9.543508529663086,16,10
1404,64,4.122535567347349,6.03948024441254,1.0162098686437349,1.034187754806557,35,51,13.39239501953125,9.543508529663086,29,13
1404,128,2.2531107110438926,5.8219737859953,1.0059221447361788,1.04040913042935,55,117,14.21042251586914,9.543508529663086,73,11
1405,1,7.421644096985944,7.421644096985931,0.9608586530633132,0.9608586530633155,0,0,7.510961055755615,7.510961055755615,1,1
1405,2,6.8723706119646755,6.872370611964677,0.9740557366536979,0.9740557366536996,0,0,9.28966999053955,7.510961055755615,2,2
1405,3,6.0906951778711464,6.090695177871147,0.9934538205379979,0.9934538205379996,0,0,9.563036918640137,7.510961055755615,3,3
1405,4,6.083655479102751,6.083655479102752,0.9941148912809383,0.9941148912809393,0,0,9.62297248840332,7.510961055755615,4,4
1405,8,5.8088097786472614,5.817356045461055,1.0014748050640059,1.0028718702521555,2,2,9.866206169128418,7.510961055755615,6,6
1405,16,4.971627242712296,5.195586607621611,1.010281661259156,1.0120768101415907,7,7,10.440226554870605,7.510961055755615,9,9
1405,32,4.077262046124091,4.7950743253733545,1.0171008329513995,1.0215979235213106,13,21,11.035715103149414,7.510961055755615,19,11
1405,64,3.3823327141981885,4.6663749487777855,1.0121519781711563,1.0277947869270803,31,51,11.87924575805664,7.510961055755615,33,13
1405,128,1.7888495242349904,4.612825146088122,1.0006981148584575,1.0309079631137874,63,115,12.741327285766602,7.510961055755615,65,13
1406,1,9.753043697944722,9.753043697944717,0.9410275806802583,0.9410275806802595,0,0,9.914103507995605,9.914103507995605,1,1
1406,2,8.028310022583314,8.028310022583312,0.9794070890626116,0.9794070890626112,0,0,10.213956832885742,9.914103507995605,2,2
1406,3,7.383487352482151,7.383487352482151,0.995331175324902,0.9953311753249012,0,0,11.128076553344727,9.914103507995605,3,3
1406,4,7.0184719441140535,7.018471944114053,1.0030131164555292,1.0030131164555285,0,0,11.258548736572266,9.914103507995605,4,4
1406,8,6.7741038842228924,6.841778014526812,1.0095165119861367,1.0089220260305456,2,2,11.788348197937012,9.914103507995605,6,6
1406,16,6.5215946744507916,6.7901603989831605,1.0135307109191132,1.013190581229257,5,6,12.635212898254395,9.914103507995605,11,10
1406,32,5.634741660330664,6.727751137801806,1.0159380768358468,1.0168088392081536,14,18,13.276751518249512,9.914103507995605,18,14
1406,64,4.415606901081666,6.512243419458011,1.0120350246383423,1.0323908231110168,32,49,13.877120971679688,9.914103507995605,32,15
1406,128,2.66661497401217,6.506998168475386,1.005660039508648,1.0337701314065602,64,110,14.890575408935547,9.914103507995605,64,18
1407,1,9.13395714343338,9.13395714343337,0.9368441262168195,0.936844126216823,0,0,9.322361946105957,9.322361946105957,1,1
1407,2,7.503314076816338,7.503314076816339,0.9719168084906253,0.9719168084906276,0,0,9.605987548828125,9.322361946105957,2,2
1407,3,7.102621458820471,7.102621458820471,0.979716059721855,0.9797160597218553,0,0,9.713027000427246,9.322361946105957,3,3
1407,4,6.96491223087321,6.964912230873211,0.9840390853630685,0.9840390853630687,0,0,10.468865394592285,9.322361946105957,4,4
1407,8,6.831792575966095,6.852923000303828,0.9868804127300121,0.9870335631490821,1,1,10.84675121307373,9.322361946105957,7,7
1407,16,6.331597498572712,6.556133413774177,0.9970467173676942,0.9969414199757104,5,8,11.757010459899902,9.322361946105957,11,8
1407,32,5.653743886094491,6.423097128946546,0.9979048493399638,1.0040503788955404,14,23,12.608692169189453,9.322361946105957,18,9
1407,64,4.5629643986130395,6.3373990411381795,1.0051908765010644,1.0117747819017757,29,51,13.484009742736816,9.322361946105957,35,13
1407,128,3.1301455132649427,6.210353825085466,1.0033654675896915,1.019640417220616,55,115,14.404473304748535,9.322361946105957,73,13
1408,1,10.124054680218944,10.124054680218949,0.9413564146409992,0.9413564146410024,0,0,10.27204704284668,10.27204704284668,1,1
1408,2,8.365727922865535,8.365727922865535,0.9904116304653274,0.9904116304653292,0,0,10.817326545715332,10.27204704284668,2,2
1408,3,8.149646981455309,8.149646981455309,0.9948554726169412,0.9948554726169424,0,0,10.924440383911133,10.27204704284668,3,3
1408,4,7.980232202748891,7.98023220274889,0.9987476554628557,0.9987476554628565,0,0,11.362730979919434,10.27204704284668,4,4
1408,8,7.636208529835071,7.731349352787486,1.0070480901452883,1.0062115629116166,1,2,12.39425277709961,10.27204704284668,7,6
1408,16,6.870761334479032,7.290936888164516,1.0270555186604533,1.0226503114313137,4,8,12.973281860351562,10.27204704284668,12,8
1408,32,5.857028185590545,6.629264450380744,1.0409987730533696,1.043320291059422,15,21,13.456522941589355,10.27204704284668,17,11
1408,64,4.934966762641145,6.440354787812107,1.0281588373000086,1.0480223421279748,33,52,14.060165405273438,10.27204704284668,31,12
1408,128,2.9123785154345665,6.438049031952464,1.0091378392948196,1.048774787728056,66,113,14.504429817199707,10.27204704284668,62,15
1409,1,4.3825688265057545,4.38256882650575,0.9887285304225424,0.9887285304225444,0,0,4.396395206451416,4.396395206451416,1,1
1409,2,3.2649796681216974,3.264979668121697,0.998456660063828,0.9984566600638292,0,0,4.653781890869141,4.396395206451416,2,2
1409,3,3.1834659007007122,3.1834659007007122,0.9989300196198422,0.9989300196198432,0,0,4.946112155914307,4.396395206451416,3,3
1409,4,3.181463970702811,3.181463970702811,0.9990355539778055,0.9990355539778074,0,0,4.999525547027588,4.396395206451416,4,4
1409,8,2.8515468749568256,3.117165985145048,0.999762853870977,1.000111123997709,3,3,5.376815319061279,4.396395206451416,5,5
1409,16,2.3395063999002055,2.82495774543796,1.005146235182455,1.0043083979669678,6,6,5.963596343994141,4.396395206451416,10,10
1409,32,1.8125026232448573,2.6014384507819623,1.0031637961710098,1.0072183090192695,11,23,6.547118663787842,4.396395206451416,21,9
1409,64,1.1542389963127502,2.5241455755675957,1.0013548218602386,1.0090092781928823,29,51,7.153494834899902,4.396395206451416,35,13
1409,128,0.25560840980296884,2.502354510335112,0.9996658576295903,1.009750871844371,65,115,7.932680130004883,4.396395206451416,63,13
1410,1,10.984042466169212,10.984042466169218,0.9280094338698268,0.9280094338698291,0,0,11.193395614624023,11.193395614624023,1,1
1410,2,8.347192170736092,8.34719217073609,0.9907164611129543,0.9907164611129551,0,0,11.216355323791504,11.193395614624023,2,2
1410,3,8.258831141007805,8.258831141007805,0.9935683648250397,0.9935683648250401,0,0,11.658902168273926,11.193395614624023,3,3
1410,4,7.914093434471928,7.926236187616741,1.0024528903144247,1.00229554546214,1,1,11.885594367980957,11.193395614624023,3,3
1410,8,7.531215065428062,7.558905683061445,1.0125846554389049,1.0120666117493013,1,1,12.35670280456543,11.193395614624023,7,7
1410,16,7.168221060962171,7.253794921403558,1.0174500679618517,1.019494960378637,6,8,12.803749084472656,11.193395614624023,10,8
1410,32,5.9911477809283165,6.592493513748681,1.0360087265632114,1.0394697658249246,12,20,13.81871509552002,11.193395614624023,20,12
1410,64,4.014879605849804,6.16379531221679,1.0242965769932706,1.0595023562572174,31,47,14.677725791931152,11.193395614624023,33,17
1410,128,2.414261340838325,6.053439351927108,1.0103132271929047,1.0657560434518165,64,107,15.667014122009277,11.193395614624023,64,21
1411,1,9.571614216388264,9.57161421638826,0.9417388372034472,0.9417388372034483,0,0,9.729911804199219,9.729911804199219,1,1
1411,2,9.050852140022654,9.050852140022654,0.955147428552063,0.9551474285520634,0,0,10.326772689819336,9.729911804199219,2,2
1411,3,8.385845031307092,8.385845031307092,0.9721079808527351,0.9721079808527355,0,0,10.950300216674805,9.729911804199219,3,3
1411,4,8.30503957380972,8.307048931740827,0.9762866753227486,0.9761192953661775,1,1,11.027213096618652,9.729911804199219,3,3
1411,8,8.123245939807106,8.152599192677872,0.9845931265194641,0.9824172773216766,1,1,11.209827423095703,9.729911804199219,7,7
1411,16,7.828440335087389,7.930352540830091,0.9945642237621877,0.9918116890805792,4,5,11.673306465148926,9.729911804199219,12,11
1411,32,6.659428148804372,7.920860872891829,0.9931866082814738,0.9929737146508459,13,20,12.378985404968262,9.729911804199219,19,12
1411,64,5.399278877837487,7.5954466924857185,0.9935930455032296,1.0086056781201684,29,51,12.951264381408691,9.729911804199219,35,13
1411,128,3.970463651899081,7.50064446226281,0.9849596863472825,1.0131674986533885,66,115,13.51294231414795,9.729911804199219,62,13
1412,1,10.739201278788117,10.73920127878812,0.9266346387448711,0.9266346387448733,0,0,10.964037895202637,10.964037895202637,1,1
1412,2,10.268414638985377,10.268414638985378,0.9486928894249734,0.9486928894249755,0,0,12.603050231933594,10.964037895202637,2,2
1412,3,9.511812903633528,9.511812903633528,0.9754465961864234,0.9754465961864245,0,0,13.000130653381348,10.964037895202637,3,3
1412,4,8.845595655172442,8.845595655172442,0.9949615606019644,0.9949615606019648,0,0,13.2197904586792,10.964037895202637,4,4
1412,8,8.063100049668863,8.587113742992749,1.0119354767726159,1.00830367608741,1,1,13.63232707977295,10.964037895202637,7,7
1412,16,7.118709372784664,8.567519781046764,1.0189018220437323,1.010800765095502,6,8,14.263304710388184,10.964037895202637,10,8
1412,32,6.188231196403335,8.151265477364468,1.0263355160636602,1.027408775033966,14,22,14.838409423828125,10.964037895202637,18,10
1412,64,4.3056756365388145,7.7560893573036545,1.0177458529538943,1.0456277411073684,27,51,15.653931617736816,10.964037895202637,37,13
1412,128,2.7369361658625095,7.380626180418035,1.0106382716765991,1.0563680757754215,55,115,16.34739112854004,10.964037895202637,73,13
1413,1,2.249463037766511,2.249463037766511,0.9950083793722905,0.9950083793722911,0,0,2.2547640800476074,2.2547640800476074,1,1
1413,2,2.1622548353491338,2.162254835349134,0.9957117277259455,0.9957117277259458,0,0,2.9364843368530273,2.2547640800476074,2,2
1413,3,2.0849409538370085,2.0849409538370085,0.9963748595514563,0.9963748595514569,0,0,2.9485836029052734,2.2547640800476074,3,3
1413,4,2.084314890997674,2.0849409538370085,0.9963293128227558,0.9963748595514569,1,1,3.0610623359680176,2.2547640800476074,3,3
1413,8,2.0363148430802838,2.039137592328389,0.9967405702305102,0.996802181928257,3,3,3.2516157627105713,2.2547640800476074,5,5
1413,16,1.8439444562944096,2.0063652172203517,0.9974976153453672,0.9974507591758683,6,7,3.5796000957489014,2.2547640800476074,10,9
1413,32,0.9621670676134173,1.534119732287106,1.0007229162468452,1.0012699476519726,12,22,3.8503479957580566,2.2547640800476074,20,10
1413,64,0.45297213628591687,1.4806605898448757,0.999076733552834,1.0018599857813792,33,55,4.157835483551025,2.2547640800476074,31,9
1413,128,0.07069429432758163,1.462481463232452,0.9991480226253225,1.0021139374573225,71,113,4.592896938323975,2.2547640800476074,57,15
1414,1,2.726861507405179,2.7268615074051805,0.9927019561058642,0.9927019561058652,0,0,2.736337184906006,2.736337184906006,1,1
1414,2,2.064661742464643,2.0646617424646436,0.9978346656617345,0.9978346656617353,0,0,2.8792004585266113,2.736337184906006,2,2
1414,3,2.0406625211026763,2.0406625211026763,0.9987890321697097,0.99878903216971,0,0,3.03027081489563,2.736337184906006,3,3
1414,4,1.9171228006782912,1.917122800678291,0.9997759016817521,0.9997759016817529,0,0,3.5249810218811035,2.736337184906006,4,4
1414,8,1.6486250645028353,1.648625064502835,1.0035515350872806,1.003551535087281,0,0,3.689653158187866,2.736337184906006,8,8
1414,16,1.4233534683126263,1.4790080197302167,1.0026137243050783,1.0035936920112059,4,5,3.93383526802063,2.736337184906006,12,11
1414,32,1.0997251436486586,1.4389488723826689,1.001835258057071,1.0042263420205033,14,19,4.1991777420043945,2.736337184906006,18,13
1414,64,0.5439447058555321,1.3222646483157783,1.0003643379617255,1.0052394417306538,32,49,4.546341419219971,2.736337184906006,32,15
1414,128,0.06933703416173387,1.295115452206652,0.9998676709933827,1.0056146253281677,58,111,4.981979846954346,2.736337184906006,70,17
1415,1,6.67290810156415,6.67290810156415,0.9747561983040087,0.9747561983040097,0,0,6.7167229652404785,6.7167229652404785,1,1
1415,2,5.578547737131718,5.578547737131718,0.9950281981084856,0.9950281981084866,0,0,7.807223796844482,6.7167229652404785,2,2
1415,3,5.3071258921414,5.307125892141399,1.0014657918913683,1.001465791891368,0,0,8.200218200683594,6.7167229652404785,3,3
1415,4,5.247665683865952,5.307125892141399,1.0003025268135306,1.001465791891368,1,1,8.581465721130371,6.7167229652404785,3,3
1415,8,4.82255131273918,5.123735935839693,1.0084608380028919,1.0073354466723075,1,2,8.881235122680664,6.7167229652404785,7,6
1415,16,4.393553760485117,5.0115501541081375,1.0119484925789481,1.011954737065556,5,7,9.215829849243164,6.7167229652404785,11,9
1415,32,3.753577960859842,4.852294609973684,1.0098872508556722,1.0163728608291454,12,21,9.755438804626465,6.7167229652404785,20,11
1415,64,2.5462990648463824,4.723508162446504,1.007662385100899,1.020960777225909,29,51,10.335646629333496,6.7167229652404785,35,13
1415,128,1.4696520362397407,4.697764491982275,1.0047260323216758,1.0223713863059332,57,114,10.97069263458252,6.7167229652404785,71,14
1416,1,7.567081667521654,7.567081667521653,0.9696200701976208,0.9696200701976226,0,0,7.622624397277832,7.622624397277832,1,1
1416,2,7.127835662664774,7.127835662664776,0.9826021082854787,0.9826021082854806,0,0,9.626770973205566,7.622624397277832,2,2
1416,3,6.712613957578339,6.712613957578338,0.9955358123077038,0.9955358123077054,0,0,9.867233276367188,7.622624397277832,3,3
1416,4,6.642722101547279,6.642722101547278,0.9980908422037316,0.9980908422037329,0,0,10.009202003479004,7.622624397277832,4,4
1416,8,5.981308744978131,6.188190804357277,1.0102735838698012,1.01144848514328,2,1,10.735014915466309,7.622624397277832,6,7
1416,16,5.054281148794888,5.876206252334779,1.0128258694981342,1.0209074651185805,6,8,11.576483726501465,7.622624397277832,10,8
1416,32,4.179978849961728,5.670927825962767,1.0178659623175297,1.030712217737291,14,19,11.969285011291504,7.622624397277832,18,13
1416,64,3.391949568010927,5.492024920114092,1.0202731316171616,1.0393484614203468,31,50,12.639509201049805,7.622624397277832,33,14
1416,128,2.0242312482493134,5.288144277310141,1.0076402395616924,1.04486277330794,58,112,13.207645416259766,7.622624397277832,70,16
1417,1,10.721858980391264,10.721858980391266,0.9346050722339868,0.9346050722339885,0,0,10.903519630432129,10.903519630432129,1,1
1417,2,10.213885822556577,10.213885822556577,0.9481267442190392,0.9481267442190395,0,0,11.022181510925293,10.903519630432129,2,2
1417,3,8.348832719061251,8.348832719061251,0.9925373000503473,0.9925373000503472,0,0,11.356245040893555,10.903519630432129,3,3
1417,4,8.292837001083118,8.29283700108312,0.993324641113744,0.9933246411137437,0,0,11.407360076904297,10.903519630432129,4,4
1417,8,7.3572462100105165,7.593644980578299,1.0126725718657952,1.0105580771992135,2,3,11.83935832977295,10.903519630432129,6,5
1417,16,6.837511302046461,7.390971488729529,1.020291179787575,1.018402304705044,6,10,12.284046173095703,10.903519630432129,10,6
1417,32,5.497817995159681,6.501396601165792,1.0356366911148582,1.0347390276627835,16,24,12.838903427124023,10.903519630432129,16,8
1417,64,3.66332060889809,6.466562945718853,1.0176546227629781,1.03670858516886,35,55,13.463959693908691,10.903519630432129,29,9
1417,128,2.2856068392975852,6.233297474615513,1.0031037215256489,1.0467815630012651,67,116,14.223865509033203,10.903519630432129,61,12
1418,1,9.333360117229304,9.333360117229304,0.9482358992703487,0.9482358992703507,0,0,9.457470893859863,9.457470893859863,1,1
1418,2,7.903807655219729,7.903807655219728,0.9787893015321423,0.9787893015321432,0,0,9.571908950805664,9.457470893859863,2,2
1418,3,7.237821021635583,7.237821021635583,0.9911851846841986,0.991185184684199,0,0,9.621628761291504,9.457470893859863,3,3
1418,4,6.445230631171405,6.445230631171406,1.0073840870852606,1.0073840870852608,0,0,9.798521995544434,9.457470893859863,4,4
1418,8,5.531440477568146,5.531440477568145,1.0256740002536642,1.0256740002536635,0,0,11.150513648986816,9.457470893859863,8,8
1418,16,5.036386429068639,5.2088285724996295,1.0325908336839307,1.0358829513582046,5,6,11.658699035644531,9.457470893859863,11,10
1418,32,4.409842873852066,4.9368646140252945,1.0346328877917255,1.0408444187479484,14,21,12.168185234069824,9.457470893859863,18,11
1418,64,3.5955678916217617,4.926849353252679,1.0252887493670704,1.0427439419633957,32,51,13.024213790893555,9.457470893859863,32,13
1418,128,2.3406915857343398,4.909709840029265,1.011003353215752,1.0443440390972867,58,114,13.641106605529785,9.457470893859863,70,14
1419,1,10.19857627281646,10.19857627281646,0.929213759634336,0.9292137596343392,0,0,10.410274505615234,10.410274505615234,1,1
1419,2,8.93832148264631,8.93832148264631,0.9616344081114971,0.9616344081114996,0,0,10.78770637512207,10.410274505615234,2,2
1419,3,8.613211977469499,8.6132119774695,0.9696150696251755,0.9696150696251775,0,0,10.808027267456055,10.410274505615234,3,3
1419,4,7.799007540513044,7.799007540513043,0.9905163704547402,0.990516370454742,0,0,11.128889083862305,10.410274505615234,4,4
1419,8,7.356978714441391,7.393257280566599,1.003099321716947,1.0011890200359708,2,2,11.405363082885742,10.410274505615234,6,6
1419,16,6.5233475043349705,7.157127452150378,1.0119194326617937,1.0058494870573473,4,9,11.966830253601074,10.410274505615234,12,7
1419,32,5.601440387954877,6.966655589503411,1.0107398817903368,1.0135190119691797,12,24,12.562957763671875,10.410274505615234,20,8
1419,64,4.25983146399264,6.856001902399719,1.0148116566325445,1.0200528314108388,34,51,13.308167457580566,10.410274505615234,30,13
1419,128,2.562939848410487,6.482788545652692,1.0041227721653863,1.032488256460387,60,114,14.20423698425293,10.410274505615234,68,14
1420,1,11.306294383343573,11.306294383343579,0.9275985201466167,0.927598520146619,0,0,11.505819320678711,11.505819320678711,1,1
1420,2,9.378967853152112,9.378967853152115,0.9809396352529682,0.9809396352529709,0,0,11.932551383972168,11.505819320678711,2,2
1420,3,8.66420549564303,8.66420549564303,0.9972204926292627,0.9972204926292653,0,0,12.17929744720459,11.505819320678711,3,3
1420,4,7.877800941160599,7.877800941160599,1.0084345983474519,1.0084345983474527,0,0,12.2238130569458,11.505819320678711,4,4
1420,8,7.2944445772432545,7.395046381693387,1.027209326095196,1.0239905676196819,1,1,12.590819358825684,11.505819320678711,7,7
1420,16,6.817875525983724,7.101399626702096,1.034275395652966,1.0300403603795527,5,7,13.296951293945312,11.505819320678711,11,9
1420,32,5.796518016027687,6.835415505445469,1.0386629901967117,1.0406906107789755,12,21,13.713336944580078,11.505819320678711,20,11
1420,64,4.228860166265183,6.77400387870664,1.0263108360900357,1.0441930406821545,28,48,14.224593162536621,11.505819320678711,36,16
1420,128,2.37698225068916,6.718900799561315,1.0068846469759194,1.0462112279601599,65,110,14.860273361206055,11.505819320678711,63,18
1421,1,9.349792782458383,9.349792782458383,0.9504676183116327,0.9504676183116347,0,0,9.464351654052734,9.464351654052734,1,1
1421,2,7.832961089247031,7.83296108924703,0.9820478299102743,0.9820478299102748,0,0,9.710517883300781,9.464351654052734,2,2
1421,3,6.89600352934707,6.89600352934707,0.9961537210407978,0.9961537210407978,0,0,9.861726760864258,9.464351654052734,3,3
1421,4,6.458565851953912,6.458565851953912,1.005786785191599,1.0057867851915983,0,0,9.889739036560059,9.464351654052734,4,4
1421,8,6.240257258525847,6.240257258525847,1.009456161894398,1.0094561618943978,0,0,10.669950485229492,9.464351654052734,8,8
1421,16,5.9559613624381,6.121244394358563,1.0115847212087634,1.0157920913324663,5,6,11.182774543762207,9.464351654052734,11,10
1421,32,5.282362642775616,6.038147679373982,1.0174667627457346,1.0179301056676537,15,22,11.837018013000488,9.464351654052734,17,10
1421,64,3.38549657166238,6.031954944820019,1.0049813381660457,1.018815392946007,32,53,12.547327041625977,9.464351654052734,32,11
1421,128,1.8445003031875487,5.87932769950199,0.9995769176464188,1.0271320328159823,61,113,13.4133939743042,9.464351654052734,67,15
1422,1,8.256563445813404,8.256563445813402,0.9579400701694993,0.9579400701695012,0,0,8.350985527038574,8.350985527038574,1,1
1422,2,7.754089143911196,7.754089143911197,0.9688266604874803,0.9688266604874808,0,0,8.378460884094238,8.350985527038574,2,2
1422,3,7.244985460923657,7.244985460923657,0.9800338590812024,0.9800338590812024,0,0,8.644672393798828,8.350985527038574,3,3
1422,4,6.934410610116998,6.934410610116998,0.9863670960602899,0.9863670960602888,0,0,8.713473320007324,8.350985527038574,4,4
1422,8,5.785220398034888,5.9042271615737985,1.0031987663699782,1.000583308366023,1,1,9.070302963256836,8.350985527038574,7,7
1422,16,5.351230740360581,5.726023777708161,1.0084623900140088,1.0052588081903018,8,8,9.995585441589355,8.350985527038574,8,8
1422,32,4.7194286286183695,5.268728033328464,1.0121715672456668,1.0170203939268971,16,23,10.53423023223877,8.350985527038574,16,9
1422,64,3.8430588470206786,5.199700276160066,1.0105162600233166,1.0204538583457416,35,49,10.922882080078125,8.350985527038574,29,15
1422,128,2.0411531863780827,5.10898113402973,1.0023071592188213,1.0254840885991345,64,112,11.710101127624512,8.350985527038574,64,16
1423,1,6.524873388877676,6.524873388877679,0.9847032445150501,0.9847032445150518,0,0,6.541027545928955,6.541027545928955,1,1
1423,2,5.680210914779722,5.680210914779723,0.9999858856562875,0.999985885656288,0,0,7.348644733428955,6.541027545928955,2,2
1423,3,5.307981487310963,5.307981487310962,1.0057629836290731,1.0057629836290736,0,0,7.644759654998779,6.541027545928955,3,3
1423,4,5.22310614819464,5.223106148194639,1.0070816372710425,1.0070816372710423,0,0,8.369420051574707,6.541027545928955,4,4
1423,8,4.4634510578556155,4.4662208679426625,1.0173193296314937,1.017154092412435,1,1,9.144181251525879,6.541027545928955,7,7
1423,16,4.204073655134839,4.416011227522977,1.0188711697513146,1.0195242675115102,4,5,9.623744010925293,6.541027545928955,12,11
1423,32,3.5102117598672073,4.276675555799917,1.016833435147519,1.0221236836187726,12,19,10.219602584838867,6.541027545928955,20,13
1423,64,2.8124770876000245,4.276147271325406,1.0118719818130832,1.0222032369045413,31,51,10.93493366241455,6.541027545928955,33,13
1423,128,1.609751737620709,4.16732197939709,1.0030333355400884,1.026341566783041,60,116,11.763625144958496,6.541027545928955,68,12
1424,1,7.902306698100807,7.902306698100808,0.9572217654612079,0.9572217654612073,0,0,8.009136199951172,8.009136199951172,1,1
1424,2,6.605385769033272,6.605385769033272,0.9850955885326478,0.9850955885326463,0,0,8.221206665039062,8.009136199951172,2,2
1424,3,6.599316924642949,6.599316924642948,0.9859255032056495,0.9859255032056483,0,0,9.221874237060547,8.009136199951172,3,3
1424,4,6.2586810219691,6.2682839349879975,0.992280584534327,0.9929413078721521,1,1,9.267190933227539,8.009136199951172,3,3
1424,8,5.913436234605877,6.059390352741429,0.9967089843437054,0.9999800958864632,3,3,10.700821876525879,8.009136199951172,5,5
1424,16,5.012200049795192,5.695504821646576,1.0085878135851856,1.0110129012399445,6,6,11.537901878356934,8.009136199951172,10,10
1424,32,4.420599317745251,5.51849845704105,1.0148105245481593,1.0179042152023383,12,21,11.89260482788086,8.009136199951172,20,11
1424,64,3.2231473250352924,5.462678126682083,1.0101007187572657,1.0214426816056266,34,53,12.477771759033203,8.009136199951172,30,11
1424,128,1.791752493930515,5.462107317857349,1.0015220953112813,1.0216631300897778,66,114,12.97271728515625,8.009136199951172,62,14
1425,1,6.818862496368052,6.818862496368053,0.9681002965529425,0.9681002965529449,0,0,6.884515285491943,6.884515285491943,1,1
1425,2,5.500505689109597,5.500505689109599,0.9897051575638067,0.9897051575638081,0,0,7.122353553771973,6.884515285491943,2,2
1425,3,5.429714148442505,5.429714148442504,0.9918073446341837,0.9918073446341844,0,0,8.132378578186035,6.884515285491943,3,3
1425,4,5.32678393073828,5.32678393073828,0.9943016590413798,0.9943016590413807,0,0,8.147109985351562,6.884515285491943,4,4
1425,8,4.691407180291943,4.740200065386199,1.0072969669523775,1.0066972689725602,2,2,8.764665603637695,6.884515285491943,6,6
1425,16,4.28661784780759,4.42646016116233,1.0147925105618225,1.0137005992860577,4,7,9.15347957611084,6.884515285491943,12,9
1425,32,3.5914364945389656,4.316552933594832,1.0145885428129298,1.0146107681677459,14,20,9.732624053955078,6.884515285491943,18,12
1425,64,2.8530307522760276,4.281551600239922,1.0079975085663584,1.017423131936708,36,49,10.614347457885742,6.884515285491943,28,15
1425,128,1.7270178859343486,4.223582553271899,0.9977137980134843,1.0213595846421786,60,114,11.65523910522461,6.884515285491943,68,14
1426,1,10.295418925059337,10.295418925059337,0.9297388749858042,0.929738874985807,0,0,10.505739212036133,10.505739212036133,1,1
1426,2,9.653726806054323,9.653726806054324,0.9461338786486307,0.9461338786486324,0,0,11.08344841003418,10.505739212036133,2,2
1426,3,8.617232553193277,8.617232553193277,0.9732797898416155,0.9732797898416156,0,0,11.313462257385254,10.505739212036133,3,3
1426,4,8.617229985610509,8.617232553193276,0.973275945876665,0.9732797898416156,1,1,11.423531532287598,10.505739212036133,3,3
1426,8,8.121711243321197,8.189902664968193,0.9863786554551686,0.9854215992440406,2,2,11.837340354919434,10.505739212036133,6,6
1426,16,7.243803666076304,7.639319686623558,1.008023418080921,1.003372687063896,4,7,12.278220176696777,10.505739212036133,12,9
1426,32,6.500755866712273,7.521522441922919,1.0163312659867,1.007578047112242,15,19,12.645845413208008,10.505739212036133,17,13
1426,64,5.0322692258806025,7.308123745625916,1.015040240461321,1.019800834805339,30,46,13.16938304901123,10.505739212036133,34,18
1426,128,3.1068870781613227,7.184772279937514,1.0047910574164665,1.0228507994681524,62,111,13.638458251953125,10.505739212036133,66,17
1427,1,7.374288955286968,7.374288955286968,0.9616448836860533,0.9616448836860542,0,0,7.466057777404785,7.466057777404785,1,1
1427,2,7.036094829231224,7.036094829231224,0.9711457503090051,0.9711457503090052,0,0,8.333595275878906,7.466057777404785,2,2
1427,3,6.787015927092524,6.787015927092524,0.9743043290444364,0.974304329044436,0,0,8.34683895111084,7.466057777404785,3,3
1427,4,6.759333442055907,6.787015927092523,0.9738910185591616,0.974304329044436,1,1,8.392987251281738,7.466057777404785,3,3
1427,8,6.715386461849093,6.7543566535763055,0.9762223587651062,0.9763838468055762,2,2,8.647717475891113,7.466057777404785,6,6
1427,16,6.387118799231327,6.530261033826058,0.9860457256716266,0.983679479178002,6,9,9.089513778686523,7.466057777404785,10,7
1427,32,6.024246066279554,6.457301157820335,0.9853151298221243,0.9875179741873377,16,24,9.532646179199219,7.466057777404785,16,8
1427,64,3.374479693005039,5.341491860534897,1.0061607056400517,1.0150460601108433,34,49,9.985944747924805,7.466057777404785,30,15
1427,128,1.984775008733985,4.679897698453508,1.0016022990834048,1.0258147213326743,68,117,10.676362991333008,7.466057777404785,60,11
1428,1,3.5975295378323375,3.5975295378323375,0.99302903893675,0.9930290389367505,0,0,3.6039490699768066,3.6039490699768066,1,1
1428,2,3.031775820149579,3.031775820149579,0.9970029580063496,0.9970029580063502,0,0,3.807690143585205,3.6039490699768066,2,2
1428,3,2.990391046141155,3.031775820149579,0.9966153682437218,0.9970029580063502,1,1,4.287628650665283,3.6039490699768066,2,2
1428,4,2.941919678271558,2.985207929079711,0.9972344234370186,0.9976196297541016,1,1,4.349591255187988,3.6039490699768066,3,3
1428,8,2.525197607005357,2.6522552676676097,1.0003639319227293,1.0005729619276544,3,3,5.070450305938721,3.6039490699768066,5,5
1428,16,1.978931058764564,2.4770757133715184,1.002594376320737,1.0026034984568932,6,11,5.305757522583008,3.6039490699768066,10,5
1428,32,1.5399430679565027,2.113456254573194,1.0041002901342144,1.0080543857465198,13,23,5.7220282554626465,3.6039490699768066,19,9
1428,64,0.7487391316296631,2.027756508484573,1.0005035716872295,1.0088429475188412,35,52,6.109386444091797,3.6039490699768066,29,12
1428,128,0.19655949075253443,2.0174710674722536,0.9991086376756622,1.0095592414315173,60,112,6.584341049194336,3.6039490699768066,68,16
1429,1,8.985902552359478,8.985902552359478,0.9438135148716824,0.9438135148716837,0,0,9.144326210021973,9.144326210021973,1,1
1429,2,7.821918907558098,7.821918907558099,0.9693097116468107,0.9693097116468117,0,0,9.619627952575684,9.144326210021973,2,2
1429,3,7.790940802446862,7.790940802446863,0.9701034147887863,0.9701034147887869,0,0,9.779435157775879,9.144326210021973,3,3
1429,4,7.432606824762112,7.432606824762112,0.9795986136216994,0.9795986136216999,0,0,10.097535133361816,9.144326210021973,4,4
1429,8,6.653950833391243,7.069145834253025,0.9875938339268371,0.988670536073105,2,3,10.554635047912598,9.144326210021973,6,5
1429,16,5.772801908846085,6.479734688698836,1.0023198863874843,1.0032796981828127,7,10,11.242873191833496,9.144326210021973,9,6
1429,32,4.549772003546089,5.826549249910619,1.0115768473422797,1.0221305020876115,15,21,12.026960372924805,9.144326210021973,17,11
1429,64,3.221036810072113,5.666528746556301,1.005915687264063,1.026754915510334,29,50,12.683721542358398,9.144326210021973,35,14
1429,128,2.0248076379153,5.500974362049687,1.0021929595474788,1.0336924308587956,59,111,13.353309631347656,9.144326210021973,69,17
1430,1,9.696258485490903,9.696258485490896,0.9440627650205805,0.944062765020583,0,0,9.841547012329102,9.841547012329102,1,1
1430,2,8.734571283002694,8.734571283002696,0.9688439496452703,0.9688439496452721,0,0,10.225748062133789,9.841547012329102,2,2
1430,3,8.52514592484951,8.52514592484951,0.9755219594404569,0.9755219594404586,0,0,10.447203636169434,9.841547012329102,3,3
1430,4,8.017732703080874,8.017732703080874,0.9845736759702262,0.984573675970227,0,0,10.558538436889648,9.841547012329102,4,4
1430,8,6.465143295314293,6.465866600310958,1.0178425650936203,1.0178577018219657,1,1,11.112013816833496,9.841547012329102,7,7
1430,16,5.980010358620662,6.053386545659517,1.0273375426360205,1.026286540181804,3,5,11.368926048278809,9.841547012329102,13,11
1430,32,5.24787434898931,5.941355817153208,1.0263015234697752,1.0279054527952076,13,17,11.901693344116211,9.841547012329102,19,15
1430,64,4.0554002386926555,5.8684663515172195,1.0212010439761179,1.0309371235579081,30,47,12.288771629333496,9.841547012329102,34,17
1430,128,2.382551010277562,5.643553280609582,1.0077569412789773,1.0390857064965107,59,110,12.685530662536621,9.841547012329102,69,18
1431,1,12.552920079442961,12.552920079442963,0.9065095673222474,0.9065095673222504,0,0,12.843210220336914,12.843210220336914,1,1
1431,2,10.777201564125143,10.777201564125141,0.9516449177468775,0.9516449177468762,0,0,12.966958999633789,12.843210220336914,2,2
1431,3,10.543879953710872,10.543879953710872,0.9604328952840383,0.9604328952840372,0,0,13.164297103881836,12.843210220336914,3,3
1431,4,10.334690972870929,10.334690972870929,0.9656594171102384,0.9656594171102364,0,0,13.268963813781738,12.843210220336914,4,4
1431,8,8.590921297206956,8.596129768552297,1.012304992938081,1.011747519886451,1,1,13.636619567871094,12.843210220336914,7,7
1431,16,8.170928302124604,8.569526398052654,1.0145091110930866,1.013509149339999,6,8,14.235389709472656,12.843210220336914,10,8
1431,32,7.214609775197196,8.390651264445738,1.0289602172419339,1.0219199016398468,11,17,14.648210525512695,12.843210220336914,21,15
1431,64,5.716674280975946,8.322181142257637,1.0215837354488526,1.0265421626118956,34,48,15.247736930847168,12.843210220336914,30,16
1431,128,3.647988317474094,7.740320462614239,1.0172841526192942,1.0525014657840162,62,116,15.816263198852539,12.843210220336914,66,12
1432,1,9.895594457330624,9.895594457330628,0.9471946057488718,0.9471946057488729,0,0,10.021391868591309,10.021391868591309,1,1
1432,2,9.36967153272878,9.369671532728784,0.961331195575676,0.9613311955756769,0,0,10.56737995147705,10.021391868591309,2,2
1432,3,8.063981915076647,8.063981915076647,0.9962594531540496,0.9962594531540504,0,0,10.614721298217773,10.021391868591309,3,3
1432,4,7.93106423085039,7.9310642308503905,0.9985786158423724,0.9985786158423727,0,0,10.839411735534668,10.021391868591309,4,4
1432,8,7.245811016439422,7.252855547675362,1.011116927414112,1.0109694752269962,2,2,11.141765594482422,10.021391868591309,6,6
1432,16,6.393850845190593,6.801982409469549,1.0228334245888353,1.0193036150041261,6,6,11.448371887207031,10.021391868591309,10,10
1432,32,5.468015300065802,6.613697776334259,1.024207305867362,1.0233525944023218,14,20,12.05306339263916,10.021391868591309,18,12
1432,64,3.9173190702611627,6.437136930104908,1.0076245537052357,1.0312679978730088,34,52,12.648290634155273,10.021391868591309,30,12
1432,128,2.2985906306276904,6.383672443466194,1.0027718629390918,1.0345913486377885,64,114,13.24504566192627,10.021391868591309,64,14
1433,1,6.480068379254034,6.480068379254032,0.9708363562310657,0.9708363562310705,0,0,6.53931999206543,6.53931999206543,1,1
1433,2,5.603409536397125,5.603409536397126,0.9854822506760088,0.9854822506760106,0,0,6.718161582946777,6.53931999206543,2,2
1433,3,4.605936343700529,4.605936343700529,0.9992912125160256,0.9992912125160271,0,0,7.118508815765381,6.53931999206543,3,3
1433,4,4.580366844855357,4.580366844855357,0.9998394975124206,0.999839497512422,0,0,7.619385242462158,6.53931999206543,4,4
1433,8,4.199163309359727,4.242009813808846,1.0072899876742758,1.0063132098772136,2,2,7.9700703620910645,6.53931999206543,6,6
1433,16,3.7723656415203948,3.988386687480939,1.0120252902128142,1.012333264294726,8,8,9.209965705871582,6.53931999206543,8,8
1433,32,3.5671190462671203,3.946106535511801,1.0119384596753087,1.0145374873471,13,21,9.941788673400879,6.53931999206543,19,11
1433,64,2.7563082663524265,3.8843052789971444,1.0052916352626995,1.017959050079808,29,51,11.004608154296875,6.53931999206543,35,13
1433,128,1.7373277219203982,3.8203611288597825,1.0011700777000914,1.021451239391207,59,114,11.865118026733398,6.53931999206543,69,14
1434,1,6.5924993621715124,6.592499362171512,0.9763810342049454,0.9763810342049475,0,0,6.630763053894043,6.630763053894043,1,1
1434,2,5.738231615472321,5.738231615472321,0.9900047004038652,0.990004700403866,0,0,7.224372386932373,6.630763053894043,2,2
1434,3,5.066983967356078,5.066983967356078,0.9982034012953834,0.9982034012953841,0,0,7.307610511779785,6.630763053894043,3,3
1434,4,5.032377995557899,5.032377995557899,0.999159628991868,0.9991596289918679,0,0,7.337094783782959,6.630763053894043,4,4
1434,8,3.9970594065568896,4.059863994185259,1.012803566428679,1.0119983373944654,2,1,7.5739946365356445,6.630763053894043,6,7
1434,16,3.7702208165183975,3.964000585952077,1.0149160078890889,1.0148191970849965,6,6,8.068061828613281,6.630763053894043,10,10
1434,32,3.1380542745999467,3.7419769387381185,1.0166787683872904,1.0186632277154275,13,19,8.555697441101074,6.630763053894043,19,13
1434,64,2.3608424509588484,3.622632209358498,1.0101957967055188,1.0211089250534005,33,50,9.020627975463867,6.630763053894043,31,14
1434,128,1.14363421456945,3.595546065537473,1.001122287631056,1.022628610082728,61,107,9.753661155700684,6.630763053894043,67,21
1435,1,12.463832357857644,12.463832357857616,0.892277025563675,0.8922770255636757,0,0,12.873688697814941,12.873688697814941,1,1
1435,2,10.797378307281678,10.797378307281658,0.9431904439553187,0.9431904439553198,0,0,13.255884170532227,12.873688697814941,2,2
1435,3,10.416791176721661,10.416791176721661,0.9541005861197315,0.9541005861197314,0,0,13.463044166564941,12.873688697814941,3,3
1435,4,8.922116850145779,8.92211685014578,0.9906976301533751,0.9906976301533762,0,0,13.478432655334473,12.873688697814941,4,4
1435,8,8.315092842383189,8.341751550874253,1.0069229067402732,1.0066373491366192,2,2,13.774211883544922,12.873688697814941,6,6
1435,16,7.965265727906322,8.234201431717219,1.0185078989719454,1.0116780323467702,4,5,14.003655433654785,12.873688697814941,12,11
1435,32,6.806358681159116,7.836714059452619,1.0368986087367411,1.026011909012364,14,17,14.3278169631958,12.873688697814941,18,15
1435,64,5.422140662918894,7.809170293926631,1.03379276118416,1.0271764954004186,29,48,14.71260929107666,12.873688697814941,35,16
1435,128,4.188389160785249,7.569179668769772,1.0315456603560311,1.0391725835593983,59,110,15.042322158813477,12.873688697814941,69,18
1436,1,4.92908835461765,4.929088354617635,0.9882431978834173,0.9882431978834189,0,0,4.941947937011719,4.941947937011719,1,1
1436,2,4.3299377412024,4.3299377412024,0.9962491599669581,0.9962491599669592,0,0,6.254240036010742,4.941947937011719,2,2
1436,3,4.2432422415468,4.2432422415468,0.9977823231137114,0.9977823231137124,0,0,6.3625054359436035,4.941947937011719,3,3
1436,4,4.1692508967801345,4.169250896780135,0.9987891846074304,0.9987891846074315,0,0,6.412571430206299,4.941947937011719,4,4
1436,8,3.735950686237085,3.765275180376773,1.0034960393936263,1.0043613312787552,2,2,7.324411392211914,4.941947937011719,6,6
1436,16,3.2969094776660404,3.511425416530146,1.0077225025003944,1.008614204336695,4,7,7.871284484863281,4.941947937011719,12,9
1436,32,2.3914838712464483,3.4865080203086753,1.0032518573428322,1.0095056084568956,14,22,8.495525360107422,4.941947937011719,18,10
1436,64,1.8417314279859025,3.287599333495606,1.0030369164691446,1.0148374922937444,30,49,9.115463256835938,4.941947937011719,34,15
1436,128,1.0472646089501927,3.2875993334956064,1.001592074160919,1.0148374922937444,64,113,9.994077682495117,4.941947937011719,64,15
1437,1,5.965403195238693,5.965403195238695,0.980863933852869,0.9808639338528697,0,0,5.993361473083496,5.993361473083496,1,1
1437,2,4.518696400966961,4.518696400966961,1.0005359031961187,1.0005359031961183,0,0,6.5810747146606445,5.993361473083496,2,2
1437,3,4.223203341239443,4.2232033412394445,1.00579118189973,1.005791181899728,0,0,6.805090427398682,5.993361473083496,3,3
1437,4,4.145583571647336,4.145583571647337,1.0067392073137633,1.0067392073137618,0,0,6.841782569885254,5.993361473083496,4,4
1437,8,3.6942333038739563,3.6942723784124545,1.0121174836405402,1.0121446359312967,1,1,7.260815620422363,5.993361473083496,7,7
1437,16,3.42350932676887,3.5467297329202156,1.0124533941728355,1.0143244126256756,6,7,7.630290508270264,5.993361473083496,10,9
1437,32,2.6730608967178076,3.270766664997057,1.0092378992784514,1.0191317050043858,14,19,8.702104568481445,5.993361473083496,18,13
1437,64,1.6291774732887727,3.270743661801222,1.0020682685843483,1.0191405895711143,32,50,9.474241256713867,5.993361473083496,32,14
1437,128,1.0870919562845067,3.235663638373252,0.9998341356746379,1.0203991190044701,61,113,10.459815979003906,5.993361473083496,67,15
1438,1,7.979510458736812,7.979510458736813,0.9579996947650248,0.9579996947650269,0,0,8.079623222351074,8.079623222351074,1,1
1438,2,6.966465784582877,6.966465784582876,0.9806395368282323,0.9806395368282337,0,0,9.644323348999023,8.079623222351074,2,2
1438,3,6.121021208198665,6.121021208198666,0.9995098579102482,0.999509857910249,0,0,10.3725004196167,8.079623222351074,3,3
1438,4,5.926070442725511,5.926070442725511,1.0049391502316907,1.0049391502316911,0,0,10.694817543029785,8.079623222351074,4,4
1438,8,5.577560375296179,5.790659130031627,1.007800603750969,1.0085711094915522,1,3,11.025192260742188,8.079623222351074,7,5
1438,16,5.125891892986775,5.596504799806602,1.0160482671254945,1.0132025483880287,6,9,11.503949165344238,8.079623222351074,10,7
1438,32,4.331555904202034,5.428606377440421,1.0144947607672574,1.0217378371890238,14,22,11.964138984680176,8.079623222351074,18,10
1438,64,3.3917895003624543,5.427436566478178,1.0085212398613714,1.0219534965931323,30,54,12.428617477416992,8.079623222351074,34,10
1438,128,1.9447069287577088,5.367345245153551,1.002566912575883,1.0240651570166586,64,116,12.969325065612793,8.079623222351074,64,12
1439,1,7.7566789751972465,7.7566789751972465,0.9600620251191445,0.9600620251191448,0,0,7.848350524902344,7.848350524902344,1,1
1439,2,6.620408538576619,6.620408538576619,0.9817317641876262,0.981731764187626,0,0,7.861242771148682,7.848350524902344,2,2
1439,3,4.6571089218843404,4.6571089218843404,1.0082899504508853,1.008289950450885,0,0,7.909642219543457,7.848350524902344,3,3
1439,4,4.408042766372295,4.4080427663722945,1.0127626569040606,1.0127626569040593,0,0,8.07101058959961,7.848350524902344,4,4
1439,8,4.221554258166723,4.397570344160968,1.0121064154707768,1.013335813029172,3,3,8.8363037109375,7.848350524902344,5,5
1439,16,4.062966206100695,4.3599600884909036,1.0113911408774452,1.014360831631085,8,10,9.408552169799805,7.848350524902344,8,6
1439,32,3.583320836605121,4.193415280436787,1.0181156085230567,1.0189074128007005,14,23,9.869294166564941,7.848350524902344,18,9
1439,64,2.7639038072121527,3.988158817410662,1.0098650157432036,1.0246222733990584,35,55,10.5620698928833,7.848350524902344,29,9
1439,128,1.7784455462394124,3.928440116855503,1.002062526415822,1.0275779516837011,60,113,11.481050491333008,7.848350524902344,68,15
1440,1,10.731799779331824,10.731799779331824,0.9249057057606749,0.9249057057606753,0,0,10.96906566619873,10.96906566619873,1,1
1440,2,9.249308573182175,9.249308573182173,0.9612499459357037,0.9612499459357045,0,0,10.998658180236816,10.96906566619873,2,2
1440,3,8.90052757752509,8.90052757752509,0.9737827171141901,0.9737827171141903,0,0,11.850116729736328,10.96906566619873,3,3
1440,4,8.8890234881293,8.90052757752509,0.9732921100223934,0.9737827171141903,1,1,11.909445762634277,10.96906566619873,3,3
1440,8,7.926156341625043,8.282136224891962,1.0004882371410257,0.9942993307556891,1,2,12.332791328430176,10.96906566619873,7,6
1440,16,6.810249239024753,7.497484701547771,1.0260842591045367,1.0160582735575683,5,8,12.648271560668945,10.96906566619873,11,8
1440,32,6.099114711697011,7.147400490407952,1.0332334561660423,1.0246098450915535,14,22,12.97707748413086,10.96906566619873,18,10
1440,64,4.8084761559173,6.885382013413412,1.0280770105214094,1.0374810505821048,31,49,13.557229995727539,10.96906566619873,33,15
1440,128,2.704624963875214,6.698236320994304,1.01279001614447,1.0417087114765384,59,109,14.115839958190918,10.96906566619873,69,19
1441,1,7.845653011854829,7.845653011854829,0.9609653439963274,0.9609653439963312,0,0,7.931921482086182,7.931921482086182,1,1
1441,2,6.531337018060458,6.531337018060453,0.980232104557058,0.9802321045570611,0,0,8.09847640991211,7.931921482086182,2,2
1441,3,6.416794306811315,6.416794306811319,0.9818268284462404,0.9818268284462432,0,0,8.503311157226562,7.931921482086182,3,3
1441,4,6.264703830253626,6.264703830253627,0.9853842807108433,0.9853842807108459,0,0,9.17468547821045,7.931921482086182,4,4
1441,8,5.009106690574384,5.041107563733535,1.0135062819622038,1.0135429884859741,1,1,10.04886245727539,7.931921482086182,7,7
1441,16,4.561944937530908,4.88692488579045,1.0103169655252555,1.016920895355398,6,8,10.70704174041748,7.931921482086182,10,8
1441,32,3.8129429494031926,4.757784660511569,1.0082798636829073,1.0202957763576341,13,23,11.684990882873535,7.931921482086182,19,9
1441,64,3.0069887047063095,4.7542636146384964,1.0028316079699067,1.020957083848778,31,54,12.21882152557373,7.931921482086182,33,10
1441,128,2.0342507043199993,4.655882557654105,0.9993994568870058,1.0249351538796199,58,116,13.069311141967773,7.931921482086182,70,12
1442,1,9.386728353284933,9.386728353284937,0.936094435200612,0.9360944352006144,0,0,9.577716827392578,9.577716827392578,1,1
1442,2,6.115525880254244,6.115525880254242,1.0078455507697177,1.0078455507697202,0,0,10.10102653503418,9.577716827392578,2,2
1442,3,6.030428728575967,6.030428728575967,1.009906769974431,1.0099067699744333,0,0,10.128774642944336,9.577716827392578,3,3
1442,4,5.738488676995589,5.738488676995587,1.0151170169103498,1.0151170169103512,0,0,10.14869499206543,9.577716827392578,4,4
1442,8,5.51804143966897,5.578816582461006,1.019299304302196,1.019295889188525,2,2,11.202887535095215,9.577716827392578,6,6
1442,16,5.197467213831036,5.264988813899473,1.0286621327464476,1.0293863986511154,5,7,11.504986763000488,9.577716827392578,11,9
1442,32,4.681161627089892,4.979000009596431,1.037484168437417,1.03794840900961,10,18,12.138396263122559,9.577716827392578,22,14
1442,64,3.6139974645618413,4.916402034773778,1.0170489552724082,1.0414413669826978,29,47,12.861570358276367,9.577716827392578,35,17
1442,128,2.2048269540898957,4.8814561960063285,1.0047312446553003,1.043805609352459,65,111,13.620611190795898,9.577716827392578,63,17
1443,1,8.06616460058485,8.066164600584852,0.9641025541323892,0.9641025541323931,0,0,8.136955261230469,8.136955261230469,1,1
1443,2,6.251590554613175,6.251590554613175,0.99589441340058,0.9958944134005825,0,0,8.647960662841797,8.136955261230469,2,2
1443,3,5.363959589598627,5.363959589598627,1.008794524822704,1.0087945248227064,0,0,8.777132034301758,8.136955261230469,3,3
1443,4,5.362702788584269,5.362702788584268,1.0087916448161116,1.0087916448161138,0,0,8.792121887207031,8.136955261230469,4,4
1443,8,4.895342783256673,4.950276724473292,1.0157502674060426,1.0150469428788929,2,3,9.12532901763916,8.136955261230469,6,5
1443,16,4.342423128004165,4.421267279542031,1.0251766542978502,1.0244452711666865,3,6,9.659638404846191,8.136955261230469,13,10
1443,32,3.766119720496747,4.3574736999598995,1.0263211069118674,1.027285457992809,11,18,10.37242603302002,8.136955261230469,21,14
1443,64,3.2168805521381207,4.3267156740980965,1.0167824451908245,1.0283333469524314,27,49,11.080891609191895,8.136955261230469,37,15
1443,128,2.162649164769019,4.295355107030228,1.0022263145766037,1.0311756584546217,63,109,11.814637184143066,8.136955261230469,65,19
1444,1,6.735825359711322,6.735825359711324,0.9772935687174042,0.9772935687174069,0,0,6.769240856170654,6.769240856170654,1,1
1444,2,5.82851751430388,5.82851751430388,0.9931490576937345,0.993149057693736,0,0,8.179618835449219,6.769240856170654,2,2
1444,3,5.388858162782975,5.388858162782974,1.0019724055047434,1.0019724055047443,0,0,8.838101387023926,6.769240856170654,3,3
1444,4,5.348469157601418,5.388858162782975,1.0011103292101726,1.0019724055047443,1,1,9.120458602905273,6.769240856170654,3,3
1444,8,5.147797579210874,5.280144143042118,1.0063846094806643,1.006215261285334,2,2,9.589716911315918,6.769240856170654,6,6
1444,16,4.109519077638056,4.4167034932408775,1.0224518422737454,1.0254893636373166,7,7,10.051727294921875,6.769240856170654,9,9
1444,32,3.9060844932709355,4.407040034412874,1.0234115498639356,1.0270425744369291,14,20,11.114741325378418,6.769240856170654,18,12
1444,64,3.2968116100489144,4.381757944601692,1.009678988195689,1.0292487712950997,28,49,12.0143461227417,6.769240856170654,36,15
1444,128,2.2708917269207793,4.350304215281875,1.0014552425155858,1.0315837105797352,68,113,12.959912300109863,6.769240856170654,60,15
1445,1,7.96337921824202,7.96337921824202,0.9677435785846297,0.9677435785846314,0,0,8.02273941040039,8.02273941040039,1,1
1445,2,7.2178965797346315,7.2178965797346315,0.9824043785406193,0.9824043785406207,0,0,8.638581275939941,8.02273941040039,2,2
1445,3,6.690731706396832,6.690731706396832,0.9920606499162954,0.9920606499162961,0,0,8.639179229736328,8.02273941040039,3,3
1445,4,6.412424373489403,6.412424373489403,0.9941995526307228,0.994199552630723,0,0,8.744390487670898,8.02273941040039,4,4
1445,8,5.685224533726274,5.751880143678902,1.0082430140753231,1.006855982474118,2,2,9.291053771972656,8.02273941040039,6,6
1445,16,5.1149750661879105,5.470801204503276,1.016467261136661,1.0131302582072221,6,8,9.740345001220703,8.02273941040039,10,8
1445,32,4.2956147540500185,5.169021990489078,1.0110737234840652,1.0203674320724838,16,22,10.36491584777832,8.02273941040039,16,10
1445,64,2.9458127072280824,5.139933678201703,1.0085523724678467,1.0211792369509314,34,53,10.714770317077637,8.02273941040039,30,11
1445,128,1.9495238386485458,5.0974048229142035,1.0026131924463817,1.0237658438092887,60,115,11.453743934631348,8.02273941040039,68,13
1446,1,10.149365537949578,10.14936553794958,0.9433400466204115,0.9433400466204142,0,0,10.295830726623535,10.295830726623535,1,1
1446,2,9.472318086908826,9.472318086908823,0.9616764595050066,0.9616764595050081,0,0,10.780345916748047,10.295830726623535,2,2
1446,3,8.868900138788147,8.868900138788149,0.9765089862948488,0.9765089862948491,0,0,10.991314888000488,10.295830726623535,3,3
1446,4,8.557814941569886,8.592000305433512,0.9874207711390368,0.9851903110762319,1,1,11.30138111114502,10.295830726623535,3,3
1446,8,6.608207066502834,6.71801634200897,1.02603016808456,1.0238357500756146,2,2,11.892827987670898,10.295830726623535,6,6
1446,16,6.209642550337982,6.709555358560874,1.0321586356447348,1.0246886310936705,5,9,12.883605003356934,10.295830726623535,11,7
1446,32,5.531073012823813,6.249019259231308,1.039473864898735,1.0425830919949968,14,21,13.527840614318848,10.295830726623535,18,11
1446,64,4.206018442910762,5.974356369090393,1.0234687866686385,1.0529766641052944,29,47,14.212146759033203,10.295830726623535,35,17
1446,128,2.55115903438801,5.9629878970538215,1.0099699033367993,1.054355966798974,63,110,14.87231159210205,10.295830726623535,65,18
1447,1,10.21516501388895,10.215165013888951,0.9381690645939227,0.9381690645939249,0,0,10.375868797302246,10.375868797302246,1,1
1447,2,8.420692739970937,8.420692739970937,0.976373372638963,0.9763733726389645,0,0,10.472230911254883,10.375868797302246,2,2
1447,3,7.980813521827679,7.98081352182768,0.988721029189747,0.9887210291897475,0,0,11.205594062805176,10.375868797302246,3,3
1447,4,7.895571279025024,7.895571279025025,0.9905671886807366,0.9905671886807375,0,0,11.356048583984375,10.375868797302246,4,4
1447,8,7.159055496571833,7.271544484241211,1.0073784274738935,1.0070487265250947,2,2,11.513420104980469,10.375868797302246,6,6
1447,16,6.6797377125396915,7.165354548827765,1.017707665779195,1.011654034848247,6,9,13.030858039855957,10.375868797302246,10,7
1447,32,5.504902886169585,6.933136053466588,1.0333419675504025,1.0276039723906312,15,20,13.588475227355957,10.375868797302246,17,12
1447,64,3.8842174313214692,6.871101509962038,1.0129519496201076,1.0326345632916631,30,51,14.740199089050293,10.375868797302246,34,13
1447,128,2.4690620150472298,6.685237277857721,1.0048060018134608,1.044806489336135,60,112,15.855691909790039,10.375868797302246,68,16
1448,1,8.192308324968831,8.192308324968824,0.960824204164258,0.96082420416426,0,0,8.27365493774414,8.27365493774414,1,1
1448,2,7.802471775996708,7.80247177599671,0.9731076870194209,0.9731076870194219,0,0,9.051229476928711,8.27365493774414,2,2
1448,3,7.6671552850841955,7.6671552850841955,0.9771371070999275,0.9771371070999281,0,0,9.398536682128906,8.27365493774414,3,3
1448,4,6.579481823590954,6.579481823590954,0.9972240044026021,0.9972240044026028,0,0,9.46485710144043,8.27365493774414,4,4
1448,8,5.295452447027914,5.706468641406327,1.0137470569196028,1.0127431771151287,2,3,9.854767799377441,8.27365493774414,6,5
1448,16,4.6085863920491175,5.033744427546406,1.025475218807023,1.0246111350098968,5,8,10.509317398071289,8.27365493774414,11,8
1448,32,3.7984736230654708,4.951133987016083,1.0221213050292575,1.0276904123405874,16,23,11.122700691223145,8.27365493774414,16,9
1448,64,3.150497612231527,4.9095351265581,1.0134992955060977,1.0304462334142062,30,53,11.923958778381348,8.27365493774414,34,11
1448,128,1.7296571489861015,4.654799584729808,1.0021863375873914,1.0408475982948078,64,113,12.759806632995605,8.27365493774414,64,15
1449,1,9.296752482299457,9.29675248229946,0.9523711444459193,0.9523711444459227,0,0,9.405206680297852,9.405206680297852,1,1
1449,2,8.364091808727947,8.36409180872795,0.975720131228312,0.9757201312283144,0,0,10.319761276245117,9.405206680297852,2,2
1449,3,8.334387584524594,8.334387584524594,0.9771146442399,0.977114644239902,0,0,10.428518295288086,9.405206680297852,3,3
1449,4,7.357463730138026,7.357463730138026,0.992196125293253,0.9921961252932536,0,0,10.48546314239502,9.405206680297852,4,4
1449,8,6.726618335104303,6.82631214348745,1.0076035977895343,1.0063422258956924,1,1,10.972826957702637,9.405206680297852,7,7
1449,16,5.420101808685708,6.044691516463723,1.0291306967972769,1.0244999731748836,4,5,11.474733352661133,9.405206680297852,12,11
1449,32,4.969286042686026,5.93194455554207,1.024006756364914,1.029854285874839,11,21,12.052204132080078,9.405206680297852,21,11
1449,64,4.0275970175781035,5.75661222765644,1.013032258247227,1.0369058786415946,31,52,12.690208435058594,9.405206680297852,33,12
1449,128,2.5141544308906743,5.656845878795093,1.005264428474998,1.0427360050934418,63,114,13.454475402832031,9.405206680297852,65,14
1450,1,8.348492926669255,8.348492926669257,0.9597367306794844,0.9597367306794856,0,0,8.436103820800781,8.436103820800781,1,1
1450,2,8.071516923082958,8.071516923082958,0.9642116631218127,0.9642116631218135,0,0,8.541747093200684,8.436103820800781,2,2
1450,3,6.480192572681048,6.480192572681048,0.9960319649533704,0.996031964953371,0,0,8.802934646606445,8.436103820800781,3,3
1450,4,5.762937258643366,5.766029687100148,1.0050349065916575,1.0049249186294533,1,1,8.92931079864502,8.436103820800781,3,3
1450,8,5.174859528140425,5.322208774892801,1.0144162267727999,1.013631826279081,3,3,9.435052871704102,8.436103820800781,5,5
1450,16,4.963222835749005,5.250674364674002,1.016051739480725,1.0160565988697454,5,7,9.981707572937012,8.436103820800781,11,9
1450,32,4.176939169273832,4.98641231305407,1.0205095304959824,1.0232961173866313,14,21,10.873085975646973,8.436103820800781,18,11
1450,64,2.775229804108199,4.806641115291755,1.0077442921096473,1.0289155692649938,29,54,11.479721069335938,8.436103820800781,35,10
1450,128,1.6137617194245573,4.786226343214391,1.0022543091378384,1.0299614638062704,58,117,12.18502426147461,8.436103820800781,70,11
1451,1,6.246946942105048,6.246946942105048,0.9810881204193633,0.9810881204193661,0,0,6.272366046905518,6.272366046905518,1,1
1451,2,5.5284617295575,5.5284617295575,0.9895995055687428,0.9895995055687439,0,0,6.734673976898193,6.272366046905518,2,2
1451,3,4.763344610005788,4.763344610005787,0.9962094462349044,0.9962094462349056,0,0,6.926604270935059,6.272366046905518,3,3
1451,4,4.665029095669693,4.665029095669694,0.997848337426984,0.9978483374269835,0,0,7.031064510345459,6.272366046905518,4,4
1451,8,4.509415156151054,4.526800642078618,1.0015521162089729,1.0012213175676234,1,1,7.472259044647217,6.272366046905518,7,7
1451,16,4.130052095544843,4.1466339995098975,1.009654708324542,1.010058411907942,4,6,8.21265983581543,6.272366046905518,12,10
1451,32,3.337374781323054,3.8344139931946963,1.0123254564659951,1.016555495803504,13,20,8.926200866699219,6.272366046905518,19,12
1451,64,2.6730011251886525,3.704074489396667,1.0072580979467225,1.0214366486714352,31,46,9.804343223571777,6.272366046905518,33,18
1451,128,1.45543970180594,3.6831640170367836,1.0011221002872075,1.0227718335849172,60,109,10.936038970947266,6.272366046905518,68,19
1452,1,9.722062101369314,9.72206210136932,0.9450547588602521,0.9450547588602546,0,0,9.860955238342285,9.860955238342285,1,1
1452,2,8.671451285678833,8.671451285678835,0.9705913828235833,0.9705913828235853,0,0,10.696884155273438,9.860955238342285,2,2
1452,3,8.159567166453085,8.159567166453085,0.9838673344016737,0.9838673344016758,0,0,10.877055168151855,9.860955238342285,3,3
1452,4,8.125327337993259,8.12532733799326,0.9843209616345429,0.9843209616345451,0,0,10.959997177124023,9.860955238342285,4,4
1452,8,7.274875992858517,7.375110567607554,1.004782117971159,1.0045643762469214,2,2,11.549379348754883,9.860955238342285,6,6
1452,16,6.654195681275453,6.825375484882576,1.019829555318131,1.0162838785712405,4,7,12.036420822143555,9.860955238342285,12,9
1452,32,5.4931369713082745,6.302048596821608,1.0301928346920723,1.0324715729558125,11,21,12.720925331115723,9.860955238342285,21,11
1452,64,4.03335389365051,6.202676318587804,1.0187640391973818,1.0382317437818396,27,51,13.296259880065918,9.860955238342285,37,13
1452,128,2.4211964262098054,6.174678331701552,1.0076696227198974,1.0408410892319435,63,112,13.93348217010498,9.860955238342285,65,16
1453,1,8.931587761010169,8.931587761010173,0.9498350158562712,0.9498350158562735,0,0,9.053116798400879,9.053116798400879,1,1
1453,2,7.065903189702272,7.065903189702272,0.9895321253517568,0.9895321253517579,0,0,9.498432159423828,9.053116798400879,2,2
1453,3,7.027914848859429,7.02791484885943,0.9906401551684395,0.9906401551684406,0,0,10.292707443237305,9.053116798400879,3,3
1453,4,6.8807267779056644,6.8807267779056644,0.9952535465007565,0.9952535465007573,0,0,10.29867935180664,9.053116798400879,4,4
1453,8,6.304393666148492,6.373635368698139,1.004263284001686,1.0047564793446955,2,3,10.510580062866211,9.053116798400879,6,5
1453,16,5.869809080593132,6.152038559302417,1.012215188558707,1.011748344463536,8,8,11.267269134521484,9.053116798400879,8,8
1453,32,4.481220328628398,5.7520951891706735,1.0176475791666777,1.0240694247211475,12,19,11.664348602294922,9.053116798400879,20,13
1453,64,3.830081068714575,5.516039289717702,1.0153426859966554,1.0339539016274597,29,50,12.622808456420898,9.053116798400879,35,14
1453,128,2.5179849659576115,5.45768367963063,1.0051121667169387,1.0391758420237234,57,113,13.426078796386719,9.053116798400879,71,15
1454,1,6.304504311529854,6.304504311529855,0.9745881830107541,0.9745881830107543,0,0,6.351217746734619,6.351217746734619,1,1
1454,2,4.73401350921239,4.7340135092123905,0.9960052840690736,0.996005284069074,0,0,6.643751621246338,6.351217746734619,2,2
1454,3,4.144098598879161,4.14409859887916,1.0022119257359228,1.0022119257359223,0,0,6.809744358062744,6.351217746734619,3,3
1454,4,3.960877322653652,3.9608773226536518,1.0042326089773999,1.0042326089774,0,0,6.904170513153076,6.351217746734619,4,4
1454,8,3.4964119348198563,3.496411934819856,1.0118633230334302,1.0118633230334297,0,0,7.47719144821167,6.351217746734619,8,8
1454,16,3.0127569558704224,3.0739524726516945,1.017382131480882,1.018299600838909,4,4,8.070743560791016,6.351217746734619,12,12
1454,32,2.6429155255610266,2.999143186406573,1.0151805110873704,1.0200424984672436,12,16,8.446539878845215,6.351217746734619,20,16
1454,64,1.8390107954334667,2.9927320145740506,1.006411821422754,1.021216347223014,27,44,9.150696754455566,6.351217746734619,37,20
1454,128,1.0162699762189062,2.9926731326518246,1.0012597393203602,1.0212660782964456,62,108,9.833207130432129,6.351217746734619,66,20
1455,1,6.402593114704913,6.402593114704912,0.9754275516004496,0.9754275516004502,0,0,6.444087982177734,6.444087982177734,1,1
1455,2,4.730877051659651,4.730877051659652,0.9980708481503302,0.9980708481503308,0,0,6.689083099365234,6.444087982177734,2,2
1455,3,4.714083775343673,4.714083775343673,0.9983802286952665,0.9983802286952671,0,0,6.8756842613220215,6.444087982177734,3,3
1455,4,4.2164901955373235,4.2164901955373235,1.003257480364062,1.0032574803640621,0,0,6.940112590789795,6.444087982177734,4,4
1455,8,3.958805222893031,3.960668947837003,1.0073581554852282,1.0073613857123496,1,1,7.439765453338623,6.444087982177734,7,7
1455,16,3.7161247255176355,3.739578874002463,1.0118184962264811,1.0113259587445937,4,2,7.835278511047363,6.444087982177734,12,14
1455,32,3.020224434838939,3.3277213814099444,1.0173734290569407,1.017605388425128,10,19,8.372580528259277,6.444087982177734,22,13
1455,64,2.290291685771329,3.203961124234038,1.007815767533816,1.0212487802892825,31,39,9.446962356567383,6.444087982177734,33,25
1455,128,1.3630663890429864,3.193773409916761,1.0016777065406508,1.0226708356339897,60,103,10.3134765625,6.444087982177734,68,25
1456,1,12.536395785652521,12.536395785652523,0.9174070671749925,0.9174070671749935,0,0,12.776363372802734,12.776363372802734,1,1
1456,2,11.426900941021009,11.426900941021009,0.9460094760586553,0.946009476058657,0,0,13.1122465133667,12.776363372802734,2,2
1456,3,11.086469102247428,11.086469102247417,0.9560637367336747,0.956063736733676,0,0,13.354042053222656,12.776363372802734,3,3
1456,4,10.841365623811493,10.841365623811495,0.96256134945792,0.9625613494579216,0,0,13.422675132751465,12.776363372802734,4,4
1456,8,10.509467735488352,10.53393136459858,0.973992159797353,0.9739606250590072,2,2,13.757320404052734,12.776363372802734,6,6
1456,16,8.368375341170282,8.72150331184508,1.0204027285360784,1.0210802843859834,6,8,14.274948120117188,12.776363372802734,10,8
1456,32,7.283893226793679,8.244332291297445,1.0334679168657273,1.0339021782450488,15,21,14.69131088256836,12.776363372802734,17,11
1456,64,5.486085339494147,7.852476285064756,1.028685301337593,1.0491571264646113,37,49,14.939315795898438,12.776363372802734,27,15
1456,128,4.055234272405776,7.8008241848885715,1.0190066665109998,1.0527383442749612,57,114,15.133532524108887,12.776363372802734,71,14
1457,1,8.15535912303031,8.15535912303031,0.9602507489048423,0.9602507489048432,0,0,8.241358757019043,8.241358757019043,1,1
1457,2,7.470830330345473,7.470830330345473,0.9718103232813927,0.9718103232813937,0,0,8.689539909362793,8.241358757019043,2,2
1457,3,7.080620337759176,7.080620337759176,0.9788749983801217,0.9788749983801226,0,0,8.762859344482422,8.241358757019043,3,3
1457,4,6.728966974901422,6.728966974901422,0.9844795924575571,0.9844795924575573,0,0,8.882651329040527,8.241358757019043,4,4
1457,8,6.423196854418458,6.423196854418458,0.992267956158714,0.9922679561587134,0,0,9.35325813293457,8.241358757019043,8,8
1457,16,5.479754939074891,5.677513120421108,1.0060579741994713,1.0067880517701786,6,9,9.869129180908203,8.241358757019043,10,7
1457,32,4.9780578587375635,5.640521168892084,1.007327761172068,1.0079422249659535,16,24,10.427681922912598,8.241358757019043,16,8
1457,64,3.859217311229147,5.6100920167374415,1.001531050828225,1.009808983508828,30,54,11.26233959197998,8.241358757019043,34,10
1457,128,2.053953095278415,5.5884264471021945,0.9985769283696209,1.011093005378141,61,117,12.148628234863281,8.241358757019043,67,11
1458,1,10.238231546033932,10.238231546033932,0.9287259302994729,0.9287259302994743,0,0,10.458800315856934,10.458800315856934,1,1
1458,2,8.74167686563675,8.74167686563675,0.9670412386081253,0.9670412386081255,0,0,10.844697952270508,10.458800315856934,2,2
1458,3,8.30618296793169,8.306182967931692,0.9779795116085751,0.9779795116085752,0,0,10.908305168151855,10.458800315856934,3,3
1458,4,7.7133365772279445,7.713336577227943,0.9936515006798758,0.9936515006798757,0,0,11.081735610961914,10.458800315856934,4,4
1458,8,7.2613724674736035,7.292695742655344,1.0047837798437405,1.0029003170874708,2,3,11.380573272705078,10.458800315856934,6,5
1458,16,6.787999500386786,7.160714707215875,1.0137555490839674,1.0084503104603044,7,8,11.752187728881836,10.458800315856934,9,8
1458,32,5.568550001220421,6.22084310147232,1.027839859796609,1.028320805605526,9,20,12.37024974822998,10.458800315856934,23,12
1458,64,3.971437323495488,6.185729825532461,1.013037774319046,1.0303368530470527,32,50,12.831582069396973,10.458800315856934,32,14
1458,128,2.0879960869182472,6.034816135729959,1.0046423763213594,1.0354105092020993,62,112,13.36972713470459,10.458800315856934,66,16
1459,1,9.91946821891072,9.919468218910724,0.9455600850202452,0.9455600850202472,0,0,10.050217628479004,10.050217628479004,1,1
1459,2,8.251016639901062,8.251016639901062,0.9831864060474896,0.98318640604749,0,0,10.251381874084473,10.050217628479004,2,2
1459,3,7.719521130772185,7.719521130772185,0.995055408107808,0.9950554081078082,0,0,10.310903549194336,10.050217628479004,3,3
1459,4,7.678970991630929,7.678970991630929,0.9953018903883205,0.9953018903883221,0,0,10.391397476196289,10.050217628479004,4,4
1459,8,7.34792384661037,7.552156889334302,1.0004820071191343,0.9990320056880249,1,1,11.177518844604492,10.050217628479004,7,7
1459,16,6.072716189490731,6.749723918188165,1.026984393762714,1.021057018024432,5,8,12.060567855834961,10.050217628479004,11,8
1459,32,5.039341885873984,6.295830967723153,1.036726115061826,1.0341718752893172,14,20,12.61055850982666,10.050217628479004,18,12
1459,64,3.977043813310182,6.202476616674712,1.0246540302244058,1.039580747278682,33,46,13.396429061889648,10.050217628479004,31,18
1459,128,2.4684382842176933,5.9577939173248655,1.0095343441426623,1.0516164939509336,64,110,14.217263221740723,10.050217628479004,64,18
1460,1,10.674195622411817,10.674195622411819,0.9384044760145988,0.9384044760146043,0,0,10.828510284423828,10.828510284423828,1,1
1460,2,8.124581601978035,8.124581601978036,0.9995041738342485,0.9995041738342518,0,0,11.893102645874023,10.828510284423828,2,2
1460,3,8.04966146634819,8.049661466348192,1.0024919554332112,1.0024919554332146,0,0,12.034900665283203,10.828510284423828,3,3
1460,4,7.693224716360418,7.700394534078503,1.0090883203219436,1.0093576650052989,1,1,12.263030052185059,10.828510284423828,3,3
1460,8,6.555951498174401,6.6388164890712895,1.0367994405572571,1.0356178709239383,1,1,12.853575706481934,10.828510284423828,7,7
1460,16,6.123289336421679,6.38434451051289,1.0454422987343177,1.0420679902447956,5,9,13.431327819824219,10.828510284423828,11,7
1460,32,5.6379725619131795,6.178769444905152,1.0517034724142738,1.0507112441738182,10,18,14.29057788848877,10.828510284423828,22,14
1460,64,4.584536297718703,6.157791464483816,1.022001494651887,1.0527551020453136,27,47,15.037992477416992,10.828510284423828,37,17
1460,128,2.794286422683472,6.136939452154893,1.0081180362559257,1.0552914404414664,61,109,16.08526611328125,10.828510284423828,67,19
1461,1,9.181252521791782,9.181252521791786,0.9562393537349785,0.9562393537349798,0,0,9.272897720336914,9.272897720336914,1,1
1461,2,7.451179302862344,7.451179302862345,0.9899506491168895,0.9899506491168905,0,0,10.200221061706543,9.272897720336914,2,2
1461,3,6.761817003429772,6.761817003429772,1.0087518655311012,1.0087518655311023,0,0,10.624887466430664,9.272897720336914,3,3
1461,4,6.761579326463415,6.761817003429772,1.0086716543735241,1.0087518655311023,1,1,11.188804626464844,9.272897720336914,3,3
1461,8,6.019700200761148,6.1289404064811235,1.0219325130487218,1.0247609924666858,2,2,11.6578950881958,9.272897720336914,6,6
1461,16,5.570117849588381,5.769499805476622,1.031660497480426,1.0342461137281194,6,7,12.14938735961914,9.272897720336914,10,9
1461,32,5.051976862468293,5.649083617447302,1.030540182674328,1.0379862449900492,12,19,12.853748321533203,9.272897720336914,20,13
1461,64,3.5913160108322164,5.489506363510675,1.0182690573078095,1.0416452177729982,26,47,13.478569984436035,9.272897720336914,38,17
1461,128,2.32214829020034,5.477237831689773,1.0053040096079866,1.0434974317378438,63,107,14.010539054870605,9.272897720336914,65,21
1462,1,7.561920899348345,7.561920899348345,0.9659232231198216,0.9659232231198234,0,0,7.6324944496154785,7.6324944496154785,1,1
1462,2,5.822952972414017,5.822952972414017,0.9938225106575194,0.9938225106575214,0,0,7.676258563995361,7.6324944496154785,2,2
1462,3,5.48990279746241,5.489902797462411,0.997284925908656,0.9972849259086558,0,0,7.69860315322876,7.6324944496154785,3,3
1462,4,5.26983318563583,5.2698331856358305,1.0006552518776743,1.0006552518776746,0,0,7.901000499725342,7.6324944496154785,4,4
1462,8,4.8897929542739655,4.895313942117375,1.0058585035911891,1.0059332628751916,3,3,8.298648834228516,7.6324944496154785,5,5
1462,16,4.54849107651958,4.832808984820581,1.007755486935663,1.00816297054132,5,7,8.961194038391113,7.6324944496154785,11,9
1462,32,3.5054115595680115,4.83044432519333,1.0038273114819214,1.0085376260449355,16,22,9.266121864318848,7.6324944496154785,16,10
1462,64,2.2787837033136276,4.617191316287483,1.0009260193797351,1.0139207115887092,30,53,9.764107704162598,7.6324944496154785,34,11
1462,128,1.004904997150322,4.4458161183272304,0.9985559522894427,1.0205003545467426,67,115,10.450881958007812,7.6324944496154785,61,13
1463,1,6.015285840228756,6.015285840228759,0.9815797922590458,0.9815797922590487,0,0,6.039539813995361,6.039539813995361,1,1
1463,2,5.644894237289804,5.644894237289791,0.9874783575851366,0.9874783575851389,0,0,6.79511022567749,6.039539813995361,2,2
1463,3,4.7338941627005635,4.733894162700563,1.0008821996637502,1.0008821996637525,0,0,7.316260814666748,6.039539813995361,3,3
1463,4,4.68845776276479,4.68845776276479,1.0035146765749154,1.0035146765749177,0,0,8.384151458740234,6.039539813995361,4,4
1463,8,4.200668767560769,4.2012267279403845,1.017698320457666,1.0175527058917218,1,1,9.317298889160156,6.039539813995361,7,7
1463,16,3.9952120143238385,4.153554637362039,1.0183982056658558,1.0201573288604708,4,5,10.053450584411621,6.039539813995361,12,11
1463,32,3.392976378386461,4.040717934337848,1.018346102978435,1.025090634705037,15,19,10.952672004699707,6.039539813995361,17,13
1463,64,2.8713440276459563,3.926198786567521,1.012764860418347,1.0303504098762442,34,46,11.93922233581543,6.039539813995361,30,18
1463,128,1.7163879544995384,3.9120764984175938,1.0011472393665806,1.0318918431240744,60,108,12.840384483337402,6.039539813995361,68,20
1464,1,7.024521787023727,7.0245217870237315,0.9719042772462231,0.9719042772462252,0,0,7.076142311096191,7.076142311096191,1,1
1464,2,6.06346178994869,6.063461789948691,0.9906434376350868,0.9906434376350881,0,0,7.74254035949707,7.076142311096191,2,2
1464,3,5.142316371832337,5.142316371832336,1.00303535205577,1.0030353520557727,0,0,7.939240455627441,7.076142311096191,3,3
1464,4,5.059331213544569,5.059331213544589,1.0062594866138146,1.0062594866138166,0,0,8.266457557678223,7.076142311096191,4,4
1464,8,4.674854553678194,4.676042507923193,1.013399949208814,1.013560365479717,2,2,9.63882064819336,7.076142311096191,6,6
1464,16,4.245209909390287,4.3995773908822065,1.0213127490527967,1.0217252258997491,5,6,9.888362884521484,7.076142311096191,11,10
1464,32,3.8817730559384485,4.3249016692939195,1.0248476961195698,1.0246412249104415,14,18,10.380599021911621,7.076142311096191,18,14
1464,64,2.6766346185667707,4.277348800847882,1.0115142707454585,1.0255931684089776,32,48,10.945981979370117,7.076142311096191,32,16
1464,128,1.6561688228730291,4.265592901401011,1.0035974995447197,1.0269180624736651,60,112,11.542920112609863,7.076142311096191,68,16
1465,1,5.804900146617349,5.80490014661735,0.9804580912121771,0.9804580912121786,0,0,5.835391044616699,5.835391044616699,1,1
1465,2,4.590854362504706,4.590854362504705,0.9970132544773394,0.9970132544773405,0,0,6.340823173522949,5.835391044616699,2,2
1465,3,4.102075701714487,4.1020757017144875,1.003435940947476,1.003435940947477,0,0,6.442195415496826,5.835391044616699,3,3
1465,4,4.052482748133331,4.052482748133331,1.004503436452686,1.0045034364526866,0,0,6.707519054412842,5.835391044616699,4,4
1465,8,3.6592586562550484,3.7168006522680033,1.009220528900289,1.0101374259412306,2,2,7.271712779998779,5.835391044616699,6,6
1465,16,3.3789692992578475,3.698710868357023,1.008601960615966,1.0108128209693912,4,8,7.799576282501221,5.835391044616699,12,8
1465,32,3.016174681321502,3.5487355278519046,1.0084016644303633,1.0139565202998158,13,23,8.151643753051758,5.835391044616699,19,9
1465,64,1.9791068801801743,3.5028662231209875,1.0045560371229447,1.015587196253907,25,48,8.807229042053223,5.835391044616699,39,16
1465,128,1.049504465697792,3.3322540982618163,1.0009641686190842,1.0191006559006077,57,110,9.505260467529297,5.835391044616699,71,18
1466,1,10.696996553958787,10.696996553958789,0.935881783489989,0.935881783489992,0,0,10.86917781829834,10.86917781829834,1,1
1466,2,9.17481243123919,9.174812431239191,0.9786415396573176,0.9786415396573178,0,0,11.580469131469727,10.86917781829834,2,2
1466,3,8.285263093162548,8.285263093162548,1.0040570024382467,1.0040570024382467,0,0,12.006126403808594,10.86917781829834,3,3
1466,4,7.909212299737208,7.909212299737207,1.0130521118616638,1.0130521118616658,0,0,12.12483024597168,10.86917781829834,4,4
1466,8,7.538431537068269,7.538431537068268,1.020271049231411,1.020271049231414,0,0,12.705352783203125,10.86917781829834,8,8
1466,16,6.297600597008244,7.2521612133217,1.0300221614830551,1.0311527667757363,4,6,13.658617973327637,10.86917781829834,12,10
1466,32,5.832335229619036,7.183701149084594,1.030341653308433,1.036518170976039,13,20,14.443192481994629,10.86917781829834,19,12
1466,64,4.352282945996262,7.089478782351992,1.018301954484744,1.0414911690556181,31,50,15.467754364013672,10.86917781829834,33,14
1466,128,2.766393978549162,7.088839819622205,1.0084248878762,1.0418580424001402,57,113,16.550073623657227,10.86917781829834,71,15
1467,1,3.7945482144352387,3.7945482144352387,0.996136548436132,0.9961365484361319,0,0,3.796440839767456,3.796440839767456,1,1
1467,2,3.0228718408345188,3.0228718408345188,1.001290379377233,1.0012903793772334,0,0,4.031495094299316,3.796440839767456,2,2
1467,3,2.999021089412187,2.999021089412187,1.0007183406308795,1.0007183406308804,0,0,4.05415678024292,3.796440839767456,3,3
1467,4,2.5509821478689227,2.550982147868922,1.0026550582371805,1.0026550582371814,0,0,4.31168794631958,3.796440839767456,4,4
1467,8,2.183188249997442,2.5408133697466853,1.0035617274914754,1.0030280598429007,2,3,4.480564117431641,3.796440839767456,6,5
1467,16,1.9487929888930955,2.4800941596271335,1.0038178738070154,1.003649268163554,7,10,4.7957024574279785,3.796440839767456,9,6
1467,32,1.480166966438037,2.3586374933183016,1.0046936578209322,1.006353274265737,14,23,5.19207763671875,3.796440839767456,18,9
1467,64,0.43647399278263277,2.3164972412510743,1.0007016570380152,1.0066528814838565,31,55,5.487926006317139,3.796440839767456,33,9
1467,128,0.06582008321515148,2.299856544755843,0.9999569675916891,1.0067872993679152,62,118,5.98100471496582,3.796440839767456,66,10
1468,1,6.221449463987892,6.221449463987892,0.9777257503873438,0.9777257503873463,0,0,6.258120536804199,6.258120536804199,1,1
1468,2,4.906090747690677,4.906090747690677,0.9946353663121592,0.994635366312161,0,0,6.529057025909424,6.258120536804199,2,2
1468,3,4.533126226125448,4.533126226125449,1.001164217625853,1.0011642176258546,0,0,6.9676289558410645,6.258120536804199,3,3
1468,4,4.476569338083072,4.476569338083073,1.0023108432436236,1.0023108432436245,0,0,7.008202075958252,6.258120536804199,4,4
1468,8,4.180402695038675,4.311989228860892,1.0060655620162888,1.0057642514613025,2,2,7.589981555938721,6.258120536804199,6,6
1468,16,3.8713861749770198,4.051379385228842,1.0094930976645289,1.0110442198195757,5,7,8.190704345703125,6.258120536804199,11,9
1468,32,3.2820180568072126,3.9312573053216187,1.007659403332748,1.0139226936481154,15,23,8.691777229309082,6.258120536804199,17,9
1468,64,2.0462931390066346,3.8922986482848354,1.0024815728500924,1.0153901292056393,27,52,9.409367561340332,6.258120536804199,37,12
1468,128,1.1515078956463596,3.8536350619934745,1.0007021795564872,1.0174009775365171,59,117,10.188011169433594,6.258120536804199,69,11
1469,1,8.040889409301013,8.040889409301013,0.9605697376381382,0.9605697376381428,0,0,8.124761581420898,8.124761581420898,1,1
1469,2,6.904390567512447,6.904390567512449,0.9845319432863393,0.9845319432863417,0,0,8.24276065826416,8.124761581420898,2,2
1469,3,6.18654862947339,6.18654862947339,0.9967550713724911,0.996755071372492,0,0,8.342482566833496,8.124761581420898,3,3
1469,4,5.63983860074222,5.639864738338727,1.0068196259276967,1.0067972106923921,1,1,8.803854942321777,8.124761581420898,3,3
1469,8,4.988794721178757,5.051623788691143,1.017201987763524,1.0158050789122792,2,2,9.29287338256836,8.124761581420898,6,6
1469,16,4.566596439162294,4.7263415629236825,1.0255862235916346,1.024527076791405,4,6,9.627933502197266,8.124761581420898,12,10
1469,32,4.005377440843831,4.699744553187183,1.0248736841429427,1.0259587113063655,13,19,10.410090446472168,8.124761581420898,19,13
1469,64,3.1850514107522523,4.68982940673118,1.0189106519151074,1.0271293285720278,31,48,10.945466995239258,8.124761581420898,33,16
1469,128,1.9889825424904317,4.659671848615769,1.0048145918984077,1.030360101384479,63,112,12.010887145996094,8.124761581420898,65,16
1470,1,2.235093111291094,2.2350931112910914,0.9942307589700398,0.9942307589700408,0,0,2.2422080039978027,2.2422080039978027,1,1
1470,2,1.6622919248429922,1.6622919248429928,0.9982553666028557,0.9982553666028566,0,0,3.132009983062744,2.2422080039978027,2,2
1470,3,1.6276921112470504,1.6276921112470466,0.9989322054967904,0.9989322054967911,0,0,3.2833070755004883,2.2422080039978027,3,3
1470,4,1.6197367753372762,1.6197367753372762,0.9991035851627892,0.99910358516279,0,0,3.5047967433929443,2.2422080039978027,4,4
1470,8,1.5420972822579422,1.5453311514412056,1.0011677033051678,1.0010488253598142,2,1,3.9053280353546143,2.2422080039978027,6,7
1470,16,1.3141740794090675,1.512850253549861,1.002379606830179,1.0016116721348993,5,6,4.2140212059021,2.2422080039978027,11,10
1470,32,1.1525688898581548,1.467993599212879,1.0025185580032545,1.0028748799221439,15,21,4.642655849456787,2.2422080039978027,17,11
1470,64,0.8265587896434459,1.4531028799153138,1.000802985325496,1.0036063881159207,30,50,5.276948928833008,2.2422080039978027,34,14
1470,128,0.19437023349319107,1.4310960503955616,1.0002579977546886,1.0045334944058202,63,110,6.024088382720947,2.2422080039978027,65,18
1471,1,7.6581462256635895,7.65814622566359,0.9700092348133522,0.9700092348133552,0,0,7.709799289703369,7.709799289703369,1,1
1471,2,6.661783728644339,6.66178372864434,0.9860335329313024,0.9860335329313035,0,0,7.7490620613098145,7.709799289703369,2,2
1471,3,6.251919692795867,6.251919692795868,0.9970404559127242,0.9970404559127246,0,0,8.852825164794922,7.709799289703369,3,3
1471,4,6.228162251995103,6.228162251995101,0.998189932444607,0.998189932444607,0,0,9.648019790649414,7.709799289703369,4,4
1471,8,5.691808774909711,5.691808774909709,1.0121391606618642,1.012139160661866,0,0,9.837407112121582,7.709799289703369,8,8
1471,16,4.872271757096388,5.074472308765747,1.0181523581936214,1.0199775878998816,5,6,10.269943237304688,7.709799289703369,11,10
1471,32,4.155276721629821,4.881967117582037,1.018540234996817,1.0249722633176215,14,21,10.758822441101074,7.709799289703369,18,11
1471,64,3.110228237671909,4.878298707457679,1.009787183438425,1.0255577589031395,31,52,11.563633918762207,7.709799289703369,33,12
1471,128,1.8197449903293872,4.742667517130606,1.00359324393254,1.0325973576273992,66,112,12.287142753601074,7.709799289703369,62,16
1472,1,8.443850528090024,8.443850528090026,0.9513908052547227,0.9513908052547256,0,0,8.565704345703125,8.565704345703125,1,1
1472,2,7.412327586940353,7.4123275869403535,0.9756362794256896,0.9756362794256908,0,0,9.2703275680542,8.565704345703125,2,2
1472,3,6.172724585562188,6.172724585562189,0.9970205265078391,0.9970205265078393,0,0,9.320704460144043,8.565704345703125,3,3
1472,4,5.866042409598378,5.866042409598378,1.0034841461869637,1.0034841461869644,0,0,9.33053207397461,8.565704345703125,4,4
1472,8,5.099718123950924,5.133853201554896,1.0157381098428204,1.0155024528842036,1,2,9.457927703857422,8.565704345703125,7,6
1472,16,4.547864847558274,5.065348898556096,1.0209705339884998,1.0176244688847897,3,7,9.821553230285645,8.565704345703125,13,9
1472,32,4.210035702696715,4.8477676266925505,1.0282848556174429,1.0238928288102362,10,15,10.367916107177734,8.565704345703125,22,17
1472,64,3.3226803837898666,4.514440385274089,1.028795365491029,1.0334950992331158,25,42,11.076434135437012,8.565704345703125,39,22
1472,128,2.1279131288318927,4.449692509247149,1.0062964604390165,1.0389211832060807,62,104,12.001420021057129,8.565704345703125,66,24
1473,1,5.983138004882139,5.98313800488214,0.9802813054110041,0.9802813054110049,0,0,6.012482166290283,6.012482166290283,1,1
1473,2,5.014106235601161,5.01410623560116,0.990056194329606,0.9900561943296073,0,0,6.046584129333496,6.012482166290283,2,2
1473,3,4.652216464221433,4.652216464221433,0.9950829890195959,0.9950829890195968,0,0,6.738897800445557,6.012482166290283,3,3
1473,4,4.648670339987103,4.648670339987103,0.9952759364359879,0.9952759364359883,0,0,7.161347389221191,6.012482166290283,4,4
1473,8,4.267873039440804,4.368670702074952,0.9989557040818748,1.0012708380364974,3,3,7.812419414520264,6.012482166290283,5,5
1473,16,3.5492849642199302,3.9056288168241697,1.0074851021915883,1.0116720016827627,8,9,8.404693603515625,6.012482166290283,8,7
1473,32,3.0042029602197076,3.7338950254105336,1.0085990661792912,1.0144439182637446,16,22,9.000201225280762,6.012482166290283,16,10
1473,64,2.429276912488502,3.6624176633459777,1.0072729178617208,1.0171280930964186,31,50,9.790205001831055,6.012482166290283,33,14
1473,128,1.2368567907937054,3.658121177968649,1.0008753978309721,1.0176500466779181,64,115,10.483992576599121,6.012482166290283,64,13
1474,1,10.20627049266867,10.206270492668668,0.9280842636912928,0.928084263691295,0,0,10.438926696777344,10.438926696777344,1,1
1474,2,8.406729180836821,8.406729180836821,0.972200837173316,0.9722008371733178,0,0,10.580387115478516,10.438926696777344,2,2
1474,3,8.056008618242627,8.056008618242627,0.9858775744123263,0.9858775744123282,0,0,12.08797550201416,10.438926696777344,3,3
1474,4,7.0583371165280795,7.0583371165280795,1.0103502331359502,1.0103502331359508,0,0,12.285977363586426,10.438926696777344,4,4
1474,8,6.7445886488684526,6.875548695300918,1.0182744283786358,1.0217108358742386,2,2,12.992766380310059,10.438926696777344,6,6
1474,16,5.956593691772337,6.309928296939968,1.032128339577483,1.0396173183511614,5,6,13.393548965454102,10.438926696777344,11,10
1474,32,4.696297441141625,6.051708027015511,1.028075995363034,1.0458691474025625,14,21,14.115985870361328,10.438926696777344,18,11
1474,64,3.669282179189331,6.0373355005812455,1.0109119209286745,1.0464272009525415,29,53,14.977630615234375,10.438926696777344,35,11
1474,128,2.271301000607739,6.0372471731687005,1.0033495106905175,1.046593459918021,63,115,15.595280647277832,10.438926696777344,65,13
1475,1,10.82897494717524,10.828974947175238,0.927878112757919,0.9278781127579193,0,0,11.038376808166504,11.038376808166504,1,1
1475,2,9.515804827980249,9.51580482798025,0.9628443259686834,0.9628443259686847,0,0,11.71347713470459,11.038376808166504,2,2
1475,3,8.478501388145887,8.478501388145887,0.9914642619403939,0.9914642619403948,0,0,12.126524925231934,11.038376808166504,3,3
1475,4,8.289837274680545,8.289837274680545,0.9988451393518231,0.9988451393518235,0,0,12.903310775756836,11.038376808166504,4,4
1475,8,7.977669439544566,7.98406540304851,1.0131152439331337,1.0121077997552979,1,1,13.119176864624023,11.038376808166504,7,7
1475,16,6.80344790179309,6.94398635664564,1.0424963339580433,1.0395888526017414,4,7,13.644640922546387,11.038376808166504,12,9
1475,32,5.919156530573513,6.876608482211679,1.0462678939565955,1.043129914910462,10,20,14.030374526977539,11.038376808166504,22,12
1475,64,4.768699974790264,6.79887025878899,1.034148199002831,1.0479831207997625,31,48,14.591349601745605,11.038376808166504,33,16
1475,128,3.2953333013287573,6.695887723574779,1.0148848863293884,1.0553607923804658,62,110,15.11245059967041,11.038376808166504,66,18
1476,1,14.032220879244116,14.03222087924412,0.8808674792785087,0.8808674792785111,0,0,14.477521896362305,14.477521896362305,1,1
1476,2,12.07683577745353,12.076835777453532,0.9473346528241211,0.9473346528241229,0,0,14.514993667602539,14.477521896362305,2,2
1476,3,11.128819537918558,11.128819537918558,0.9753728660892019,0.9753728660892038,0,0,14.646204948425293,14.477521896362305,3,3
1476,4,10.261542528294632,10.261542528294632,0.9982159920479423,0.9982159920479439,0,0,14.661208152770996,14.477521896362305,4,4
1476,8,10.128475845906143,10.140154550163597,1.004253443987357,1.003504055775382,2,2,15.348642349243164,14.477521896362305,6,6
1476,16,9.615262762653456,10.11436563754383,1.0066644850645283,1.0052180099524126,6,8,16.107177734375,14.477521896362305,10,8
1476,32,7.7094851369580795,9.21511119835301,1.042818018825849,1.0447343117423995,13,23,16.583309173583984,14.477521896362305,19,9
1476,64,6.203013182729242,9.17268307789627,1.0228550835023342,1.05075631546911,32,52,17.22171401977539,14.477521896362305,32,12
1476,128,4.253054949363072,9.099207388032639,1.014629811615319,1.0586934493585283,65,115,18.026636123657227,14.477521896362305,63,13
1477,1,8.359599606153225,8.359599606153225,0.9641524004237914,0.9641524004237931,0,0,8.430359840393066,8.430359840393066,1,1
1477,2,6.68567196192847,6.685671961928471,0.9979462457729842,0.9979462457729851,0,0,9.69261646270752,8.430359840393066,2,2
1477,3,6.592003107608735,6.592003107608735,1.0002891271408922,1.0002891271408922,0,0,10.102723121643066,8.430359840393066,3,3
1477,4,6.390844065860878,6.390844065860879,1.0049582957313914,1.0049582957313925,0,0,10.182965278625488,8.430359840393066,4,4
1477,8,6.292097858255689,6.333416068393133,1.0058328970108683,1.0075013760163896,2,3,11.208410263061523,8.430359840393066,6,5
1477,16,5.278866826802844,5.800519731870318,1.0217480968247785,1.0245249330785853,6,9,11.866809844970703,8.430359840393066,10,7
1477,32,4.347601522363822,5.4660955761569925,1.0250951121011345,1.0355621263302148,14,20,12.343137741088867,8.430359840393066,18,12
1477,64,3.3745090411175447,5.40297649248716,1.0206315099284313,1.040792116617649,29,51,13.117934226989746,8.430359840393066,35,13
1477,128,2.0474380172613507,5.358799536834328,1.005653884996123,1.0439233765517288,67,112,13.763702392578125,8.430359840393066,61,16
1478,1,7.468400696407986,7.4684006964079845,0.9692385798674519,0.9692385798674529,0,0,7.52467679977417,7.52467679977417,1,1
1478,2,6.458045817057798,6.458045817057798,0.9863383084978545,0.9863383084978552,0,0,8.051419258117676,7.52467679977417,2,2
1478,3,5.905628245519529,5.90562824551953,0.9965099642838675,0.996509964283868,0,0,8.798314094543457,7.52467679977417,3,3
1478,4,5.77941996427377,5.779419964273771,0.9982659911763125,0.9982659911763129,0,0,8.932108879089355,7.52467679977417,4,4
1478,8,5.235797958758837,5.2357979587588375,1.0086467586904733,1.0086467586904733,0,0,9.709525108337402,7.52467679977417,8,8
1478,16,4.8666658376493475,5.014112046282493,1.0135695182962965,1.0143969748897086,4,6,10.318120002746582,7.52467679977417,12,10
1478,32,4.163859340927249,4.929767064526496,1.0174711063952637,1.0181287022192127,11,16,10.947173118591309,7.52467679977417,21,16
1478,64,2.7986782372152086,4.889538933108626,1.0064408608814324,1.0203487501625927,33,49,11.566887855529785,7.52467679977417,31,15
1478,128,1.7037421889024496,4.774218482068955,1.000419745408165,1.0268876335440638,66,110,12.268961906433105,7.52467679977417,62,18
1479,1,4.012729701243598,4.0127297012435985,0.9932691381206687,0.9932691381206699,0,0,4.018095970153809,4.018095970153809,1,1
1479,2,3.287336740982556,3.2873367409825565,0.9979671050677117,0.9979671050677137,0,0,4.060944557189941,4.018095970153809,2,2
1479,3,3.130804647000334,3.1308046470003346,0.9992774547362518,0.999277454736254,0,0,4.100839614868164,4.018095970153809,3,3
1479,4,3.123530326306183,3.123530326306184,0.9994144827254852,0.9994144827254863,0,0,4.215390205383301,4.018095970153809,4,4
1479,8,2.5517928515228534,2.6488027627624864,1.0021002188329566,1.0023778801936616,2,4,4.366884231567383,4.018095970153809,6,4
1479,16,2.206580507270735,2.639436043130153,1.0030431252462928,1.0026896283471765,5,10,4.824746131896973,4.018095970153809,11,6
1479,32,1.6558450230483135,2.6324270745203484,1.000756289206704,1.0032584806662102,15,24,5.306886196136475,4.018095970153809,17,8
1479,64,0.9482827459405379,2.5830500984903786,1.0015172126381988,1.0044248549250414,32,54,5.565006732940674,4.018095970153809,32,10
1479,128,0.15058406796275656,2.5590382350595338,0.9998929765040745,1.005800665929878,69,118,6.023922443389893,4.018095970153809,59,10
1480,1,11.636417459211208,11.636417459211208,0.9230355733604599,0.9230355733604603,0,0,11.85787582397461,11.85787582397461,1,1
1480,2,10.362051868101188,10.362051868101188,0.9511509250227683,0.9511509250227685,0,0,11.960898399353027,11.85787582397461,2,2
1480,3,9.153190759036697,9.153190759036697,0.9803282380087983,0.9803282380087999,0,0,11.975152969360352,11.85787582397461,3,3
1480,4,8.547526080015148,8.547526080015148,0.9949393485329032,0.9949393485329043,0,0,12.479004859924316,11.85787582397461,4,4
1480,8,7.9285493573645525,8.340489092975218,1.005259902240391,1.000466874034622,3,4,12.563985824584961,11.85787582397461,5,4
1480,16,6.973781658134589,7.539743023843583,1.0249978511799094,1.0236220819346125,5,7,12.91197395324707,11.85787582397461,11,9
1480,32,6.082458783774908,7.380052953640565,1.038531195613026,1.026529817949303,13,18,13.317960739135742,11.85787582397461,19,14
1480,64,4.888622461147594,7.182973253934523,1.0248126296530742,1.0366402958251497,31,51,13.812088966369629,11.85787582397461,33,13
1480,128,3.065364066499315,6.998980443181456,1.0085394694239185,1.0474121848132616,65,108,14.281204223632812,11.85787582397461,63,20
1481,1,10.719458656827008,10.71945865682701,0.9337482125308292,0.9337482125308311,0,0,10.903271675109863,10.903271675109863,1,1
1481,2,9.466310021294559,9.466310021294559,0.964180586561315,0.9641805865613158,0,0,11.042285919189453,10.903271675109863,2,2
1481,3,8.90466209921629,8.90466209921629,0.9779979566140357,0.9779979566140369,0,0,11.046919822692871,10.903271675109863,3,3
1481,4,8.289012748283417,8.327144338962219,0.990606731984099,0.9897082988111043,1,1,11.16858196258545,10.903271675109863,3,3
1481,8,6.912751507876331,6.93833672372132,1.0209287956730808,1.0206361352630549,3,4,12.145033836364746,10.903271675109863,5,4
1481,16,6.650834113516031,6.867755110970842,1.022504943545976,1.024523572316888,8,10,12.88060188293457,10.903271675109863,8,6
1481,32,5.678057798173796,6.780195694805047,1.015161701722741,1.0302784715565292,12,23,13.637565612792969,10.903271675109863,20,9
1481,64,3.9457293724339886,6.6860273285183744,1.0101178451550212,1.0351517460874413,32,53,14.369274139404297,10.903271675109863,32,11
1481,128,2.6219875988329893,6.650750192761514,1.0069505356759811,1.039949900215853,63,116,15.164046287536621,10.903271675109863,65,12
1482,1,9.556096469880972,9.55609646988096,0.942598816456513,0.9425988164565178,0,0,9.709717750549316,9.709717750549316,1,1
1482,2,7.781999089223599,7.781999089223598,0.9708121974993996,0.9708121974994007,0,0,10.082139015197754,9.709717750549316,2,2
1482,3,7.142151647724021,7.142151647724023,0.9866030073756951,0.9866030073756964,0,0,10.197656631469727,9.709717750549316,3,3
1482,4,7.112338156918189,7.112338156918189,0.9882440609205804,0.988244060920582,0,0,11.176251411437988,9.709717750549316,4,4
1482,8,6.665388954841289,6.665806759175697,1.0015343243993722,1.0014422725414438,3,3,11.758910179138184,9.709717750549316,5,5
1482,16,6.471219396719643,6.5571143986860125,1.0095371825341894,1.010624695144198,6,6,12.872193336486816,9.709717750549316,10,10
1482,32,5.778055878897512,6.240072624455406,1.021606434903621,1.0260232477694038,12,18,13.292922973632812,9.709717750549316,20,14
1482,64,4.498043072728232,6.1292139416604225,1.0166181738423155,1.0326663350493663,30,48,13.983043670654297,9.709717750549316,34,16
1482,128,2.8422518193286543,5.982018342537424,1.010016412831136,1.0420975906686372,55,110,14.708696365356445,9.709717750549316,73,18
1483,1,9.465835557898181,9.465835557898185,0.9593739594852978,0.9593739594852996,0,0,9.54326057434082,9.54326057434082,1,1
1483,2,7.3700164402279915,7.3700164402279915,1.0000698230926437,1.0000698230926437,0,0,10.65987491607666,9.54326057434082,2,2
1483,3,7.278636194348445,7.278636194348445,1.0025186341781016,1.0025186341781014,0,0,10.69666862487793,9.54326057434082,3,3
1483,4,7.236467415521422,7.236467415521421,1.0042915530974479,1.004291553097448,0,0,11.135923385620117,9.54326057434082,4,4
1483,8,6.796930108982449,6.796930108982449,1.0140311103466435,1.0140311103466433,0,0,11.617815017700195,9.54326057434082,8,8
1483,16,6.1441339005150875,6.5504086377549235,1.0281507692136183,1.0229246799217413,5,6,11.907980918884277,9.54326057434082,11,10
1483,32,5.225613034796495,6.360310524506254,1.0239018054421902,1.028518473404898,14,22,12.461182594299316,9.54326057434082,18,10
1483,64,4.0855344633445565,5.875428790141589,1.0284751487132313,1.0421114658959094,26,52,12.8939790725708,9.54326057434082,38,12
1483,128,2.45066444874722,5.727149151439952,1.0114771329007608,1.0459519803723851,61,113,13.515152931213379,9.54326057434082,67,15
1484,1,6.886230865712754,6.886230865712754,0.9757359886366452,0.9757359886366469,0,0,6.924081325531006,6.924081325531006,1,1
1484,2,6.37836529017415,6.378365290174152,0.9847091315846597,0.984709131584661,0,0,7.667592525482178,6.924081325531006,2,2
1484,3,6.038347147483218,6.038347147483218,0.990325729247763,0.9903257292477639,0,0,7.880229473114014,6.924081325531006,3,3
1484,4,5.836075829963578,5.836075829963575,0.9943650110745155,0.9943650110745166,0,0,8.104072570800781,6.924081325531006,4,4
1484,8,5.365979519956079,5.3916333389649465,1.0020504372153638,1.0018064045084496,1,1,8.781641006469727,6.924081325531006,7,7
1484,16,4.242266521674001,4.824785191160413,1.015876565605351,1.0141530913122452,4,7,9.393367767333984,6.924081325531006,12,9
1484,32,3.7183154024093783,4.493389180375639,1.0095043489458349,1.0166295546928845,16,20,10.464244842529297,6.924081325531006,16,12
1484,64,2.3403048486774294,4.470512363709252,1.0001309404021286,1.0184081356157564,30,51,11.53729248046875,6.924081325531006,34,13
1484,128,1.3097567461286959,4.466959170472019,1.0010089778517695,1.0190586151684595,60,114,12.384222030639648,6.924081325531006,68,14
1485,1,8.22038928452557,8.22038928452557,0.9547560960113953,0.9547560960113971,0,0,8.333334922790527,8.333334922790527,1,1
1485,2,6.614507232929952,6.614507232929953,0.9892403332682098,0.9892403332682111,0,0,9.560098648071289,8.333334922790527,2,2
1485,3,6.613393911521426,6.613393911521427,0.9894292181319992,0.9894292181319998,0,0,9.572125434875488,8.333334922790527,3,3
1485,4,6.58934433131154,6.589344366654935,0.9900020199895523,0.9900028942880865,1,1,9.758519172668457,8.333334922790527,3,3
1485,8,5.94334743676359,5.988148220377802,1.0020119680158097,1.0025395187472865,1,1,10.080798149108887,8.333334922790527,7,7
1485,16,5.298244492193661,5.664161691948054,1.015397648857478,1.0135274559505443,6,9,10.586734771728516,8.333334922790527,10,7
1485,32,4.365085261988787,5.375382490617203,1.017773304153808,1.0220450906842249,13,21,11.095014572143555,8.333334922790527,19,11
1485,64,3.47586372249314,5.36322901415724,1.0075249272899374,1.022993249026475,33,53,11.922403335571289,8.333334922790527,31,11
1485,128,1.8573255670228666,5.137197054408725,1.0028603077630582,1.029167254228447,58,109,12.584875106811523,8.333334922790527,70,19
1486,1,3.147793922199843,3.147793922199845,0.9948503499404451,0.9948503499404464,0,0,3.1518428325653076,3.1518428325653076,1,1
1486,2,2.834906612699481,2.834906612699482,0.9965082275421278,0.9965082275421284,0,0,3.4745736122131348,3.1518428325653076,2,2
1486,3,2.715219529406799,2.7152195294067996,0.9976122698766399,0.9976122698766408,0,0,3.6313295364379883,3.1518428325653076,3,3
1486,4,2.5346008227399555,2.534600822739956,0.9982624518509569,0.9982624518509582,0,0,3.6725709438323975,3.1518428325653076,4,4
1486,8,2.394568796998925,2.394568796998925,1.0000070219350894,1.0000070219350907,0,0,4.0678253173828125,3.1518428325653076,8,8
1486,16,2.0380847936208886,2.2482144542169036,1.0023800443499975,1.0017074757173883,6,8,4.574951648712158,3.1518428325653076,10,8
1486,32,1.3361072512719934,2.2236778382126485,0.9997231711817558,1.0021267821806834,14,22,5.0105366706848145,3.1518428325653076,18,10
1486,64,0.6006225378597896,2.2093783755523932,0.9993989391377697,1.0027380950252578,30,55,5.706496715545654,3.1518428325653076,34,9
1486,128,0.07237309946045507,2.184845161953571,0.9999640187557683,1.0044300607508618,60,115,6.278473854064941,3.1518428325653076,68,13
1487,1,7.456710049004615,7.456710049004615,0.9756099378744195,0.9756099378744217,0,0,7.492528438568115,7.492528438568115,1,1
1487,2,5.9252605848309265,5.925260584830926,0.9965552188944653,0.9965552188944679,0,0,7.723647117614746,7.492528438568115,2,2
1487,3,5.286281814223423,5.286281814223422,1.0064624585079067,1.0064624585079096,0,0,8.300440788269043,7.492528438568115,3,3
1487,4,5.276335804486341,5.286281814223423,1.0060337163186142,1.0064624585079096,1,1,8.870315551757812,7.492528438568115,3,3
1487,8,4.771744358791883,4.876904925222429,1.015037518726696,1.0160474509148312,2,2,9.394237518310547,7.492528438568115,6,6
1487,16,4.184527522516126,4.836103804798255,1.01259349519998,1.0166261944022423,6,9,9.98755168914795,7.492528438568115,10,7
1487,32,3.470147955086338,4.820027201591627,1.0130987698001106,1.0180019990566294,18,24,10.523602485656738,7.492528438568115,14,8
1487,64,2.7002492463109755,4.624703305583926,1.007160215129806,1.026385750620559,35,52,11.284611701965332,7.492528438568115,29,12
1487,128,1.5369839376906302,4.534190098934001,1.0011922605783592,1.0295538051069317,59,116,12.116500854492188,7.492528438568115,69,12
1488,1,2.6105927442734846,2.6105927442734846,0.9953384609693682,0.9953384609693686,0,0,2.61452317237854,2.61452317237854,1,1
1488,2,2.0893354313895776,2.0893354313895776,0.999092425752916,0.9990924257529157,0,0,3.033329486846924,2.61452317237854,2,2
1488,3,1.9590180533284618,1.9590180533284618,0.9999369646899028,0.9999369646899028,0,0,3.4034557342529297,2.61452317237854,3,3
1488,4,1.6704252330269886,1.6704252330269882,1.0011433064754067,1.0011433064754067,0,0,3.6355574131011963,2.61452317237854,4,4
1488,8,1.4937006346464372,1.6564842762688796,1.0009340472174737,1.0015613677473625,3,3,4.292055130004883,2.61452317237854,5,5
1488,16,1.3342270902305953,1.5827657423157762,1.0008381746542896,1.0024971555711144,7,10,4.950473308563232,2.61452317237854,9,6
1488,32,0.9537336833202885,1.5806448780453306,0.9989993554126813,1.0026911376297158,18,25,5.382734775543213,2.61452317237854,14,7
1488,64,0.5716628091722894,1.5806442457391578,0.9989943481091185,1.0026933323363156,32,57,5.771917819976807,2.61452317237854,32,7
1488,128,0.14670111195019084,1.580644245739158,0.9986064421060342,1.0026933323363156,66,121,6.362241268157959,2.61452317237854,62,7
1489,1,9.270287851037505,9.270287851037505,0.9523715982097024,0.9523715982097046,0,0,9.377337455749512,9.377337455749512,1,1
1489,2,8.804324546955822,8.804324546955822,0.9681972078846041,0.9681972078846055,0,0,10.765727043151855,9.377337455749512,2,2
1489,3,8.539227026072382,8.539227026072382,0.9755112275601531,0.9755112275601544,0,0,10.769267082214355,9.377337455749512,3,3
1489,4,7.34911786282031,7.349117862820311,1.002861769558292,1.0028617695582929,0,0,11.007614135742188,9.377337455749512,4,4
1489,8,6.229416268257313,6.246081455749596,1.024285654668037,1.024772859780943,1,1,11.575644493103027,9.377337455749512,7,7
1489,16,5.517762544719564,5.824350395627242,1.033931359435476,1.0375685406192279,6,6,12.617135047912598,9.377337455749512,10,10
1489,32,4.773147609179042,5.55693944243376,1.0384040024734011,1.047435042984098,13,18,13.548468589782715,9.377337455749512,19,14
1489,64,3.5031300731526827,5.532785807856861,1.0250321943716085,1.0483680072239774,26,49,14.273165702819824,9.377337455749512,38,15
1489,128,2.3273575443824726,5.453003778395516,1.0113357834181405,1.0504347429751468,60,113,14.800006866455078,9.377337455749512,68,15
1490,1,7.35470943615384,7.354709436153841,0.9662953304932926,0.9662953304932933,0,0,7.4235992431640625,7.4235992431640625,1,1
1490,2,5.742244100150643,5.742244100150644,0.9897780615011683,0.9897780615011678,0,0,7.518625259399414,7.4235992431640625,2,2
1490,3,5.647184459043059,5.647184459043059,0.9919143503582402,0.9919143503582397,0,0,8.306745529174805,7.4235992431640625,3,3
1490,4,5.644978808533253,5.644978808533253,0.9921293785445512,0.9921293785445513,0,0,8.369199752807617,7.4235992431640625,4,4
1490,8,5.303308243639478,5.319108540509316,0.9988957357483308,0.9989767127338668,2,3,8.704354286193848,7.4235992431640625,6,5
1490,16,4.831945320215689,5.097817718883564,1.0061420623448434,1.0057377598198207,4,8,9.183454513549805,7.4235992431640625,12,8
1490,32,3.7256252934196685,4.9003791567042345,1.0037998743933327,1.0122712876116549,14,20,9.888714790344238,7.4235992431640625,18,12
1490,64,2.5487710520123614,4.669803942450804,1.0061611546245315,1.0198611750893376,30,50,10.306380271911621,7.4235992431640625,34,14
1490,128,1.4676820244633653,4.641442825943668,1.0034265322873255,1.0202613504854177,60,113,11.082465171813965,7.4235992431640625,68,15
1491,1,7.496017034407968,7.496017034407967,0.9756221320839128,0.9756221320839136,0,0,7.531838893890381,7.531838893890381,1,1
1491,2,6.243938073654989,6.243938073654988,0.9934834525703296,0.99348345257033,0,0,7.678099155426025,7.531838893890381,2,2
1491,3,4.69135010667799,4.691350106677991,1.0143995500662824,1.0143995500662824,0,0,8.37691879272461,7.531838893890381,3,3
1491,4,4.69133840795996,4.691350106677991,1.0143901116904457,1.0143995500662824,1,1,9.398293495178223,7.531838893890381,3,3
1491,8,4.6071871214622755,4.611753899621247,1.0184508099995302,1.0189296876665823,1,2,10.578095436096191,7.531838893890381,7,6
1491,16,3.9335721176826093,4.400616015800525,1.0230830351306874,1.029729917130393,4,7,11.097465515136719,7.531838893890381,12,9
1491,32,3.4546969840411124,4.399459782800129,1.0150664656883506,1.030187963645042,14,23,12.089286804199219,7.531838893890381,18,9
1491,64,2.6001864998744253,4.319712230207975,1.008841180944156,1.0339691442233088,32,51,12.837557792663574,7.531838893890381,32,13
1491,128,1.6523676330530108,4.317024093044085,1.004345997418794,1.034681853511031,63,113,13.7500581741333,7.531838893890381,65,15
1492,1,9.912650366403522,9.912650366403524,0.9216567587230672,0.9216567587230681,0,0,10.186405181884766,10.186405181884766,1,1
1492,2,8.095578874418456,8.095578874418456,0.9732313082039983,0.9732313082039983,0,0,11.112424850463867,10.186405181884766,2,2
1492,3,7.621554836278398,7.621554836278399,0.9840377219518648,0.9840377219518648,0,0,11.2066650390625,10.186405181884766,3,3
1492,4,7.6202656042640395,7.6215548362784,0.9839921111546466,0.9840377219518648,1,1,11.596901893615723,10.186405181884766,3,3
1492,8,7.566402412538935,7.614667529210019,0.9854331788668741,0.9846155990284814,2,4,11.843964576721191,10.186405181884766,6,4
1492,16,7.38820261075312,7.583590505181697,0.9889717302364143,0.9863773388639826,6,10,12.487419128417969,10.186405181884766,10,6
1492,32,6.418759736749331,7.204046917271313,1.0059534232301108,1.0000219108877055,15,23,12.810006141662598,10.186405181884766,17,9
1492,64,4.948859456563585,7.151146339833853,1.0081431965127363,1.0044992166736053,32,51,13.370671272277832,10.186405181884766,32,13
1492,128,3.124860857691351,7.030580301445472,1.0048595422222146,1.0134657473442987,60,115,13.841832160949707,10.186405181884766,68,13
1493,1,9.725489099346262,9.725489099346257,0.9433583865796219,0.943358386579624,0,0,9.871467590332031,9.871467590332031,1,1
1493,2,8.693709286387328,8.693709286387332,0.9648921424635077,0.964892142463509,0,0,9.949112892150879,9.871467590332031,2,2
1493,3,8.076219881225667,8.076219881225661,0.9798593644222091,0.9798593644222104,0,0,10.600802421569824,9.871467590332031,3,3
1493,4,7.864329135739423,7.8643291357394185,0.9839787625977112,0.9839787625977133,0,0,10.691062927246094,9.871467590332031,4,4
1493,8,7.430252396884253,7.430252396884253,0.9955387353672374,0.995538735367238,0,0,11.0017728805542,9.871467590332031,8,8
1493,16,6.077347489089717,6.237360312167185,1.0222200152514818,1.0197773241180896,6,7,11.630059242248535,9.871467590332031,10,9
1493,32,4.9563228428781825,5.753514697949322,1.0211627028980135,1.0286808907270109,13,14,12.277010917663574,9.871467590332031,19,18
1493,64,3.903411497866252,5.69168334850047,1.0203417002383843,1.029665158220379,30,47,12.932828903198242,9.871467590332031,34,17
1493,128,2.4683293609397943,5.607302733506767,1.006012703526968,1.0343897849344368,63,108,13.467301368713379,9.871467590332031,65,20
1494,1,9.492907240101035,9.492907240101035,0.9500497816458183,0.9500497816458188,0,0,9.605960845947266,9.605960845947266,1,1
1494,2,8.13837642698862,8.13837642698862,0.9806541447549457,0.9806541447549451,0,0,10.457575798034668,9.605960845947266,2,2
1494,3,8.13006734236514,8.13006734236514,0.9809671873975392,0.9809671873975382,0,0,10.682188034057617,9.605960845947266,3,3
1494,4,8.036329267319775,8.036329267319777,0.9823560547390643,0.9823560547390641,0,0,10.775457382202148,9.605960845947266,4,4
1494,8,7.049620803922645,7.067515829085116,1.00198633150209,1.0019435005119413,1,1,11.051200866699219,9.605960845947266,7,7
1494,16,6.800024487072879,7.0251140990002705,1.0034692913634984,1.0037249482676538,5,5,11.528117179870605,9.605960845947266,11,11
1494,32,5.288399373691639,6.622883166111155,1.0141222022858574,1.017799968294546,14,23,12.243496894836426,9.605960845947266,18,9
1494,64,3.9525373284320247,6.349406584696423,1.0169167843319031,1.0255693258424454,32,53,12.910567283630371,9.605960845947266,32,11
1494,128,2.301104022250325,6.2223670251458305,1.0069095553246457,1.0295533510260395,61,114,13.593453407287598,9.605960845947266,67,14
1495,1,4.87033048542496,4.870330485424962,0.9882972817699404,0.9882972817699431,0,0,4.882896900177002,4.882896900177002,1,1
1495,2,4.34648715370595,4.346487153705951,0.9963717489522237,0.996371748952226,0,0,6.159794807434082,4.882896900177002,2,2
1495,3,4.294380571295402,4.294380571295401,0.9988198428288197,0.9988198428288226,0,0,6.599478244781494,4.882896900177002,3,3
1495,4,3.8946191207287684,3.8946191207287773,1.0042016249278356,1.0042016249278365,0,0,6.722295761108398,4.882896900177002,4,4
1495,8,3.5329467319377827,3.6362748841415837,1.0106445619543867,1.0103337334207159,2,2,7.148451328277588,4.882896900177002,6,6
1495,16,3.3165780608516564,3.4924136500676037,1.0130875925114506,1.0148773430963844,5,5,7.961748123168945,4.882896900177002,11,11
1495,32,2.7919824433517237,3.4824793122752764,1.0059556658974982,1.015718911780137,16,17,9.084590911865234,4.882896900177002,16,15
1495,64,2.1945573216346133,3.4801909860127442,1.0012395653814923,1.01621420874219,31,49,10.185562133789062,4.882896900177002,33,15
1495,128,1.3882434746840697,3.431345569940826,0.9995073570798899,1.0184656027740122,56,114,11.246807098388672,4.882896900177002,72,14
1496,1,4.7774144469378905,4.777414446937891,0.986740954248898,0.9867409542489001,0,0,4.794536590576172,4.794536590576172,1,1
1496,2,4.4408027084751645,4.440802708475164,0.9911335326647938,0.9911335326647953,0,0,5.574985027313232,4.794536590576172,2,2
1496,3,3.9401432273729364,3.940143227372937,0.9970336918955038,0.9970336918955056,0,0,5.862757682800293,4.794536590576172,3,3
1496,4,3.9401254324923873,3.9401254324923873,0.9970398910642662,0.9970398910642667,0,0,6.116969108581543,4.794536590576172,4,4
1496,8,2.8886658067106947,2.918827642822789,1.0100681764926316,1.0095813703315635,2,2,6.461986064910889,4.794536590576172,6,6
1496,16,2.468242955956493,2.8159609220855626,1.009816506309388,1.010283399401217,6,9,7.035638809204102,4.794536590576172,10,7
1496,32,1.987023500962003,2.5612180803590787,1.0053681951975175,1.0114716676145665,14,23,7.613465785980225,4.794536590576172,18,9
1496,64,1.3951510142747032,2.5593344644096865,1.0001374666024623,1.0116979999246287,32,54,8.429590225219727,4.794536590576172,32,10
1496,128,0.7061875644870917,2.556474775973468,0.9994889565375378,1.0119708433808188,62,117,9.054403305053711,4.794536590576172,66,11
1497,1,8.317876233605173,8.317876233605173,0.9711716936081506,0.9711716936081517,0,0,8.362160682678223,8.362160682678223,1,1
1497,2,6.248730206761311,6.2487302067613095,0.9961137843496186,0.99611378434962,0,0,8.537507057189941,8.362160682678223,2,2
1497,3,6.157529125333354,6.157529125333354,0.9977749144921455,0.9977749144921467,0,0,8.620157241821289,8.362160682678223,3,3
1497,4,5.76701303379459,5.771956062882927,1.0025144795684913,1.0025535106074568,1,1,8.677806854248047,8.362160682678223,3,3
1497,8,4.849939878472922,5.095496101289951,1.014030051858645,1.0136436695948992,2,2,8.9642972946167,8.362160682678223,6,6
1497,16,4.5876051418718475,4.9391092925040665,1.0154660481980353,1.015465650781012,5,7,9.69083023071289,8.362160682678223,11,9
1497,32,3.671783650534787,4.862470867085279,1.015586994115869,1.01851805181097,14,20,10.316558837890625,8.362160682678223,18,12
1497,64,2.7008118829505454,4.609857037084284,1.007693320350099,1.027416714506027,32,49,11.244747161865234,8.362160682678223,32,15
1497,128,1.3839442445581647,4.421337566352776,1.000135973283982,1.031656413204538,61,111,12.074220657348633,8.362160682678223,67,17
1498,1,9.582277412989942,9.58227741298994,0.9391581522140321,0.9391581522140356,0,0,9.754947662353516,9.754947662353516,1,1
1498,2,8.250241536290332,8.250241536290332,0.9733922879574318,0.9733922879574335,0,0,10.14189338684082,9.754947662353516,2,2
1498,3,7.807666846725982,7.807666846725982,0.9847407277924912,0.9847407277924934,0,0,10.490283966064453,9.754947662353516,3,3
1498,4,7.7676378850615295,7.767637885061528,0.98644699559842,0.9864469955984221,0,0,10.685535430908203,9.754947662353516,4,4
1498,8,6.725093983649199,6.737355383300994,1.0076261236889548,1.0076582645487582,1,1,11.092752456665039,9.754947662353516,7,7
1498,16,5.898917179718182,6.306791210208855,1.019921061672318,1.0209055023670173,7,7,11.889398574829102,9.754947662353516,9,9
1498,32,4.664320495843051,6.122512768784931,1.0234853739094627,1.026018154092846,15,19,12.395535469055176,9.754947662353516,17,13
1498,64,3.496318039545077,5.970400322233228,1.01704554718177,1.0332865295115683,33,48,13.1236572265625,9.754947662353516,31,16
1498,128,2.118468980203041,5.873664734221491,1.0051737064093003,1.0364463969987743,60,113,14.008063316345215,9.754947662353516,68,15
1499,1,5.626316864630576,5.626316864630576,0.9790037598313076,0.9790037598313092,0,0,5.662774562835693,5.662774562835693,1,1
1499,2,4.701144099365137,4.701144099365137,0.9933724187059634,0.993372418705964,0,0,6.193899631500244,5.662774562835693,2,2
1499,3,4.650572214404489,4.65057221440449,0.9943217888537856,0.9943217888537859,0,0,6.406879901885986,5.662774562835693,3,3
1499,4,4.495894859241842,4.495894859241842,0.9968827400094479,0.9968827400094479,0,0,6.759868621826172,5.662774562835693,4,4
1499,8,3.7888827409723467,3.852381030645585,1.0090220376144967,1.0079691315463706,4,4,7.3423380851745605,5.662774562835693,4,4
1499,16,3.4557474529635543,3.673309066757935,1.0098644379180122,1.0109066717426909,6,10,7.994055271148682,5.662774562835693,10,6
1499,32,2.7759304918582357,3.559882046631623,1.006347727846253,1.0146503397273543,14,23,8.561399459838867,5.662774562835693,18,9
1499,64,2.298385273115233,3.537964441767189,1.004453451596377,1.016724873892779,29,53,9.465544700622559,5.662774562835693,35,11
1499,128,1.3349208817570888,3.535175885648849,1.0023176670275815,1.0172849959204708,66,115,10.304702758789062,5.662774562835693,62,13
1500,1,10.549413049111433,10.549413049111433,0.9176042321094693,0.9176042321094701,0,0,10.836165428161621,10.836165428161621,1,1
1500,2,9.20273314828213,9.202733148282132,0.9495863774098834,0.9495863774098843,0,0,10.893019676208496,10.836165428161621,2,2
1500,3,9.087097302939627,9.087097302939629,0.9533290257413761,0.9533290257413771,0,0,11.184832572937012,10.836165428161621,3,3
1500,4,9.053678462276684,9.053678462276682,0.9545879256408724,0.954587925640874,0,0,11.447356224060059,10.836165428161621,4,4
1500,8,8.754623034952738,8.772517530013689,0.9656039509627355,0.9660524803789083,2,2,11.747369766235352,10.836165428161621,6,6
1500,16,8.201740424792458,8.348650150455668,0.979420795139171,0.9800728693005728,6,8,12.143699645996094,10.836165428161621,10,8
1500,32,7.6460458851151225,8.125809763069661,0.9837080667758326,0.987474944938299,12,19,12.46667194366455,10.836165428161621,20,13
1500,64,6.890306117725525,8.120462112665727,0.9748105063285426,0.9881307033054023,32,51,12.955363273620605,10.836165428161621,32,13
1500,128,4.416381053217785,8.05405786433496,0.982201074372923,0.9925820005366918,66,116,13.470141410827637,10.836165428161621,62,12
1501,1,11.522723222173726,11.52272322217373,0.9095970877158633,0.9095970877158647,0,0,11.84730052947998,11.84730052947998,1,1
1501,2,10.047759757160579,10.047759757160579,0.9579670135437264,0.9579670135437268,0,0,13.037466049194336,11.84730052947998,2,2
1501,3,9.781110193752713,9.781110193752713,0.9723181402199024,0.9723181402199026,0,0,13.346205711364746,11.84730052947998,3,3
1501,4,9.21101371948461,9.21101371948461,0.9943256409709353,0.9943256409709351,0,0,13.388184547424316,11.84730052947998,4,4
1501,8,8.809882518066079,8.861000751962838,1.0086180934139612,1.0092874314101927,1,1,14.353459358215332,11.84730052947998,7,7
1501,16,8.449450100255069,8.816474704706678,1.0108776366244716,1.0133592066409178,5,6,14.625471115112305,11.84730052947998,11,10
1501,32,7.558759461370756,8.756246597320775,1.0078640736504965,1.0189689040622745,14,18,15.406438827514648,11.84730052947998,18,14
1501,64,6.0534220253905175,8.455241467511184,1.0131644299381142,1.0347176658620258,28,49,15.924834251403809,11.84730052947998,36,15
1501,128,4.631331360010938,8.372441011074358,1.0038418685505541,1.0378772064210835,63,111,16.535921096801758,11.84730052947998,65,17
1502,1,10.221846601946181,10.221846601946186,0.9368685749021299,0.9368685749021319,0,0,10.394867897033691,10.394867897033691,1,1
1502,2,8.811664744561394,8.811664744561368,0.9623223808234413,0.9623223808234435,0,0,10.413370132446289,10.394867897033691,2,2
1502,3,7.161314294434316,7.161314294434315,0.9986750057235021,0.9986750057235037,0,0,10.43897533416748,10.394867897033691,3,3
1502,4,6.844668257483514,6.844668257483514,1.0051822604700056,1.0051822604700065,0,0,10.579883575439453,10.394867897033691,4,4
1502,8,6.6277751611591835,6.6277751611591835,1.009068888105241,1.009068888105241,0,0,11.118830680847168,10.394867897033691,8,8
1502,16,6.352838951208401,6.581412008184992,1.0097157858722654,1.0104340675137449,8,8,11.4559907913208,10.394867897033691,8,8
1502,32,5.5443864973874275,6.466908839452031,1.0127981976524887,1.0151114416428364,12,19,11.846677780151367,10.394867897033691,20,13
1502,64,4.263658210487411,6.313839724192405,1.0114020870900886,1.019281383279186,33,51,12.237156867980957,10.394867897033691,31,13
1502,128,2.2986615860362587,6.092034407640221,1.0082971292579557,1.0276240555884857,63,115,12.55841064453125,10.394867897033691,65,13
1503,1,10.042859446439953,10.042859446439955,0.9408238417175301,0.9408238417175339,0,0,10.198034286499023,10.198034286499023,1,1
1503,2,8.633244102276768,8.633244102276768,0.9711032129780193,0.9711032129780206,0,0,10.323111534118652,10.198034286499023,2,2
1503,3,7.247696089212582,7.247696089212581,0.9955316747324974,0.9955316747324972,0,0,10.332064628601074,10.198034286499023,3,3
1503,4,7.243501457691147,7.243501457691147,0.9957244797956294,0.9957244797956298,0,0,10.47831916809082,10.198034286499023,4,4
1503,8,6.996072027648816,7.006371988680477,0.9998166180026178,1.000308906173498,2,2,11.252114295959473,10.198034286499023,6,6
1503,16,6.071332695423574,6.292432562330713,1.0226821870528924,1.0211031520819296,7,8,11.89903450012207,10.198034286499023,9,8
1503,32,5.414314327412719,6.032555549732935,1.0310164306031346,1.033917189830802,13,18,12.502765655517578,10.198034286499023,19,14
1503,64,4.305102016813346,5.924470354961991,1.022623133975393,1.036895080410984,30,46,13.206986427307129,10.198034286499023,34,18
1503,128,2.701632629234265,5.886369453284197,1.0049176061996743,1.0398344903307868,68,108,13.703691482543945,10.198034286499023,60,20
1504,1,10.145694709364111,10.145694709364113,0.9454448172330181,0.9454448172330215,0,0,10.274797439575195,10.274797439575195,1,1
1504,2,8.390901124903742,8.390901124903744,0.9858863803533447,0.9858863803533482,0,0,11.359696388244629,10.274797439575195,2,2
1504,3,7.782984489302384,7.782984489302383,1.0021627809428648,1.002162780942868,0,0,11.446321487426758,10.274797439575195,3,3
1504,4,7.67135562613519,7.67135562613519,1.0067268236072047,1.0067268236072073,0,0,11.64173412322998,10.274797439575195,4,4
1504,8,6.841033950707411,6.8927682797399354,1.0266077729974237,1.0269852973222677,1,1,12.2932767868042,10.274797439575195,7,7
1504,16,6.441618317438247,6.662299938755192,1.030217573873175,1.031358315544241,4,7,12.703824043273926,10.274797439575195,12,9
1504,32,5.540626103312022,6.6455732860554555,1.0292776759749864,1.0325875812833993,13,20,13.363571166992188,10.274797439575195,19,12
1504,64,4.291391447350236,6.370467506975812,1.0244109630889011,1.0459719245930774,26,47,14.24487018585205,10.274797439575195,38,17
1504,128,2.5583030014783015,6.343887150920278,1.0023984057248911,1.0469714904490641,61,110,14.989867210388184,10.274797439575195,67,18
1505,1,9.227169610633178,9.22716961063318,0.9415286695148056,0.9415286695148084,0,0,9.393521308898926,9.393521308898926,1,1
1505,2,7.899475479984821,7.89947547998482,0.9686975758640648,0.9686975758640664,0,0,9.88826847076416,9.393521308898926,2,2
1505,3,7.896234001020198,7.8962340010202,0.9687331440972065,0.9687331440972076,0,0,9.970232963562012,9.393521308898926,3,3
1505,4,7.84082397435151,7.896234001020201,0.9687542652013305,0.9687331440972076,1,1,10.115693092346191,9.393521308898926,3,3
1505,8,7.242435142524264,7.360844983522419,0.9847140704614217,0.9836550609986734,2,2,10.549797058105469,9.393521308898926,6,6
1505,16,6.627488438492173,6.943140389807303,0.9957026563910063,0.9959151536857063,5,8,10.796577453613281,9.393521308898926,11,8
1505,32,5.810105419873638,6.671753672975419,1.0095358519452595,1.0028880423218298,15,22,11.009827613830566,9.393521308898926,17,10
1505,64,4.715390207258156,6.649717160518542,1.0074328833020385,1.0050348167383039,29,51,11.527392387390137,9.393521308898926,35,13
1505,128,2.871870003469715,6.374487252313046,1.000419944748405,1.0121883657991764,55,113,12.063708305358887,9.393521308898926,73,15
1506,1,5.120915497676168,5.120915497676168,0.9824990669227995,0.9824990669228003,0,0,5.148812294006348,5.148812294006348,1,1
1506,2,4.4448367434506455,4.4448367434506455,0.9922924747912785,0.9922924747912787,0,0,5.276914596557617,5.148812294006348,2,2
1506,3,4.245377362408574,4.245377362408574,0.9942926886742469,0.9942926886742476,0,0,5.752058982849121,5.148812294006348,3,3
1506,4,3.9002330378209793,3.900316432891587,0.9988212770142673,0.9988265715251559,1,1,5.758758544921875,5.148812294006348,3,3
1506,8,3.7286639832094957,3.767943541355596,1.0015879799054745,1.0012389739583551,2,2,6.067516803741455,5.148812294006348,6,6
1506,16,2.7777614143787974,3.2017440384775493,1.004728491181572,1.0057136207086321,5,8,6.25568151473999,5.148812294006348,11,8
1506,32,2.27139933718876,2.817265129477534,1.0080741169990302,1.0117377223392128,13,18,6.890046119689941,5.148812294006348,19,14
1506,64,1.2856618298034503,2.715367892960127,1.0025123988500257,1.0139359923389333,28,47,7.469703674316406,5.148812294006348,36,17
1506,128,0.6317204576233093,2.675565936268632,0.9998357005998266,1.0147268490002113,59,109,8.221250534057617,5.148812294006348,69,19
1507,1,9.479452462905309,9.47945246290531,0.937684994647652,0.9376849946476541,0,0,9.657416343688965,9.657416343688965,1,1
1507,2,8.597650746071604,8.597650746071606,0.9637242407390165,0.9637242407390176,0,0,10.361836433410645,9.657416343688965,2,2
1507,3,7.6700726977435645,7.6700726977435645,0.9853781404055943,0.9853781404055956,0,0,10.3749418258667,9.657416343688965,3,3
1507,4,7.279120412624601,7.279120412624601,0.9938697097558624,0.993869709755864,0,0,10.679588317871094,9.657416343688965,4,4
1507,8,6.4115343221898335,6.411550606031774,1.0191145298592126,1.019061516742255,1,1,11.842059135437012,9.657416343688965,7,7
1507,16,6.2796139803275635,6.34395396644162,1.023642263730405,1.0217900225794527,4,4,12.354360580444336,9.657416343688965,12,12
1507,32,5.587518349119997,6.225263468414976,1.025250805402842,1.028356544718929,13,16,12.945673942565918,9.657416343688965,19,16
1507,64,4.323553843958882,6.046140723660655,1.01795462755735,1.0375934828691338,28,49,13.51588249206543,9.657416343688965,36,15
1507,128,2.79234938013091,6.043582401690542,1.0025313679898078,1.0381531465094533,58,110,14.446855545043945,9.657416343688965,70,18
1508,1,10.011886624799846,10.01188662479985,0.9464200205987019,0.9464200205987044,0,0,10.142589569091797,10.142589569091797,1,1
1508,2,9.293412415183512,9.293412415183514,0.9669716188227705,0.9669716188227728,0,0,10.45311164855957,10.142589569091797,2,2
1508,3,8.571320111899919,8.571320111899919,0.9823291598653601,0.982329159865361,0,0,10.536175727844238,10.142589569091797,3,3
1508,4,7.223309653521078,7.223309653521078,1.0069074786783878,1.0069074786783894,0,0,10.952428817749023,10.142589569091797,4,4
1508,8,6.6555792646761915,6.655579264676191,1.0141215292330779,1.014121529233079,0,0,11.13790225982666,10.142589569091797,8,8
1508,16,6.3324040817414335,6.5283868807236995,1.0157737546073173,1.0169371037836832,3,4,11.672784805297852,10.142589569091797,13,12
1508,32,5.930382972361033,6.319792312437996,1.0211632731866138,1.0223566918239255,15,20,11.923966407775879,10.142589569091797,17,12
1508,64,4.293835196260484,6.307088787522291,1.009133787943597,1.0234450738623093,28,51,12.233346939086914,10.142589569091797,36,13
1508,128,2.5014263588366146,6.264421002457327,0.9992650857359582,1.0258592458328075,67,110,12.530586242675781,10.142589569091797,61,18
1509,1,8.987005112371325,8.987005112371326,0.955343110158623,0.9553431101586244,0,0,9.084035873413086,9.084035873413086,1,1
1509,2,8.321425645130972,8.321425645130972,0.9698530652601796,0.96985306526018,0,0,9.5929536819458,9.084035873413086,2,2
1509,3,8.024202724502603,8.024202724502603,0.977484326716073,0.9774843267160735,0,0,9.96108341217041,9.084035873413086,3,3
1509,4,7.949427995948936,7.949427995948937,0.9812994915685631,0.981299491568564,0,0,10.484761238098145,9.084035873413086,4,4
1509,8,7.058839608182481,7.058839608182481,1.0063699252336307,1.006369925233631,0,0,10.851702690124512,9.084035873413086,8,8
1509,16,6.671989075546986,6.702451678592727,1.0189285499469876,1.0195710863167662,4,5,11.6536226272583,9.084035873413086,12,11
1509,32,5.813026804754912,6.538424758808477,1.0257359372474815,1.0249785193397112,12,21,12.060929298400879,9.084035873413086,20,11
1509,64,4.139580462479335,6.362117659420113,1.017806107515619,1.0352708242604634,27,47,12.718628883361816,9.084035873413086,37,17
1509,128,2.4884797481806715,6.293278213292417,1.005535873556473,1.0383202211805624,69,111,13.552678108215332,9.084035873413086,59,17
1510,1,10.69285459865384,10.69285459865384,0.9334800746966693,0.9334800746966698,0,0,10.874215126037598,10.874215126037598,1,1
1510,2,8.115398797235544,8.115398797235544,0.9936200304326936,0.9936200304326943,0,0,11.552101135253906,10.874215126037598,2,2
1510,3,7.677395867121707,7.677395867121708,1.0011751091891148,1.0011751091891146,0,0,11.63642406463623,10.874215126037598,3,3
1510,4,7.670166647446803,7.670166647446802,1.001947822323891,1.0019478223238907,0,0,11.845795631408691,10.874215126037598,4,4
1510,8,7.402593889729706,7.402618116473396,1.0119558352106988,1.011987165014614,1,1,13.276968955993652,10.874215126037598,7,7
1510,16,7.033515136074886,7.390597400963616,1.0136756868965064,1.0135968395788106,4,5,13.914627075195312,10.874215126037598,12,11
1510,32,6.031396706980786,7.059683905690654,1.0218756405230458,1.028617868925368,14,23,14.488110542297363,10.874215126037598,18,9
1510,64,4.290216835204055,6.98680610015913,1.0158593193222796,1.0324271415375945,30,53,15.318320274353027,10.874215126037598,34,11
1510,128,2.9559779419117014,6.844720744275764,1.0061477038558062,1.043272303820351,59,115,16.301002502441406,10.874215126037598,69,13
1511,1,8.198966290474518,8.198966290474514,0.9603342507989463,0.9603342507989481,0,0,8.282215118408203,8.282215118408203,1,1
1511,2,6.605734861050834,6.605734861050835,0.9872133170569432,0.9872133170569446,0,0,8.614133834838867,8.282215118408203,2,2
1511,3,6.47420235478285,6.47420235478285,0.9900147682654905,0.9900147682654917,0,0,8.721169471740723,8.282215118408203,3,3
1511,4,6.357348592486964,6.357348592486965,0.9915910121372741,0.9915910121372742,0,0,8.791211128234863,8.282215118408203,4,4
1511,8,5.850835108811071,5.87176287222704,1.0024945404144008,1.0025936109259406,2,2,9.623498916625977,8.282215118408203,6,6
1511,16,5.170561861608677,5.338328542639846,1.0144763701440487,1.0148476158437165,6,7,10.242962837219238,8.282215118408203,10,9
1511,32,4.412810731440922,5.041937331980931,1.0203055669582373,1.024148850016908,17,19,10.910435676574707,8.282215118408203,15,13
1511,64,3.3590376442711385,4.943693344594538,1.009970086609984,1.028290563821542,25,48,11.487299919128418,8.282215118408203,39,16
1511,128,1.761147171786224,4.930033431598075,1.0004148479558848,1.0298861698982644,58,108,12.174300193786621,8.282215118408203,70,20
1512,1,8.90051843066589,8.900518430665892,0.9524434416251342,0.9524434416251358,0,0,9.012616157531738,9.012616157531738,1,1
1512,2,7.653802900425976,7.653802900425974,0.9807080640271849,0.9807080640271858,0,0,9.365757942199707,9.012616157531738,2,2
1512,3,7.356457311652604,7.356457311652603,0.9850476719059296,0.9850476719059301,0,0,9.614126205444336,9.012616157531738,3,3
1512,4,6.391272982975388,6.392215197742189,0.9995954726985123,0.9995577650627884,1,1,9.868406295776367,9.012616157531738,3,3
1512,8,5.919930324593172,6.059796085688579,1.0068499141171274,1.006744389186601,2,2,10.432694435119629,9.012616157531738,6,6
1512,16,5.279281085229031,5.63500643273025,1.0140170685598893,1.0152730308539337,7,9,10.608179092407227,9.012616157531738,9,7
1512,32,4.5982467575364705,5.483918671962924,1.018570568678573,1.0197531428774165,15,22,11.049642562866211,9.012616157531738,17,10
1512,64,3.9818279529737115,5.327051699120869,1.0152388910334875,1.0243234896180675,30,49,11.869704246520996,9.012616157531738,34,15
1512,128,2.2531331461237856,5.2696552290634475,1.002361074826793,1.0288541551715018,65,110,12.72937297821045,9.012616157531738,63,18
1513,1,10.291200793654365,10.291200793654367,0.9350483756320005,0.9350483756320017,0,0,10.473243713378906,10.473243713378906,1,1
1513,2,8.43617161522861,8.43617161522861,0.9784297649999305,0.9784297649999316,0,0,10.608729362487793,10.473243713378906,2,2
1513,3,7.770688998050923,7.770688998050922,0.9945852978992602,0.9945852978992609,0,0,10.876436233520508,10.473243713378906,3,3
1513,4,7.657692343503403,7.657692343503403,0.9980768865734039,0.9980768865734047,0,0,11.066838264465332,10.473243713378906,4,4
1513,8,6.893570577825614,6.896757005588571,1.0128140216706576,1.0127926558595974,1,1,12.05728816986084,10.473243713378906,7,7
1513,16,6.447676438132212,6.466940841277744,1.025864206127255,1.0256763033999707,2,2,12.419225692749023,10.473243713378906,14,14
1513,32,5.889264275734931,6.422703017695655,1.0282038841409022,1.0290393629695542,12,15,12.718932151794434,10.473243713378906,20,17
1513,64,4.5532191269491245,6.307023983727719,1.0292437332751005,1.0327357337204677,33,48,12.995565414428711,10.473243713378906,31,16
1513,128,3.1661800422671935,6.085786800619753,1.0146481282036288,1.0400799462606733,61,107,13.29455280303955,10.473243713378906,67,21
1514,1,8.07186811872775,8.07186811872775,0.9604195559453056,0.9604195559453087,0,0,8.154581069946289,8.154581069946289,1,1
1514,2,7.686380155048413,7.686380155048414,0.9725562287732237,0.9725562287732257,0,0,9.724255561828613,8.154581069946289,2,2
1514,3,7.372592118013279,7.37259211801328,0.9800087851201819,0.9800087851201837,0,0,10.615059852600098,8.154581069946289,3,3
1514,4,6.50889356552147,6.509691783449463,0.9959450377140742,0.9960401668207057,1,1,10.847199440002441,8.154581069946289,3,3
1514,8,6.322375839672021,6.369520064532506,0.9999507316985561,1.0009528633036113,2,2,11.502433776855469,8.154581069946289,6,6
1514,16,5.461048054429877,5.49879570593713,1.0291972445434159,1.029538530796252,4,8,12.510246276855469,8.154581069946289,12,8
1514,32,4.739995074015978,5.3281537046997,1.0243131575996196,1.0371421142321962,12,20,13.423301696777344,8.154581069946289,20,12
1514,64,3.7341420824075917,5.245339561487061,1.02546382511893,1.0404326239892585,33,48,14.110451698303223,8.154581069946289,31,16
1514,128,2.6447640860436343,5.216425689885045,1.010561420186016,1.0427480479480793,59,112,15.075621604919434,8.154581069946289,69,16
1515,1,7.429615547537479,7.429615547537479,0.9708478544000453,0.9708478544000472,0,0,7.481238842010498,7.481238842010498,1,1
1515,2,6.5371800390357535,6.537180039035756,0.9885179080718107,0.988517908071812,0,0,7.833699703216553,7.481238842010498,2,2
1515,3,6.215363521296,6.215363521295999,0.9951953553334749,0.9951953553334763,0,0,8.130461692810059,7.481238842010498,3,3
1515,4,5.931001273283808,5.931001273283808,1.0014048520597676,1.0014048520597685,0,0,8.172410011291504,7.481238842010498,4,4
1515,8,5.086809417181147,5.141632520093397,1.0102675179856242,1.0109118720164416,1,2,8.526055335998535,7.481238842010498,7,6
1515,16,4.333205700524826,4.645084662473747,1.0169547317635406,1.0178975934643817,5,6,9.024417877197266,7.481238842010498,11,10
1515,32,3.857883002485439,4.530673008783998,1.0163910797813411,1.0193631300106043,14,19,9.207808494567871,7.481238842010498,18,13
1515,64,2.7225614435447754,4.31625556725665,1.01455095512888,1.0239121966264226,28,46,9.845717430114746,7.481238842010498,36,18
1515,128,1.4360180357526062,4.145939278830806,1.0008041934308336,1.0277307597126455,63,112,10.694074630737305,7.481238842010498,65,16
1516,1,2.7950083111680946,2.7950083111680946,0.9929551719053704,0.9929551719053716,0,0,2.8035502433776855,2.8035502433776855,1,1
1516,2,2.642133802894317,2.642133802894314,0.9942683561928457,0.9942683561928469,0,0,3.1449472904205322,2.8035502433776855,2,2
1516,3,2.5493871292293764,2.549387129229377,0.9952507774628456,0.9952507774628462,0,0,3.486745595932007,2.8035502433776855,3,3
1516,4,2.5461231585763477,2.546123158576348,0.9954438663440509,0.9954438663440522,0,0,3.516740322113037,2.8035502433776855,4,4
1516,8,2.3640386802103874,2.3917564847982473,0.9972899293392495,0.9972093192159556,2,4,3.5781943798065186,2.8035502433776855,6,4
1516,16,1.9952016200732652,2.257681792782258,0.9998773395808688,0.9993355008925423,7,9,3.742419958114624,2.8035502433776855,9,7
1516,32,1.2966562896741085,1.8257005626298404,1.0010962161856316,1.001662593580476,12,21,4.058193206787109,2.8035502433776855,20,11
1516,64,0.715797760514353,1.7418190355087266,0.9998389298410157,1.0027767231993856,33,49,4.427422046661377,2.8035502433776855,31,15
1516,128,0.06327038832104903,1.6872503931217326,0.9995002655404988,1.0040325797611573,66,113,5.12516975402832,2.8035502433776855,62,15
1517,1,6.307355137748006,6.307355137748008,0.9754658356348145,0.9754658356348158,0,0,6.351196765899658,6.351196765899658,1,1
1517,2,4.930847653759132,4.930847653759132,0.9922056747043559,0.9922056747043567,0,0,6.48022985458374,6.351196765899658,2,2
1517,3,4.458680683584615,4.458680683584615,0.9979621943085177,0.9979621943085186,0,0,6.560511589050293,6.351196765899658,3,3
1517,4,4.194702049498419,4.194702049498419,1.0009098162750765,1.0009098162750774,0,0,6.561267375946045,6.351196765899658,4,4
1517,8,3.7504643356027,3.8195915714218023,1.0060950296927067,1.004587496901776,1,1,6.778964042663574,6.351196765899658,7,7
1517,16,3.207065016005451,3.370312881368588,1.0094354376006893,1.010722539311124,5,7,7.252000331878662,6.351196765899658,11,9
1517,32,2.435669609885737,3.2257546084374797,1.0051025612404978,1.0119874996384355,13,19,7.746213912963867,6.351196765899658,19,13
1517,64,1.834439083339478,3.0652446072380206,1.004544697997481,1.0145307657987437,31,52,8.279778480529785,6.351196765899658,33,12
1517,128,1.0757784107014277,3.0424643155700712,1.0004882573061105,1.0162587199627713,64,113,8.820865631103516,6.351196765899658,64,15
1518,1,13.067376986392741,13.067376986392743,0.8942520842999815,0.8942520842999832,0,0,13.438384056091309,13.438384056091309,1,1
1518,2,11.01594429818961,11.015944298189611,0.9580789771496716,0.9580789771496736,0,0,13.470786094665527,13.438384056091309,2,2
1518,3,11.008623483057885,11.008623483057885,0.9592797818058413,0.9592797818058425,0,0,14.178586959838867,13.438384056091309,3,3
1518,4,10.479794260284399,10.480759066921316,0.9790726984088887,0.9793588765245211,1,1,14.524742126464844,13.438384056091309,3,3
1518,8,9.661648045423638,9.669333680439648,1.009837919348213,1.0105227854058012,1,1,14.912370681762695,13.438384056091309,7,7
1518,16,9.347742599977341,9.531675471127233,1.0182228410951357,1.0170380165947048,7,6,15.315217018127441,13.438384056091309,9,10
1518,32,8.135839885973963,9.293682988330604,1.031091361630346,1.026071598781317,15,18,15.859834671020508,13.438384056091309,17,14
1518,64,6.63081196437569,9.039855902935747,1.0298103947689852,1.0387881609359295,32,47,16.264663696289062,13.438384056091309,32,17
1518,128,3.8962914761140426,8.74945871430334,1.0188125924509597,1.0518342901516917,60,113,16.838285446166992,13.438384056091309,68,15
1519,1,7.7881364496865935,7.788136449686594,0.9695738031133884,0.9695738031133901,0,0,7.841718673706055,7.841718673706055,1,1
1519,2,5.917564690770346,5.917564690770347,0.9963885825399879,0.9963885825399881,0,0,8.76276683807373,7.841718673706055,2,2
1519,3,5.603733361153665,5.603733361153665,1.0031267956133878,1.0031267956133876,0,0,9.4295015335083,7.841718673706055,3,3
1519,4,5.3734583234649245,5.373458323464924,1.0081830701936234,1.0081830701936236,0,0,9.551199913024902,7.841718673706055,4,4
1519,8,5.268648976356773,5.3687078750156045,1.007605774809369,1.008622606413704,2,3,10.164510726928711,7.841718673706055,6,5
1519,16,4.58440900558444,5.363964080265832,1.0032121502558917,1.0095564881750438,8,10,11.395548820495605,7.841718673706055,8,6
1519,32,3.861327246078788,5.280391951600366,1.008894220913043,1.0141278933911564,14,22,11.924199104309082,7.841718673706055,18,10
1519,64,2.9374533228583357,5.2604908142167455,1.0047189522734152,1.0161110964502904,31,53,12.413867950439453,7.841718673706055,33,11
1519,128,1.8988721001805644,5.161788079956253,1.0017201024502724,1.0231474394732474,63,114,13.313329696655273,7.841718673706055,65,14
1520,1,12.457510100971206,12.45751010097121,0.8963924894210279,0.8963924894210291,0,0,12.83487319946289,12.83487319946289,1,1
1520,2,11.37490729252276,11.37490729252276,0.9353179951370265,0.9353179951370267,0,0,13.756078720092773,12.83487319946289,2,2
1520,3,10.719437685974556,10.719437685974556,0.9582548786068785,0.9582548786068794,0,0,14.125934600830078,12.83487319946289,3,3
1520,4,10.649504812246814,10.649504812246814,0.9625746067302525,0.962574606730253,0,0,14.418293952941895,12.83487319946289,4,4
1520,8,9.941611224617843,9.943534984845684,0.9941089712409121,0.9942438362297121,1,1,14.673660278320312,12.83487319946289,7,7
1520,16,9.291102312766972,9.742645518135381,1.0097903929066263,1.0046344406610308,5,6,15.01612377166748,12.83487319946289,11,10
1520,32,8.105778712949899,9.272767773157447,1.027088787533056,1.0258089987159569,12,23,15.440423011779785,12.83487319946289,20,9
1520,64,5.794551779386255,8.277450022259996,1.04447104285591,1.0506978011223707,28,51,15.749838829040527,12.83487319946289,36,13
1520,128,3.80043706567891,7.950697164857338,1.0244212105186195,1.0584616337736148,58,110,16.170795440673828,12.83487319946289,70,18
1521,1,7.850592279266124,7.850592279266125,0.9602293281844644,0.9602293281844652,0,0,7.942129611968994,7.942129611968994,1,1
1521,2,7.317292842134138,7.317292842134139,0.9677122727877694,0.9677122727877706,0,0,8.557559967041016,7.942129611968994,2,2
1521,3,6.953968270441438,6.953968270441437,0.9766616378963939,0.976661637896395,0,0,9.75223159790039,7.942129611968994,3,3
1521,4,6.302847152869335,6.302847152869335,0.995881354155941,0.9958813541559401,0,0,10.042665481567383,7.942129611968994,4,4
1521,8,6.002363817941615,6.071327672746573,0.9992905831576341,1.001796149291002,3,3,10.502097129821777,7.942129611968994,5,5
1521,16,5.669958316844734,6.042933228175696,1.0010342622664072,1.004585210973024,7,9,11.277329444885254,7.942129611968994,9,7
1521,32,4.610693825820355,5.90318999438744,1.007053781269747,1.014170100520646,13,22,11.974517822265625,7.942129611968994,19,10
1521,64,3.4815558293054423,5.890323885762366,0.9998115843011651,1.0158941186661568,32,52,12.578099250793457,7.942129611968994,32,12
1521,128,2.2742266429150595,5.800984073131528,1.0018421017955568,1.0227225517332166,67,115,13.089444160461426,7.942129611968994,61,13
1522,1,7.274509926629983,7.274509926629985,0.9639113763211985,0.9639113763212004,0,0,7.35528564453125,7.35528564453125,1,1
1522,2,6.3368095870357655,6.336809587035767,0.9804135233871278,0.980413523387129,0,0,8.179657936096191,7.35528564453125,2,2
1522,3,6.018800184329386,6.018800184329386,0.988061537001785,0.9880615370017855,0,0,9.01913833618164,7.35528564453125,3,3
1522,4,5.879722774303233,5.879722774303233,0.9914702928317133,0.9914702928317136,0,0,9.108428001403809,7.35528564453125,4,4
1522,8,5.708638834855039,5.763637799341656,0.9935551418590133,0.9959811617932393,2,2,9.703612327575684,7.35528564453125,6,6
1522,16,5.131227578638198,5.733096870616531,0.9938923847704615,0.9979248970403407,7,7,9.913610458374023,7.35528564453125,9,9
1522,32,4.32520215430832,5.669288659116902,1.0071049454465835,1.0012028543875147,13,21,10.527765274047852,7.35528564453125,19,11
1522,64,2.9594777847527327,5.591002400332429,1.0037729086649878,1.005581165319907,29,52,11.155326843261719,7.35528564453125,35,12
1522,128,1.5167088770628725,5.416217028969205,1.003441765594304,1.012499589546664,68,117,11.693997383117676,7.35528564453125,60,11
1523,1,8.671830563435634,8.671830563435634,0.9638439750464658,0.9638439750464679,0,0,8.74179458618164,8.74179458618164,1,1
1523,2,6.610919793721451,6.610919793721451,0.9998430874300697,0.9998430874300706,0,0,9.876762390136719,8.74179458618164,2,2
1523,3,6.506173740431106,6.506173740431106,1.0040844286816708,1.0040844286816708,0,0,9.90753173828125,8.74179458618164,3,3
1523,4,6.299521058783846,6.299521058783846,1.0104620054497861,1.010462005449787,0,0,10.08456039428711,8.74179458618164,4,4
1523,8,6.002539508457714,6.0857841464823235,1.0137280586706903,1.0156811269311299,2,3,10.673666000366211,8.74179458618164,6,5
1523,16,5.621322967220852,5.93735482244441,1.0194293510946637,1.0220877603490568,5,9,11.136280059814453,8.74179458618164,11,7
1523,32,4.293389535697479,5.094123559927612,1.0325832584629535,1.0450792445773756,9,22,11.568241119384766,8.74179458618164,23,10
1523,64,3.296597584405963,4.908159414176011,1.0238825042200026,1.049560412163309,28,49,12.082871437072754,8.74179458618164,36,15
1523,128,1.9973495578312255,4.771374826042837,1.010479296009764,1.0539380046690803,54,108,12.733634948730469,8.74179458618164,74,20
1524,1,12.168779201876891,12.168779201876891,0.9070094979497184,0.907009497949719,0,0,12.470841407775879,12.470841407775879,1,1
1524,2,10.70361560591984,10.703615605919842,0.9471866577544406,0.9471866577544417,0,0,12.496950149536133,12.470841407775879,2,2
1524,3,10.254268212709755,10.254268212709755,0.9594628537613803,0.9594628537613807,0,0,12.683631896972656,12.470841407775879,3,3
1524,4,9.400787544142402,9.400787544142402,0.9807603526391944,0.9807603526391935,0,0,12.8416109085083,12.470841407775879,4,4
1524,8,8.07215609362956,8.07390293787248,1.0168045965244974,1.016721393605922,2,2,13.16533374786377,12.470841407775879,6,6
1524,16,7.393124419271901,7.5517418397702265,1.0359831740397172,1.0315868118491762,6,7,13.621804237365723,12.470841407775879,10,9
1524,32,6.663265275301813,7.359240813775612,1.0328375833690049,1.0388018921558948,16,21,14.842795372009277,12.470841407775879,16,11
1524,64,5.2882492419135305,7.2544707634554975,1.0118432427455015,1.0423546742625254,28,51,15.572957038879395,12.470841407775879,36,13
1524,128,3.299734441502233,7.2113478189728415,0.9979811308199111,1.0457391469337054,59,111,16.495241165161133,12.470841407775879,69,17
1525,1,8.491500963665555,8.491500963665558,0.9617878305538553,0.9617878305538586,0,0,8.569114685058594,8.569114685058594,1,1
1525,2,7.485087993762227,7.48508799376223,0.9815321697422497,0.981532169742252,0,0,8.892680168151855,8.569114685058594,2,2
1525,3,7.4769792451910835,7.476979245191086,0.981886423608375,0.9818864236083772,0,0,9.046792030334473,8.569114685058594,3,3
1525,4,6.938765679815792,6.938765679815792,0.9943783046990102,0.9943783046990113,0,0,9.135965347290039,8.569114685058594,4,4
1525,8,5.584101336992865,5.86766605603522,1.011592679832552,1.0079847346638793,2,2,9.42165470123291,8.569114685058594,6,6
1525,16,5.269495843583238,5.570284640075203,1.0166234680746835,1.0120034004298608,3,7,9.805607795715332,8.569114685058594,13,9
1525,32,4.497762024524517,5.074007384251615,1.0190562294032706,1.0203501400739912,15,23,10.382487297058105,8.569114685058594,17,9
1525,64,3.251276057871895,5.05537733524079,1.0130905755310882,1.0217321618282371,28,53,10.930011749267578,8.569114685058594,36,11
1525,128,1.6098956178709238,4.9442017234510365,1.0026088122049004,1.0255771710672636,66,114,11.594829559326172,8.569114685058594,62,14
1526,1,7.706408416717008,7.706408416717008,0.9680426586436229,0.9680426586436244,0,0,7.765930652618408,7.765930652618408,1,1
1526,2,6.6504479006127575,6.650447900612758,0.9862231614674757,0.9862231614674764,0,0,7.848076343536377,7.765930652618408,2,2
1526,3,6.153730360848799,6.153730360848799,0.9919569010060434,0.9919569010060434,0,0,8.010472297668457,7.765930652618408,3,3
1526,4,6.150706007018925,6.153730360848799,0.9920341585985082,0.9919569010060434,1,1,8.14682674407959,7.765930652618408,3,3
1526,8,5.464597257319794,5.624717881700894,1.0022619654801594,1.0014844801195013,2,2,8.718873023986816,7.765930652618408,6,6
1526,16,4.972549096520563,5.324729374422489,1.0097632254717785,1.0068751534177816,7,9,9.331792831420898,7.765930652618408,9,7
1526,32,4.24910027643265,5.168834787752883,1.01051084307962,1.0111224428047385,14,20,9.76000690460205,7.765930652618408,18,12
1526,64,3.1553073305351855,5.138514399440084,1.0051919201792285,1.011943184405871,29,53,10.38333511352539,7.765930652618408,35,11
1526,128,1.4224865814130638,5.122593482051088,0.9987665736501926,1.0138752475927175,62,114,11.083796501159668,7.765930652618408,66,14
1527,1,6.279998319244619,6.279998319244621,0.9825261597602503,0.9825261597602524,0,0,6.301844120025635,6.301844120025635,1,1
1527,2,5.793419934399324,5.793419934399324,0.9899964681231045,0.9899964681231058,0,0,6.535502910614014,6.301844120025635,2,2
1527,3,5.383109016843361,5.383109016843361,0.99615315619714,0.996153156197141,0,0,6.9781718254089355,6.301844120025635,3,3
1527,4,5.370600117030129,5.370600117030129,0.9965826123096833,0.9965826123096846,0,0,7.501611232757568,6.301844120025635,4,4
1527,8,4.74147187340022,4.779534911160463,1.0077565913016664,1.0082418311379122,3,3,7.895162105560303,6.301844120025635,5,5
1527,16,4.136239364306575,4.22848457932498,1.0162191513131862,1.01679787969748,5,7,8.730774879455566,6.301844120025635,11,9
1527,32,3.370534056450624,3.8166750313341904,1.014333591163898,1.0208271962282263,12,19,9.330899238586426,6.301844120025635,20,13
1527,64,2.3458510019022665,3.725376223131963,1.0074572198690057,1.0234477837165568,28,48,10.126708030700684,6.301844120025635,36,16
1527,128,1.4157999503063998,3.7068783622761514,1.0001709391962823,1.024858282773878,65,110,10.853946685791016,6.301844120025635,63,18
1528,1,10.485080437051447,10.48508043705145,0.9373860229635457,0.937386022963548,0,0,10.647367477416992,10.647367477416992,1,1
1528,2,9.989643913180469,9.98964391318047,0.9504914479872605,0.9504914479872623,0,0,11.428617477416992,10.647367477416992,2,2
1528,3,8.875221995481192,8.875221995481192,0.9756839629638967,0.975683962963898,0,0,11.51555347442627,10.647367477416992,3,3
1528,4,8.466138481904245,8.466138481904245,0.9860747717280687,0.9860747717280693,0,0,11.713590621948242,10.647367477416992,4,4
1528,8,7.852581694523872,7.911667458378256,1.0013308877701224,1.0031250056581251,1,1,12.302215576171875,10.647367477416992,7,7
1528,16,7.103678133938682,7.636544986415299,1.0137483480711464,1.013597606617001,4,6,13.281885147094727,10.647367477416992,12,10
1528,32,6.2167500584422735,7.33613714642098,1.023520684069785,1.0246553448523434,11,21,13.883706092834473,10.647367477416992,21,11
1528,64,4.485299809719013,6.9183339381068985,1.0208543780689623,1.0397244561762113,28,52,14.786654472351074,10.647367477416992,36,12
1528,128,2.694262453430032,6.914870981171663,1.002966170735179,1.0405126010135408,59,115,15.586463928222656,10.647367477416992,69,13
1529,1,12.562168420596414,12.562168420596418,0.8905171092248191,0.8905171092248207,0,0,12.988237380981445,12.988237380981445,1,1
1529,2,9.691200684513706,9.691200684513708,0.978962005753024,0.9789620057530248,0,0,13.34564208984375,12.988237380981445,2,2
1529,3,9.544298232134791,9.54429823213479,0.9831532436591721,0.9831532436591732,0,0,13.80188274383545,12.988237380981445,3,3
1529,4,9.538949884468288,9.538949884468288,0.9841754185478068,0.9841754185478073,0,0,14.402252197265625,12.988237380981445,4,4
1529,8,9.065290598160848,9.065571429485027,1.001978707501291,1.0021681058035299,1,1,14.928596496582031,12.988237380981445,7,7
1529,16,8.656469745364419,8.784911888765178,1.0183667413665694,1.0242749974614467,4,6,15.609891891479492,12.988237380981445,12,10
1529,32,7.239190587805025,8.295399053028985,1.040055414814995,1.0490774532984246,12,19,16.08399772644043,12.988237380981445,20,13
1529,64,5.840707067423206,7.800285266765814,1.0444812276448545,1.071591419755181,31,46,16.654430389404297,12.988237380981445,33,18
1529,128,4.056673501324676,7.583911179480349,1.0276783036003536,1.0762142243471013,64,111,17.1330623626709,12.988237380981445,64,17
1530,1,7.20682637482288,7.20682637482288,0.9725347585868274,0.9725347585868294,0,0,7.252622127532959,7.252622127532959,1,1
1530,2,6.362568763825262,6.362568763825263,0.9888172253392711,0.988817225339272,0,0,7.512500762939453,7.252622127532959,2,2
1530,3,5.480055738841351,5.480055738841351,1.0021770492307693,1.002177049230771,0,0,8.427494049072266,7.252622127532959,3,3
1530,4,5.43421245811406,5.43421245811406,1.0037476499804272,1.0037476499804283,0,0,8.58193302154541,7.252622127532959,4,4
1530,8,4.9733032654525955,4.9733033395038,1.015083271776323,1.015083230181311,1,1,9.100141525268555,7.252622127532959,7,7
1530,16,4.522278713454721,4.677275144431223,1.0229920318641934,1.0212724668479753,3,6,9.556389808654785,7.252622127532959,13,10
1530,32,3.9846607597595374,4.445798185061182,1.0250867283446785,1.0250038197622182,14,21,9.881278991699219,7.252622127532959,18,11
1530,64,3.3467946735651424,4.135227917077787,1.0243693604828135,1.034807354315054,31,44,10.4915189743042,7.252622127532959,33,20
1530,128,1.8183553466639848,4.082475235772822,1.0070878221628945,1.0373957621338616,60,107,11.417340278625488,7.252622127532959,68,21
1531,1,7.4733349001669716,7.473334900166972,0.9626912273377191,0.9626912273377202,0,0,7.5587663650512695,7.5587663650512695,1,1
1531,2,6.366199692507977,6.366199692507976,0.9825993640462573,0.9825993640462568,0,0,7.809214115142822,7.5587663650512695,2,2
1531,3,4.809795887489144,4.809795887489143,1.0051645342331086,1.0051645342331086,0,0,7.980919361114502,7.5587663650512695,3,3
1531,4,4.729400135905632,4.729400135905633,1.0061002316963037,1.0061002316963035,0,0,8.190128326416016,7.5587663650512695,4,4
1531,8,4.375456545014133,4.4152170046878645,1.0107735072615354,1.0117405794313474,1,1,8.917559623718262,7.5587663650512695,7,7
1531,16,4.028338991841652,4.193403887625572,1.0177420260239949,1.0169567761934388,5,6,9.166024208068848,7.5587663650512695,11,10
1531,32,3.2956686921755716,4.096525696294442,1.0125630321389198,1.0209524844837592,14,18,10.004645347595215,7.5587663650512695,18,14
1531,64,2.5725871792994828,4.0582594178365285,1.009995696946178,1.0233880924488608,28,45,10.51102066040039,7.5587663650512695,36,19
1531,128,1.462155006689593,3.934899187208204,1.001162204419279,1.0265301344153424,61,111,11.113785743713379,7.5587663650512695,67,17
1532,1,7.25993205290594,7.259932052905941,0.961352561242804,0.961352561242805,0,0,7.355480194091797,7.355480194091797,1,1
1532,2,5.914220844576005,5.914220844576005,0.9831097071319577,0.9831097071319571,0,0,7.396595478057861,7.355480194091797,2,2
1532,3,5.571956405833342,5.571956405833342,0.9887497365584061,0.9887497365584053,0,0,7.410733699798584,7.355480194091797,3,3
1532,4,5.4496606721199825,5.4496606721199825,0.9907550050139051,0.9907550050139047,0,0,7.519881248474121,7.355480194091797,4,4
1532,8,5.095457914162524,5.140549197007713,0.9956255692181277,0.995511161558594,1,2,7.79803466796875,7.355480194091797,7,6
1532,16,3.8517671862287366,4.8243614590738275,1.0094027371053986,1.0031282468688834,3,9,8.228278160095215,7.355480194091797,13,7
1532,32,3.4280152205055776,4.752523117348111,1.008554111039646,1.0049875630517877,9,21,8.70324993133545,7.355480194091797,23,11
1532,64,2.0046794991920556,4.248123784230536,1.00611365913596,1.020531932779687,27,49,9.224754333496094,7.355480194091797,37,15
1532,128,0.9934920394706525,4.140649120564122,1.0019018252753153,1.0243374089701105,52,107,9.68704605102539,7.355480194091797,76,21
1533,1,8.064116712055984,8.064116712055961,0.9674619258001697,0.9674619258001709,0,0,8.12215518951416,8.12215518951416,1,1
1533,2,6.993188268489409,6.99318826848941,0.9895564837773545,0.9895564837773552,0,0,8.886874198913574,8.12215518951416,2,2
1533,3,6.329769356019895,6.329769356019896,0.9996912815705997,0.9996912815706,0,0,8.907783508300781,8.12215518951416,3,3
1533,4,6.008382596690945,6.008382596690944,1.0062846882600878,1.0062846882600867,0,0,8.937296867370605,8.12215518951416,4,4
1533,8,4.977867185437696,4.982304716401455,1.019576853383331,1.0196832896279953,1,1,9.509039878845215,8.12215518951416,7,7
1533,16,4.813166096187399,4.944764519831358,1.017545828562078,1.020402990938535,6,8,10.375725746154785,8.12215518951416,10,8
1533,32,4.384264973848148,4.759522377886125,1.0213031194651458,1.0281982402092886,16,19,11.053528785705566,8.12215518951416,16,13
1533,64,3.363358863758138,4.755191005338803,1.01211200653676,1.0287770949788615,31,49,12.068002700805664,8.12215518951416,33,15
1533,128,2.0519476002488903,4.710719172246751,1.004617139731495,1.0301518825730076,60,112,13.057382583618164,8.12215518951416,68,16
1534,1,3.744981610855346,3.744981610855346,0.9908632970726519,0.9908632970726531,0,0,3.7555928230285645,3.7555928230285645,1,1
1534,2,2.5720986817135234,2.5720986817135234,0.9988321058597569,0.9988321058597582,0,0,3.801429510116577,3.7555928230285645,2,2
1534,3,2.5120762708411193,2.5120762708411193,0.9993723964563302,0.9993723964563312,0,0,3.811941623687744,3.7555928230285645,3,3
1534,4,2.2422832992113384,2.2522866827423695,1.0000647801275178,1.0001575949577992,1,1,3.8287367820739746,3.7555928230285645,3,3
1534,8,1.9499127433328203,2.0997341667996348,1.001591838429749,1.0010898514007547,2,2,4.104123115539551,3.7555928230285645,6,6
1534,16,1.631479322064238,1.9316646769561474,1.0022584471502163,1.0024941903240574,4,8,4.461130619049072,3.7555928230285645,12,8
1534,32,1.2603211720216458,1.8655644978083228,1.0026978420196238,1.0031978900165917,10,23,4.77431583404541,3.7555928230285645,22,9
1534,64,0.7043279618024909,1.8655064113900608,1.0002247428440851,1.0032333670287168,30,53,5.16768741607666,3.7555928230285645,34,11
1534,128,0.1672110870933247,1.7371888266567008,0.9992574980638339,1.0043509457490751,69,118,5.614664077758789,3.7555928230285645,59,10
1535,1,9.799659220998034,9.799659220998036,0.9490650872896438,0.949065087289645,0,0,9.917107582092285,9.917107582092285,1,1
1535,2,8.740779748320206,8.740779748320206,0.9798740980573477,0.9798740980573489,0,0,10.888875961303711,9.917107582092285,2,2
1535,3,7.9023144090128445,7.902314409012845,0.9983507022463634,0.9983507022463641,0,0,11.436556816101074,9.917107582092285,3,3
1535,4,7.874576534140303,7.874576534140303,0.9999559529770459,0.9999559529770461,0,0,11.70520305633545,9.917107582092285,4,4
1535,8,7.451936301861478,7.46790857944037,1.0144031066311934,1.0143662349946792,1,2,12.391409873962402,9.917107582092285,7,6
1535,16,7.134205344714377,7.220468867999225,1.024965125401086,1.0262396969894811,4,5,12.825215339660645,9.917107582092285,12,11
1535,32,5.82522592439865,6.859992515014484,1.0296959385030662,1.0418263425905385,12,16,13.764357566833496,9.917107582092285,20,16
1535,64,4.065521670751827,6.691034637181978,1.0215399666517606,1.050179749608077,31,48,14.910554885864258,9.917107582092285,33,16
1535,128,2.567799438691665,6.629528207418198,1.007500057890471,1.055631687277494,61,110,15.881770133972168,9.917107582092285,67,18
1536,1,3.6934763658116054,3.6934763658116054,0.9875552195989773,0.9875552195989789,0,0,3.7136030197143555,3.7136030197143555,1,1
1536,2,3.343097966479696,3.343097966479696,0.9907766505402837,0.9907766505402849,0,0,3.9281156063079834,3.7136030197143555,2,2
1536,3,2.713596419231163,2.7135964192311626,0.9954849176883835,0.9954849176883839,0,0,3.9898104667663574,3.7136030197143555,3,3
1536,4,2.606982816142165,2.606982816142165,0.9967968622984953,0.996796862298496,0,0,4.153730869293213,3.7136030197143555,4,4
1536,8,2.4097005869709562,2.442131860121601,0.9971055013137607,0.9978898993729702,2,2,4.212902069091797,3.7136030197143555,6,6
1536,16,1.6799251291450354,2.055565327423972,1.0009746805023363,1.000400930738019,5,9,4.495954513549805,3.7136030197143555,11,7
1536,32,1.1226076860844632,2.00039247801272,0.9988589467798704,0.9997991924992515,18,23,4.955099105834961,3.7136030197143555,14,9
1536,64,0.5952042555676882,1.8329151855236163,0.9991832652590998,1.0022249903361693,30,54,5.226191520690918,3.7136030197143555,34,10
1536,128,0.08132560219238412,1.8048794317276373,0.9985034712567704,1.0030698758552261,61,116,5.510872840881348,3.7136030197143555,67,12
1537,1,9.832763537616025,9.832763537616025,0.9550766266022721,0.9550766266022731,0,0,9.9222993850708,9.9222993850708,1,1
1537,2,7.036340308939935,7.036340308939934,1.0137985974327972,1.0137985974327979,0,0,10.618335723876953,9.9222993850708,2,2
1537,3,6.942020949514971,6.942020949514971,1.0168941802926206,1.0168941802926206,0,0,10.671707153320312,9.9222993850708,3,3
1537,4,6.9021339301853315,6.902133930185331,1.0166941936700915,1.0166941936700917,0,0,10.74667739868164,9.9222993850708,4,4
1537,8,6.486315343061966,6.610050603503571,1.0252231779151038,1.0226664616353183,2,2,11.502331733703613,9.9222993850708,6,6
1537,16,5.905006097256498,6.004472409929372,1.0377208238430817,1.0365155770798613,5,8,12.178888320922852,9.9222993850708,11,8
1537,32,5.227676860634137,6.004435330406915,1.026812347159465,1.0365897980436796,15,22,12.67094612121582,9.9222993850708,17,10
1537,64,3.9188867706375614,5.965800410521002,1.0198941969830015,1.0394385395970387,33,52,13.138702392578125,9.9222993850708,31,12
1537,128,2.4343136903726355,5.965800410521002,1.0090789608353203,1.0394385395970387,65,116,13.931045532226562,9.9222993850708,63,12
1538,1,8.337431603086305,8.337431603086305,0.9626647094417453,0.9626647094417483,0,0,8.412489891052246,8.412489891052246,1,1
1538,2,6.609210750421955,6.609210750421954,0.993031657508602,0.9930316575086037,0,0,8.792407989501953,8.412489891052246,2,2
1538,3,5.989124458920475,5.989124458920475,1.0012581663590154,1.0012581663590163,0,0,8.866867065429688,8.412489891052246,3,3
1538,4,5.981587733743948,5.981587733743949,1.0015773611404137,1.001577361140415,0,0,9.15831470489502,8.412489891052246,4,4
1538,8,5.036898982327148,5.077444379584382,1.016440459671538,1.0171231637320532,1,2,9.598875999450684,8.412489891052246,7,6
1538,16,4.651292336595575,4.919172865495928,1.0216152445849858,1.0206642490751952,5,7,9.917743682861328,8.412489891052246,11,9
1538,32,3.9390939664700717,4.487718325748091,1.0244445653188663,1.028489658735767,15,20,10.254036903381348,8.412489891052246,17,12
1538,64,3.290741133609738,4.279628609253089,1.02060068631587,1.0306057601463765,26,51,10.664194107055664,8.412489891052246,38,13
1538,128,1.8839355094564547,4.245279305490479,1.0056572617060764,1.032468494126634,66,112,11.293418884277344,8.412489891052246,62,16
1539,1,12.268086369910552,12.268086369910554,0.9081047578857961,0.9081047578857969,0,0,12.564774513244629,12.564774513244629,1,1
1539,2,10.660012980053121,10.660012980053121,0.9554783509221791,0.9554783509221803,0,0,12.579472541809082,12.564774513244629,2,2
1539,3,9.77957217926431,9.779572179264308,0.980803582617362,0.9808035826173623,0,0,12.86205768585205,12.564774513244629,3,3
1539,4,9.511146084147233,9.511146084147233,0.9886758572368348,0.9886758572368345,0,0,12.9644775390625,12.564774513244629,4,4
1539,8,8.292963696645849,8.372435425087595,1.016445447820308,1.0148626496830677,2,2,13.570965766906738,12.564774513244629,6,6
1539,16,8.12582204173167,8.305097353254364,1.019705764391572,1.0195956582998564,5,7,14.153600692749023,12.564774513244629,11,9
1539,32,6.5257087873312,7.6472321865083375,1.040241792547084,1.0411213440646194,13,21,14.494768142700195,12.564774513244629,19,11
1539,64,5.30835752693489,7.469683499207543,1.024096915239955,1.0484174465942149,37,53,15.226438522338867,12.564774513244629,27,11
1539,128,3.562356976584618,7.282136332626452,1.0127633531324984,1.0597011587133405,64,110,15.819424629211426,12.564774513244629,64,18
1540,1,10.398001975924995,10.398001975924997,0.9379258295846187,0.9379258295846211,0,0,10.558789253234863,10.558789253234863,1,1
1540,2,9.419467090789283,9.419467090789286,0.9616919829800157,0.9616919829800172,0,0,11.040312767028809,10.558789253234863,2,2
1540,3,9.218994309263065,9.218994309263065,0.9696744878556568,0.9696744878556581,0,0,11.774628639221191,10.558789253234863,3,3
1540,4,9.025987481118689,9.218994309263065,0.9683771751726464,0.9696744878556581,1,1,12.102668762207031,10.558789253234863,3,3
1540,8,8.784000975596689,9.121555496677622,0.9704946216849206,0.973438997748415,2,3,12.196600914001465,10.558789253234863,6,5
1540,16,6.607310491881931,6.915770451414547,1.0259446935406649,1.0281630921940796,5,6,12.785533905029297,10.558789253234863,11,10
1540,32,5.732728537612134,6.871389949581482,1.022215833851595,1.0324743121427167,12,21,13.847200393676758,10.558789253234863,20,11
1540,64,3.684975045405922,6.611292663894153,1.016231896479916,1.0403708084706724,27,53,14.678641319274902,10.558789253234863,37,11
1540,128,2.3523484682915443,6.573088982735447,1.0057941511148927,1.0435442951451155,57,115,15.624005317687988,10.558789253234863,71,13
1541,1,11.30785671872287,11.307856718722874,0.9229553057650096,0.9229553057650124,0,0,11.535638809204102,11.535638809204102,1,1
1541,2,10.53004998663294,10.53004998663294,0.9500028641785356,0.9500028641785365,0,0,12.13813591003418,11.535638809204102,2,2
1541,3,10.037574523748551,10.037574523748551,0.9657979191128965,0.9657979191128967,0,0,12.323478698730469,11.535638809204102,3,3
1541,4,9.767840245978725,9.767840245978723,0.9756331421111507,0.9756331421111489,0,0,12.555355072021484,11.535638809204102,4,4
1541,8,9.173013388527156,9.212566012686276,0.9883615805314631,0.9898001911923364,2,3,13.57151985168457,11.535638809204102,6,5
1541,16,8.341696706257517,9.116534873414093,0.999771484926236,0.9975657742908446,3,7,13.84765911102295,11.535638809204102,13,9
1541,32,6.926552783394972,8.355371124872828,1.0209275897418983,1.0258890046470073,13,22,14.430335998535156,11.535638809204102,19,10
1541,64,5.4120170232624645,8.280655609205613,1.0318085845973248,1.0333614373135063,28,51,15.127434730529785,11.535638809204102,36,13
1541,128,3.814985599598211,8.16125651912923,1.0104484200825234,1.0431130661175048,65,114,16.120346069335938,11.535638809204102,63,14
1542,1,6.0422372405700875,6.042237240570088,0.9767827732106028,0.9767827732106031,0,0,6.083407402038574,6.083407402038574,1,1
1542,2,4.347063947204356,4.347063947204356,0.9985858800039054,0.9985858800039058,0,0,6.186462879180908,6.083407402038574,2,2
1542,3,4.129323804120015,4.129323804120015,1.0015679309229477,1.0015679309229477,0,0,6.8434858322143555,6.083407402038574,3,3
1542,4,3.991010777042534,3.991010777042534,1.0037943136577543,1.0037943136577547,0,0,7.015861988067627,6.083407402038574,4,4
1542,8,3.5032337158834808,3.5032337158834803,1.009541399381879,1.009541399381878,0,0,7.234713554382324,6.083407402038574,8,8
1542,16,3.234684202125821,3.416624671598584,1.0106870036315496,1.0119074721689363,5,5,7.7433552742004395,6.083407402038574,11,11
1542,32,2.669249782528601,3.3388670315370743,1.0093673136086379,1.0148006973736905,11,18,8.107641220092773,6.083407402038574,21,14
1542,64,1.541050703455784,3.325617704143579,1.0016699159955194,1.0151660113537115,31,49,8.596307754516602,6.083407402038574,33,15
1542,128,0.8570064537222922,3.2868904069657185,0.9996488114233125,1.0161666306907104,61,109,9.238310813903809,6.083407402038574,67,19
1543,1,9.421908296597321,9.421908296597323,0.9519196181666281,0.9519196181666312,0,0,9.530638694763184,9.530638694763184,1,1
1543,2,8.575468624719687,8.575468624719688,0.9763679817123783,0.9763679817123813,0,0,10.500066757202148,9.530638694763184,2,2
1543,3,8.573280392326168,8.573280392326172,0.9767576441087863,0.9767576441087898,0,0,11.022798538208008,9.530638694763184,3,3
1543,4,8.085281305398217,8.106822505896709,0.9875712094485474,0.9881035616929835,1,1,11.03831958770752,9.530638694763184,3,3
1543,8,7.189769923797134,7.263381417395356,1.010601180374104,1.011045763293148,3,3,11.222900390625,9.530638694763184,5,5
1543,16,6.487352283077861,6.959348544634123,1.0214657797244837,1.020370403615559,6,7,11.762840270996094,9.530638694763184,10,9
1543,32,6.001967570083128,6.803942487814547,1.0248670173185137,1.0272312742595817,13,19,12.29985523223877,9.530638694763184,19,13
1543,64,4.979661124062925,6.730221526676756,1.0184719161073272,1.0305766753348329,32,47,12.653159141540527,9.530638694763184,32,17
1543,128,2.9497228696391544,6.473633713606639,1.0077030180998698,1.039682944355925,67,111,13.064078330993652,9.530638694763184,61,17
1544,1,7.65101724580615,7.651017245806147,0.9673139502502994,0.9673139502503023,0,0,7.711736679077148,7.711736679077148,1,1
1544,2,5.899645757626697,5.899645757626696,0.999198452994208,0.9991984529942095,0,0,8.04430866241455,7.711736679077148,2,2
1544,3,5.612209504005022,5.612209504005022,1.0042614395821814,1.0042614395821823,0,0,8.112011909484863,7.711736679077148,3,3
1544,4,5.612196274773558,5.612209504005021,1.0042554611405743,1.0042614395821823,1,1,8.403193473815918,7.711736679077148,3,3
1544,8,4.533795772232609,4.697865422844547,1.0193509278064503,1.0178771199471992,3,2,9.005855560302734,7.711736679077148,5,6
1544,16,4.376201059029518,4.589994127177661,1.021572767780093,1.02083194731299,7,7,9.38136100769043,7.711736679077148,9,9
1544,32,3.5948528673926092,4.31852404010109,1.026708191611959,1.0286603798846576,13,20,10.131197929382324,7.711736679077148,19,12
1544,64,3.017367081609535,4.249245971145316,1.0172849431382163,1.0317420865542581,27,50,10.856693267822266,7.711736679077148,37,14
1544,128,2.2137967351148253,4.216659034829184,1.0086107237599178,1.034167206393959,60,109,11.465410232543945,7.711736679077148,68,19
1545,1,6.74145336447792,6.741453364477919,0.975491536879616,0.9754915368796184,0,0,6.781613349914551,6.781613349914551,1,1
1545,2,5.454745765382449,5.454745765382449,0.9964312030779995,0.9964312030780009,0,0,7.380777359008789,6.781613349914551,2,2
1545,3,5.396467699319232,5.396467699319232,0.9969570121425115,0.9969570121425135,0,0,7.58026123046875,6.781613349914551,3,3
1545,4,5.3835839750079035,5.383583975007905,0.9977037997810851,0.9977037997810866,0,0,7.764730930328369,6.781613349914551,4,4
1545,8,4.89343250854382,4.893432508543819,1.0044073615114262,1.004407361511427,0,0,7.915560245513916,6.781613349914551,8,8
1545,16,4.016079649587665,4.4780354458910585,1.0114308948773618,1.0106883356488512,4,5,8.471508979797363,6.781613349914551,12,11
1545,32,3.610845464984667,4.335404591491483,1.0076311054235267,1.014901930283893,15,18,9.34332275390625,6.781613349914551,17,14
1545,64,2.373184752692575,4.234007718116214,1.003191316927636,1.0199403897613786,30,47,9.985952377319336,6.781613349914551,34,17
1545,128,1.3606908878173887,4.132896438215187,1.0007262311974792,1.0234204972175573,62,111,10.840916633605957,6.781613349914551,66,17
1546,1,9.769318219930353,9.769318219930355,0.949909547093706,0.9499095470937099,0,0,9.880062103271484,9.880062103271484,1,1
1546,2,7.234149778484245,7.234149778484243,1.0060546547267513,1.0060546547267544,0,0,10.85452938079834,9.880062103271484,2,2
1546,3,6.988495642652374,6.9884956426523726,1.0125832001273913,1.0125832001273933,0,0,11.047063827514648,9.880062103271484,3,3
1546,4,6.768785925476199,6.768785925476198,1.0169158246815817,1.0169158246815833,0,0,11.072035789489746,9.880062103271484,4,4
1546,8,6.603559012703325,6.603559012703326,1.0203590416812682,1.0203590416812687,0,0,12.013191223144531,9.880062103271484,8,8
1546,16,6.515412753134197,6.562912986996696,1.021698083540032,1.022484122403552,5,5,12.519209861755371,9.880062103271484,11,11
1546,32,5.452338066012851,6.276493339422996,1.028180638350531,1.0338312676971897,10,18,12.925549507141113,9.880062103271484,22,14
1546,64,4.624939330361259,6.235807145376996,1.0234619126543252,1.0367668764994957,26,49,13.639190673828125,9.880062103271484,38,15
1546,128,2.985714013068469,6.162662666492742,1.0059559305369048,1.0416683764666637,59,114,14.27021598815918,9.880062103271484,69,14
1547,1,10.238512069698242,10.238512069698245,0.9352476174018767,0.9352476174018791,0,0,10.422286987304688,10.422286987304688,1,1
1547,2,8.031509769072589,8.03150976907259,0.9895644166255118,0.9895644166255129,0,0,10.945863723754883,10.422286987304688,2,2
1547,3,7.5736335603451765,7.573633560345176,0.9983502331204704,0.9983502331204719,0,0,11.166069984436035,10.422286987304688,3,3
1547,4,7.263856671949566,7.263856671949565,1.0070911781881144,1.0070911781881153,0,0,11.320067405700684,10.422286987304688,4,4
1547,8,6.864767159638495,6.864767159638495,1.0190955115666265,1.0190955115666291,0,0,11.860868453979492,10.422286987304688,8,8
1547,16,5.992291102375368,6.098656087614015,1.0371298689713397,1.0368551123610648,7,8,12.368359565734863,10.422286987304688,9,8
1547,32,5.609423312118292,5.90092046326999,1.0414366489978948,1.0406167310581633,13,17,12.72159481048584,10.422286987304688,19,15
1547,64,4.329607035888227,5.890551098702034,1.0298716861754935,1.0417888583783745,24,46,13.312576293945312,10.422286987304688,40,18
1547,128,2.270364137812544,5.88629874265689,1.0077183335133753,1.0424415696787563,64,107,13.808060646057129,10.422286987304688,64,21
1548,1,8.509009974123597,8.509009974123602,0.9658907955809283,0.9658907955809299,0,0,8.570542335510254,8.570542335510254,1,1
1548,2,6.251043111803063,6.251043111803065,1.0054949716117416,1.0054949716117425,0,0,8.9054536819458,8.570542335510254,2,2
1548,3,6.132151295226548,6.1321512952265484,1.0084270937632207,1.0084270937632214,0,0,9.520979881286621,8.570542335510254,3,3
1548,4,6.062181814359387,6.062181814359387,1.009597256529604,1.0095972565296047,0,0,9.76236629486084,8.570542335510254,4,4
1548,8,5.689570977435295,5.691914829654128,1.019226733614749,1.0191511249832033,1,1,10.280874252319336,8.570542335510254,7,7
1548,16,5.272682080552455,5.408598148692011,1.0260739889382202,1.0247426538421585,5,5,10.703452110290527,8.570542335510254,11,11
1548,32,4.679517499054764,5.362142744468824,1.0242644304567732,1.0256790211826958,12,18,11.061531066894531,8.570542335510254,20,14
1548,64,3.469455320713156,5.3239344404381095,1.020111834045134,1.0276345560707023,25,50,11.4646577835083,8.570542335510254,39,14
1548,128,2.0884301290760137,5.321101226103323,1.0045653024692704,1.0282302109124897,56,109,12.200020790100098,8.570542335510254,72,19
1549,1,12.462297489095485,12.462297489095487,0.9031556517707495,0.9031556517707531,0,0,12.785541534423828,12.785541534423828,1,1
1549,2,11.377767821711418,11.37776782171142,0.9411737058228163,0.9411737058228182,0,0,13.346298217773438,12.785541534423828,2,2
1549,3,10.14498634926036,10.14498634926036,0.9771662657754556,0.9771662657754578,0,0,13.383687973022461,12.785541534423828,3,3
1549,4,9.846875182835173,9.846875182835177,0.9876003656142298,0.9876003656142329,0,0,13.448128700256348,12.785541534423828,4,4
1549,8,8.519531816235483,8.52871537224862,1.01730430156117,1.0172767850805098,2,2,13.869389533996582,12.785541534423828,6,6
1549,16,7.692114771076015,7.9302069304335046,1.035016500869876,1.0342248950793667,5,6,14.26434326171875,12.785541534423828,11,10
1549,32,6.916960572850502,7.742536369581584,1.043746054639299,1.041971803116331,14,21,14.731671333312988,12.785541534423828,18,11
1549,64,5.56781463550291,7.6236313836367255,1.0390213621723685,1.0503275645287662,29,48,15.57060432434082,12.785541534423828,35,16
1549,128,3.3329608085559936,7.576721540309227,1.0085463793119396,1.0532816292396763,60,111,16.347898483276367,12.785541534423828,68,17
1550,1,9.236795253823885,9.236795253823864,0.9611186116845907,0.9611186116845924,0,0,9.308035850524902,9.308035850524902,1,1
1550,2,8.477194540650535,8.477194540650537,0.9758722879160711,0.975872287916072,0,0,9.784790992736816,9.308035850524902,2,2
1550,3,7.653333696959018,7.653333696959018,0.9878529425851373,0.9878529425851369,0,0,9.91771411895752,9.308035850524902,3,3
1550,4,7.292832875821283,7.29556559770221,0.9987026267462795,0.9987190427833549,1,1,10.586584091186523,9.308035850524902,3,3
1550,8,7.045344672882627,7.2091882791868125,1.0019972596548323,1.0042049830523785,2,3,11.802742958068848,9.308035850524902,6,5
1550,16,6.526422997316804,7.119498485907159,1.016934655386794,1.011936520784277,6,8,12.496031761169434,9.308035850524902,10,8
1550,32,5.095976932927959,6.9097280221006825,1.0238336677598165,1.0220202031620729,13,23,13.874807357788086,9.308035850524902,19,9
1550,64,3.644414385236716,6.615145612508909,1.0125046867844052,1.0340439317504189,31,54,14.734232902526855,9.308035850524902,33,10
1550,128,2.448577078845003,6.56696507941297,1.0045693586776043,1.0402348402509065,64,115,16.10250473022461,9.308035850524902,64,13
1551,1,10.484524927456773,10.484524927456773,0.937019166940266,0.9370191669402698,0,0,10.649566650390625,10.649566650390625,1,1
1551,2,8.2973118892117,8.2973118892117,0.9868426906495589,0.9868426906495598,0,0,10.96874713897705,10.649566650390625,2,2
1551,3,8.259604643459525,8.259604643459527,0.9876630108959579,0.9876630108959592,0,0,10.9764986038208,10.649566650390625,3,3
1551,4,7.963782845828097,7.9637828458280975,0.9948864018553614,0.994886401855362,0,0,11.33304214477539,10.649566650390625,4,4
1551,8,7.349119440600779,7.619355713751462,1.0095766154213803,1.0066753879952413,2,1,12.09166431427002,10.649566650390625,6,7
1551,16,6.669335468924344,7.373447549954099,1.0206342555783738,1.014446871594246,8,7,12.877074241638184,10.649566650390625,8,9
1551,32,5.4859128182363115,6.942742464750517,1.0166020309521755,1.030744547266166,15,23,13.766590118408203,10.649566650390625,17,9
1551,64,4.020576767640764,6.875892041167812,1.0123278692590425,1.03730939679266,31,52,15.01081371307373,10.649566650390625,33,12
1551,128,2.729635588491913,6.8681149429576145,1.0010977801119312,1.039182517260064,64,115,16.311756134033203,10.649566650390625,64,13
1552,1,3.1704229514936415,3.1704229514936424,0.9958718997932052,0.9958718997932068,0,0,3.1730029582977295,3.1730029582977295,1,1
1552,2,3.0066810507744455,3.0066810507744455,0.9937919800675972,0.9937919800675981,0,0,3.2020041942596436,3.1730029582977295,2,2
1552,3,2.4766453410904217,2.4772673096042213,0.9963878941376001,0.9965378062863985,1,1,3.2546024322509766,3.1730029582977295,2,2
1552,4,2.4389212306841785,2.445100293487357,0.996442012296591,0.9968864106318345,1,1,3.984779119491577,3.1730029582977295,3,3
1552,8,1.902063126881079,2.3421069528362786,0.997035342709715,0.9978270879684694,3,4,4.285394668579102,3.1730029582977295,5,4
1552,16,1.5728978219894285,2.318598616632989,0.9987451921726043,0.9987384394281141,9,10,4.645570755004883,3.1730029582977295,7,6
1552,32,1.1749854586388004,2.286824366156237,1.0000855595961333,0.9994977111203498,16,25,5.24751091003418,3.1730029582977295,16,7
1552,64,0.5672583243671462,2.1192667706636694,0.9992444804873326,1.001616253031324,28,56,5.813096046447754,3.1730029582977295,36,8
1552,128,0.1202540124509596,2.108813019116328,0.9993757131683505,1.0021594189582976,69,120,6.351055145263672,3.1730029582977295,59,8
1553,1,7.33060676269268,7.330606762692672,0.9787715716138204,0.9787715716138227,0,0,7.357920169830322,7.357920169830322,1,1
1553,2,5.820648623050076,5.820648623050077,1.0009817798868077,1.000981779886807,0,0,7.6609721183776855,7.357920169830322,2,2
1553,3,4.992555241491582,4.992555241491582,1.0104449830510913,1.0104449830510926,0,0,7.72506856918335,7.357920169830322,3,3
1553,4,4.901764299139553,4.901764299139552,1.011895330397807,1.0118953303978078,0,0,8.052640914916992,7.357920169830322,4,4
1553,8,4.596496422720265,4.739174816145415,1.015429814303396,1.014918248623928,1,1,8.762046813964844,7.357920169830322,7,7
1553,16,4.212999612250891,4.715928107011877,1.0202219629489142,1.0160513899240184,6,6,9.419301986694336,7.357920169830322,10,10
1553,32,3.530945368572651,4.690589516207281,1.0182764004565108,1.0175360669663929,12,20,10.110630989074707,7.357920169830322,20,12
1553,64,2.347098550174101,4.440805406723183,1.0038284728650697,1.024789095929265,27,53,10.9860200881958,7.357920169830322,37,11
1553,128,1.471672211550105,4.426830642944981,1.0020597957926465,1.0262244840050774,58,116,11.981730461120605,7.357920169830322,70,12
1554,1,6.974280885554246,6.974280885554247,0.976358556011864,0.9763585560118652,0,0,7.0103864669799805,7.0103864669799805,1,1
1554,2,5.431065737217536,5.431065737217535,0.9962562424592528,0.9962562424592543,0,0,7.318573951721191,7.0103864669799805,2,2
1554,3,4.89251193887836,4.892511938878361,1.004932387204196,1.0049323872041964,0,0,7.78066873550415,7.0103864669799805,3,3
1554,4,4.878563195970568,4.878563195970572,1.0055914093869602,1.0055914093869611,0,0,7.804676532745361,7.0103864669799805,4,4
1554,8,4.157560275642954,4.203959833676123,1.0145920007040266,1.0151196291010611,2,2,8.06743335723877,7.0103864669799805,6,6
1554,16,3.8923243375770604,4.111404013169552,1.015386967261442,1.0164815331466306,7,8,8.353589057922363,7.0103864669799805,9,8
1554,32,3.057704328737135,4.035185709197865,1.0146210719240383,1.0181037180339851,14,22,8.853958129882812,7.0103864669799805,18,10
1554,64,2.0699052051241345,3.889747556146069,1.0080127415128872,1.0218168689251308,30,49,9.499628067016602,7.0103864669799805,34,15
1554,128,1.0745128598366793,3.884119421191907,1.001010322003862,1.0224058283979747,57,108,10.26442813873291,7.0103864669799805,71,20
1555,1,9.356254804912334,9.356254804912336,0.9526213110787369,0.9526213110787387,0,0,9.460898399353027,9.460898399353027,1,1
1555,2,8.397880252035874,8.397880252035874,0.9773478956442208,0.9773478956442211,0,0,10.372958183288574,9.460898399353027,2,2
1555,3,8.308952496302213,8.308952496302215,0.9799296802188272,0.9799296802188284,0,0,10.75286865234375,9.460898399353027,3,3
1555,4,8.010535570060268,8.010535570060268,0.9846642429544112,0.9846642429544123,0,0,10.972190856933594,9.460898399353027,4,4
1555,8,7.740999228916955,7.758334339737889,0.992251889665674,0.9932149216749586,2,2,11.319153785705566,9.460898399353027,6,6
1555,16,7.412462838435739,7.696229431954974,0.9956990009318486,0.9975724227179907,5,8,11.940520286560059,9.460898399353027,11,8
1555,32,5.563203869150885,7.317637066428545,1.011054189009393,1.010860281127936,12,22,12.529361724853516,9.460898399353027,20,10
1555,64,4.115514166012991,6.772478973159403,1.0145598988550177,1.029418335139248,33,54,12.997854232788086,9.460898399353027,31,10
1555,128,2.488094675571612,6.355797489134919,1.0038915965993256,1.0404311628697807,60,117,13.713733673095703,9.460898399353027,68,11
1556,1,9.693627061536876,9.693627061536876,0.9462023424119871,0.9462023424119893,0,0,9.823060989379883,9.823060989379883,1,1
1556,2,8.600587484321228,8.600587484321228,0.9766820454108036,0.9766820454108036,0,0,10.729028701782227,9.823060989379883,2,2
1556,3,7.309775237459975,7.309775237459976,1.0054397576816743,1.005439757681674,0,0,10.755033493041992,9.823060989379883,3,3
1556,4,6.976453392562679,6.976453392562677,1.0118843113560057,1.011884311356006,0,0,10.786409378051758,9.823060989379883,4,4
1556,8,6.799571079822212,6.865343516293419,1.0148845339076282,1.0144771909636094,1,1,10.974061012268066,9.823060989379883,7,7
1556,16,5.542139826858075,5.8421442024109576,1.0374770539795215,1.0349675872484152,3,8,11.863896369934082,9.823060989379883,13,8
1556,32,5.079539123174504,5.762942397403087,1.0410768716440113,1.038112073187847,12,21,12.77000617980957,9.823060989379883,20,11
1556,64,4.1853600389595345,5.705534298499041,1.0248357010957996,1.0430607402187702,27,49,13.690659523010254,9.823060989379883,37,15
1556,128,2.6822770659464124,5.614734495123628,1.0087218842574448,1.0502321990762398,65,112,14.567651748657227,9.823060989379883,63,16
1557,1,8.110346451358748,8.110346451358748,0.960264604091911,0.9602646040919135,0,0,8.198709487915039,8.198709487915039,1,1
1557,2,7.264456619819106,7.264456619819107,0.9776315295647673,0.977631529564768,0,0,9.193349838256836,8.198709487915039,2,2
1557,3,6.667738492844893,6.667738492844893,0.9881352239211678,0.9881352239211681,0,0,9.358431816101074,8.198709487915039,3,3
1557,4,6.337469760322288,6.337469760322288,0.9939015204291778,0.993901520429179,0,0,9.391203880310059,8.198709487915039,4,4
1557,8,5.510453530616984,5.527631419854891,1.0117815865268671,1.0113903636784363,1,1,9.797006607055664,8.198709487915039,7,7
1557,16,4.83224023848817,5.28401576283964,1.0147711435147304,1.015893711258626,7,6,10.111247062683105,8.198709487915039,9,10
1557,32,3.9777290025001584,5.232295162365323,1.014180259680787,1.0175934954597043,16,20,10.754129409790039,8.198709487915039,16,12
1557,64,2.821388723979514,5.219899220665375,1.0066388392717807,1.019020433688487,32,49,11.56531047821045,8.198709487915039,32,15
1557,128,1.6244878663584466,5.189955232232701,0.9987732384333455,1.022124135257663,62,115,12.415706634521484,8.198709487915039,66,13
1558,1,8.851607182606621,8.851607182606624,0.9566230036694054,0.9566230036694073,0,0,8.94450569152832,8.94450569152832,1,1
1558,2,7.756134130054809,7.75613413005481,0.9806543903082968,0.9806543903082978,0,0,9.533710479736328,8.94450569152832,2,2
1558,3,6.852785213292792,6.852785213292791,0.9982359120893317,0.998235912089332,0,0,9.8549165725708,8.94450569152832,3,3
1558,4,6.437059600705437,6.437059600705438,1.0071320029088795,1.0071320029088808,0,0,10.44991683959961,8.94450569152832,4,4
1558,8,5.820587638006905,5.830053627469361,1.0188228553848027,1.0188899761854757,2,2,11.151168823242188,8.94450569152832,6,6
1558,16,5.6778981482689606,5.787686394492601,1.0203642035763556,1.0194486072630413,7,9,11.611529350280762,8.94450569152832,9,7
1558,32,4.8635157384269565,5.757544902601029,1.0095303640478275,1.0212954157802534,17,21,12.204330444335938,8.94450569152832,15,11
1558,64,3.5659988683356,5.699340309966196,1.0049971613147286,1.0263077040187405,33,49,12.668338775634766,8.94450569152832,31,15
1558,128,1.9013861400539176,5.662033389410387,1.0006288492471909,1.0275316738313678,63,111,13.300273895263672,8.94450569152832,65,17
1559,1,3.0928941377990586,3.0928941377990538,0.9937444191754937,0.9937444191754956,0,0,3.098958969116211,3.098958969116211,1,1
1559,2,2.836202287062093,2.8362022870620924,0.9950800486135767,0.9950800486135765,0,0,3.489654541015625,3.098958969116211,2,2
1559,3,2.6881353198427753,2.688135319842775,0.997494852938565,0.9974948529385637,0,0,3.5332727432250977,3.098958969116211,3,3
1559,4,2.6305176006188598,2.6305176006188593,0.9980489326930186,0.9980489326930178,0,0,3.610996961593628,3.098958969116211,4,4
1559,8,2.3768317482517745,2.4486468530082126,0.9994107608485275,0.9994367152859733,3,4,3.9010159969329834,3.098958969116211,5,4
1559,16,1.9173713892560602,2.142707344297307,1.0019496307240257,1.0011064582456048,4,8,4.240070343017578,3.098958969116211,12,8
1559,32,1.3993548570802476,1.9996574630373842,1.0038068067347952,1.0031342274816315,16,24,4.653280735015869,3.098958969116211,16,8
1559,64,0.7844051786147214,1.9802758481137062,1.0008412044625512,1.0035619723334273,29,51,5.152665138244629,3.098958969116211,35,13
1559,128,0.07163640969080157,1.9789810408899486,0.9997428165176112,1.003579096198713,61,115,5.720104694366455,3.098958969116211,67,13
1560,1,8.284464242484642,8.284464242484642,0.9636035340067568,0.9636035340067582,0,0,8.35455322265625,8.35455322265625,1,1
1560,2,7.025862035400839,7.025862035400841,0.9853639935114381,0.98536399351144,0,0,9.039650917053223,8.35455322265625,2,2
1560,3,6.859928701304759,6.859928701304759,0.991095911644924,0.9910959116449257,0,0,9.294878005981445,8.35455322265625,3,3
1560,4,6.615136000972943,6.615136000972943,0.995137111207589,0.9951371112075912,0,0,9.317710876464844,8.35455322265625,4,4
1560,8,5.753108025108301,5.76098687027524,1.0131817121940583,1.0128361996986368,1,1,9.87629222869873,8.35455322265625,7,7
1560,16,5.659625075416638,5.7228844738925,1.0143472757758372,1.0148637522257227,5,6,10.711555480957031,8.35455322265625,11,10
1560,32,4.764434723162485,5.608100422520491,1.0117051209813808,1.0207875474036856,12,20,11.20173454284668,8.35455322265625,20,12
1560,64,3.8248348823052587,5.41657722720766,1.0134122587080856,1.0311234712548503,29,47,11.948354721069336,8.35455322265625,35,17
1560,128,2.4892409430613456,5.410999683430712,1.0057874968905813,1.03211647387809,67,108,12.667278289794922,8.35455322265625,61,20
1561,1,10.252455775449285,10.252455775449288,0.9411964823386035,0.9411964823386048,0,0,10.40092658996582,10.40092658996582,1,1
1561,2,9.117414767757506,9.117414767757506,0.9650843477074131,0.9650843477074131,0,0,10.41156005859375,10.40092658996582,2,2
1561,3,7.735549821665374,7.735549821665373,0.9964797569458455,0.9964797569458449,0,0,10.654518127441406,10.40092658996582,3,3
1561,4,7.670722722398761,7.670722722398762,0.9976346231500564,0.9976346231500558,0,0,10.691697120666504,10.40092658996582,4,4
1561,8,6.935347684508764,7.033639351378889,1.0119066449763585,1.010655100580976,2,2,11.039306640625,10.40092658996582,6,6
1561,16,6.486274861154375,6.749376669889135,1.0191297543386044,1.017129330288526,5,8,11.882342338562012,10.40092658996582,11,8
1561,32,5.504183003997633,6.618029670366844,1.0237344286418097,1.023397843911865,15,22,12.39820384979248,10.40092658996582,17,10
1561,64,4.163502757905283,6.4378012554828885,1.0201331407760477,1.02991013062629,29,47,13.005948066711426,10.40092658996582,35,17
1561,128,2.409623086034111,6.328885093621454,1.002823091459686,1.0366849849822537,57,110,13.836095809936523,10.40092658996582,71,18
1562,1,7.517795871266838,7.517795871266838,0.9624412253945914,0.9624412253945941,0,0,7.598149299621582,7.598149299621582,1,1
1562,2,7.167285914087782,7.167285914087782,0.9727196647699596,0.972719664769961,0,0,9.036726951599121,7.598149299621582,2,2
1562,3,6.158121056969688,6.158121056969688,0.9946239232642142,0.9946239232642157,0,0,9.599099159240723,7.598149299621582,3,3
1562,4,6.11373484769975,6.158121056969688,0.9943420522029242,0.9946239232642157,1,1,9.841533660888672,7.598149299621582,3,3
1562,8,5.8630819789124855,6.056104666618331,1.001458323450298,0.9997322421821475,2,2,10.396161079406738,7.598149299621582,6,6
1562,16,5.475167713514262,5.9112067300726805,1.0084379255327982,1.005535744812621,6,7,10.753006935119629,7.598149299621582,10,9
1562,32,4.662386375300227,5.806325975137948,1.0087541914694795,1.0084561590233057,13,23,11.359764099121094,7.598149299621582,19,9
1562,64,3.7088755845990464,5.638145150469246,1.0126586000916278,1.0146567428195743,30,56,12.127582550048828,7.598149299621582,34,8
1562,128,2.212222017621111,5.571054601944934,1.0019971398356158,1.0192023028722472,65,116,13.24157428741455,7.598149299621582,63,12
1563,1,8.849881544282706,8.849881544282704,0.9595477640298163,0.9595477640298204,0,0,8.93372917175293,8.93372917175293,1,1
1563,2,7.445500199846941,7.445500199846941,0.9843881005034607,0.9843881005034609,0,0,9.51915168762207,8.93372917175293,2,2
1563,3,6.850731603466594,6.850731603466595,0.9953659826601444,0.9953659826601438,0,0,9.541284561157227,8.93372917175293,3,3
1563,4,6.50511898774155,6.50511898774155,1.0039783073657689,1.0039783073657693,0,0,9.712665557861328,8.93372917175293,4,4
1563,8,6.414603946890758,6.414603946890758,1.0089750984673376,1.0089750984673367,0,0,10.918169975280762,8.93372917175293,8,8
1563,16,5.595013413774516,6.33514726452946,1.0097210499390035,1.011939086466904,6,7,12.270920753479004,8.93372917175293,10,9
1563,32,5.167215800059566,6.174521458070615,1.0111388229781035,1.0225043452999998,15,19,12.90147876739502,8.93372917175293,17,13
1563,64,4.004031476573151,6.033138928275916,1.0097779531026119,1.0286768040976062,33,51,13.762909889221191,8.93372917175293,31,13
1563,128,2.359278860404126,5.943721070622123,1.0000987100122876,1.0342536816091816,62,114,14.67470932006836,8.93372917175293,66,14
1564,1,4.86569360183139,4.865693601831372,0.981039653887526,0.9810396538875279,0,0,4.900813579559326,4.900813579559326,1,1
1564,2,4.471516764786421,4.471516764786423,0.9868246966067625,0.986824696606764,0,0,5.242389678955078,4.900813579559326,2,2
1564,3,4.220569251619451,4.220569251619452,0.9899369503064199,0.9899369503064204,0,0,5.348027229309082,4.900813579559326,3,3
1564,4,4.185558608309189,4.185558608309188,0.9906613676593141,0.990661367659314,0,0,5.672104835510254,4.900813579559326,4,4
1564,8,3.8660487980498823,3.9330721177786025,0.9957544987829825,0.9944429237280996,1,2,5.7852935791015625,4.900813579559326,7,6
1564,16,3.0003595067050672,3.379008603158004,1.0022269274605093,1.000363818406833,7,11,5.988420009613037,4.900813579559326,9,5
1564,32,2.2254589866681482,3.276659691043586,1.0024835713644817,1.0025246900956726,14,22,6.411707878112793,4.900813579559326,18,10
1564,64,1.6195491866106508,3.1629564147079337,0.9984523357526169,1.0050402759951054,30,53,6.950756549835205,4.900813579559326,34,11
1564,128,1.1125559903182838,3.135128103945582,0.9966965291982297,1.0061084869529533,61,119,7.611526012420654,4.900813579559326,67,9
1565,1,11.261847040061411,11.261847040061395,0.9212894405101304,0.921289440510132,0,0,11.502721786499023,11.502721786499023,1,1
1565,2,10.339731567261005,10.339731567261005,0.9483154045773584,0.9483154045773584,0,0,11.656967163085938,11.502721786499023,2,2
1565,3,9.610600103417658,9.610600103417658,0.9653206068025433,0.9653206068025424,0,0,11.79355525970459,11.502721786499023,3,3
1565,4,9.609359380875523,9.609359380875524,0.9654697025681714,0.965469702568171,0,0,11.840957641601562,11.502721786499023,4,4
1565,8,9.089819174363717,9.152287627589235,0.9806042939667965,0.9784721452930966,1,1,12.598508834838867,11.502721786499023,7,7
1565,16,8.401613848706873,9.03777798054342,0.9820004197011285,0.9828305167651152,6,7,13.352165222167969,11.502721786499023,10,9
1565,32,6.984177504911802,8.392208452929571,0.9992190634194622,1.0041704189495975,13,21,13.793135643005371,11.502721786499023,19,11
1565,64,5.482450540916598,8.189644550535208,1.0014770410364724,1.0149459971563501,30,47,14.443628311157227,11.502721786499023,34,17
1565,128,3.3271578304828577,7.891909609497371,1.0002260439809258,1.0300455956348102,65,107,15.17853832244873,11.502721786499023,63,21
1566,1,8.65836705935862,8.65836705935862,0.9441981009253237,0.9441981009253253,0,0,8.81814193725586,8.81814193725586,1,1
1566,2,7.20729759453565,7.20729759453565,0.9784735873449912,0.978473587344991,0,0,8.819162368774414,8.81814193725586,2,2
1566,3,7.012077293778982,7.012077293778983,0.9835407071905593,0.9835407071905592,0,0,9.473008155822754,8.81814193725586,3,3
1566,4,6.741269661715997,6.741269661715997,0.988129541465465,0.9881295414654645,0,0,9.848630905151367,8.81814193725586,4,4
1566,8,6.561856133076432,6.561856133076432,0.9969280472218905,0.9969280472218903,0,0,10.190386772155762,8.81814193725586,8,8
1566,16,5.564500965522144,5.851957558991183,1.015497822447129,1.0173457774933305,6,7,11.190752029418945,8.81814193725586,10,9
1566,32,4.619976320485222,5.690879825887402,1.0089825876651703,1.0222056554915788,16,22,11.885921478271484,8.81814193725586,16,10
1566,64,3.2590831616335665,5.3830725952349425,1.0085744614207288,1.0289935339644134,29,53,12.631465911865234,8.81814193725586,35,11
1566,128,2.128340542317167,5.366244949932991,1.0010981758237043,1.0291480661708394,58,115,13.511781692504883,8.81814193725586,70,13
1567,1,12.136311930541632,12.136311930541634,0.8990115979075164,0.8990115979075192,0,0,12.499573707580566,12.499573707580566,1,1
1567,2,10.593357470122221,10.593357470122221,0.9436448809993662,0.9436448809993679,0,0,12.558640480041504,12.499573707580566,2,2
1567,3,9.865204283551481,9.865204283551474,0.9650489232801363,0.9650489232801379,0,0,12.605631828308105,12.499573707580566,3,3
1567,4,9.700737305351417,9.700737305351417,0.9712370833646359,0.9712370833646372,0,0,12.694600105285645,12.499573707580566,4,4
1567,8,8.405197622879673,8.637875963037787,1.0033251227762592,0.9981278710686142,2,3,13.386674880981445,12.499573707580566,6,5
1567,16,7.983516010949603,8.19507684014858,1.0177277700307092,1.0160773071845073,4,8,14.103814125061035,12.499573707580566,12,8
1567,32,6.112311166200119,7.688521137597333,1.029098311044531,1.0379396468484203,15,20,15.346171379089355,12.499573707580566,17,12
1567,64,4.423708092660313,7.58856491683442,1.0154043843831988,1.0457434056590875,27,49,15.982950210571289,12.499573707580566,37,15
1567,128,3.061963243736038,7.5432284586663005,1.0101698174125946,1.0502679578858785,60,112,16.996665954589844,12.499573707580566,68,16
1568,1,9.655516273783547,9.655516273783551,0.9453643120350562,0.9453643120350605,0,0,9.79259204864502,9.79259204864502,1,1
1568,2,8.234433334950726,8.234433334950728,0.981132402114122,0.981132402114125,0,0,10.539505958557129,9.79259204864502,2,2
1568,3,7.589783656869672,7.589783656869672,0.9903436624675506,0.9903436624675515,0,0,10.57722282409668,9.79259204864502,3,3
1568,4,7.294610108970361,7.29461010897036,0.9985628381474677,0.9985628381474684,0,0,10.949065208435059,9.79259204864502,4,4
1568,8,7.096257292027677,7.118311253107709,1.0039658283346289,1.0036493113770004,1,1,11.321733474731445,9.79259204864502,7,7
1568,16,6.768570786196885,6.91179923850944,1.0095558225827443,1.0131936837764692,6,7,12.554656982421875,9.79259204864502,10,9
1568,32,6.129077982711566,6.6396363682934485,1.0155481108705646,1.0249816300908872,15,21,13.491628646850586,9.79259204864502,17,11
1568,64,5.0066900830062275,6.6353786109635955,1.0052034261685314,1.0256938185993552,32,51,14.271449089050293,9.79259204864502,32,13
1568,128,3.1646656954400294,6.615367780862933,0.9999732759557209,1.0297800970321678,64,112,15.081062316894531,9.79259204864502,64,16
1569,1,5.990763264395443,5.990763264395444,0.9754073357307964,0.9754073357307989,0,0,6.03627347946167,6.03627347946167,1,1
1569,2,5.150478557753157,5.150478557753157,0.9897597678452603,0.9897597678452621,0,0,6.454961776733398,6.03627347946167,2,2
1569,3,4.8368318301630175,4.8368318301630175,0.9941135171894663,0.9941135171894675,0,0,6.967721939086914,6.03627347946167,3,3
1569,4,4.818787477761055,4.8368318301630175,0.9935527562613388,0.9941135171894675,1,1,7.040286064147949,6.03627347946167,3,3
1569,8,4.238841856658162,4.266510952173016,1.003221456694399,1.003159012789894,2,2,7.740257263183594,6.03627347946167,6,6
1569,16,3.7191924535050145,4.083216648571984,1.0050979588276943,1.0060403664219915,6,7,8.301854133605957,6.03627347946167,10,9
1569,32,2.9718775105456174,3.7828481441319646,1.0095650727524998,1.0166180101544047,15,20,8.74496841430664,6.03627347946167,17,12
1569,64,2.1533431214694136,3.725330417519218,1.0036554410224277,1.017353879366238,30,51,9.200258255004883,6.03627347946167,34,13
1569,128,1.166709272238079,3.563505286007178,1.0013161054783009,1.021691365789259,61,110,9.81348705291748,6.03627347946167,67,18
1570,1,8.371756374283088,8.371756374283088,0.9625523330745946,0.9625523330745956,0,0,8.446815490722656,8.446815490722656,1,1
1570,2,6.926363848278783,6.926363848278783,0.9859241643429466,0.9859241643429475,0,0,8.455578804016113,8.446815490722656,2,2
1570,3,6.37741028739364,6.377410287393641,0.9947810056217823,0.9947810056217828,0,0,8.678240776062012,8.446815490722656,3,3
1570,4,6.2398087850425705,6.2398087850425705,0.9970711645548291,0.9970711645548291,0,0,9.218324661254883,8.446815490722656,4,4
1570,8,5.4570600365464665,5.460834942721199,1.0129618407153071,1.013779213473458,1,1,10.792452812194824,8.446815490722656,7,7
1570,16,5.055483249737006,5.3287235352462705,1.0174432741969135,1.0197578905615576,5,7,11.372367858886719,8.446815490722656,11,9
1570,32,4.396527900328255,5.302385796073679,1.0124456964111357,1.0218735864703394,15,18,11.739381790161133,8.446815490722656,17,14
1570,64,3.189896347200484,5.209461018041934,1.012532104491246,1.02681053505784,28,49,12.247556686401367,8.446815490722656,36,15
1570,128,1.918015557962509,5.199852517261363,1.0047484660334538,1.0281988366134238,59,112,13.114251136779785,8.446815490722656,69,16
1571,1,8.107664732252015,8.107664732252015,0.9573515730792379,0.9573515730792388,0,0,8.209124565124512,8.209124565124512,1,1
1571,2,6.453862148735144,6.453862148735144,0.9877658995888101,0.9877658995888108,0,0,8.216387748718262,8.209124565124512,2,2
1571,3,6.10015807480689,6.100158074806889,0.9946812236301219,0.9946812236301223,0,0,8.412262916564941,8.209124565124512,3,3
1571,4,5.826614994241995,5.826614994241995,0.9991344997048055,0.9991344997048066,0,0,8.482094764709473,8.209124565124512,4,4
1571,8,5.027013844285956,5.033918994595144,1.0111647880498449,1.0111950455031926,1,1,8.750041007995605,8.209124565124512,7,7
1571,16,4.629472383401368,4.927575727676409,1.0145670683711598,1.013591283724997,5,8,9.238737106323242,8.209124565124512,11,8
1571,32,4.015936980550247,4.6870538366191745,1.0194364594414909,1.0191450632291588,14,21,9.778124809265137,8.209124565124512,18,11
1571,64,2.4722367578606046,4.614988827295399,1.012377315024148,1.0212635401145136,29,51,10.360745429992676,8.209124565124512,35,13
1571,128,1.3197773974497182,4.594765184722871,1.0006791124763958,1.0239726175166468,61,111,11.042644500732422,8.209124565124512,67,17
1572,1,6.898751003919124,6.898751003919126,0.9737427773971339,0.9737427773971353,0,0,6.944689750671387,6.944689750671387,1,1
1572,2,6.25425942735407,6.254259427354066,0.9832334796396223,0.9832334796396234,0,0,7.359394550323486,6.944689750671387,2,2
1572,3,6.198100048655338,6.198100048655338,0.9850618476946289,0.985061847694629,0,0,7.936921119689941,6.944689750671387,3,3
1572,4,5.64139104754197,5.64139104754197,0.9967084991939017,0.9967084991939019,0,0,8.147584915161133,6.944689750671387,4,4
1572,8,5.049015000364222,5.07336140895885,1.0089571053933706,1.0086959322018698,1,1,8.769991874694824,6.944689750671387,7,7
1572,16,4.3582103954682045,4.659346280226196,1.019605593132603,1.0201136529250192,4,7,9.43032169342041,6.944689750671387,12,9
1572,32,3.9863610246527608,4.641690210832429,1.0160256198491515,1.0213144451816665,13,19,9.923151016235352,6.944689750671387,19,13
1572,64,2.9699627918748983,4.597295700390776,1.0078723235645168,1.022456852715615,30,49,10.49010944366455,6.944689750671387,34,15
1572,128,1.4827067508018978,4.582835428496353,0.9998279387905596,1.0251389251483491,57,109,11.223380088806152,6.944689750671387,71,19
1573,1,4.619110378347348,4.619110378347349,0.9861609093232182,0.986160909323219,0,0,4.638762950897217,4.638762950897217,1,1
1573,2,4.585524699640367,4.585524699640367,0.98668798064345,0.9866879806434508,0,0,4.911149024963379,4.638762950897217,2,2
1573,3,4.384170552597611,4.392349294924399,0.9879903513026022,0.9880613711477835,1,1,4.98792028427124,4.638762950897217,2,2
1573,4,4.146319657997546,4.233565912078006,0.991018976590115,0.9904408850783587,1,1,5.0223588943481445,4.638762950897217,3,3
1573,8,3.975584594709552,4.15069860932808,0.9925454583628692,0.9920604081504474,3,4,5.670890808105469,4.638762950897217,5,4
1573,16,3.4029102192521066,3.673714639686323,1.0016456998391865,1.0000225197452561,7,9,5.995994567871094,4.638762950897217,9,7
1573,32,2.956156712096081,3.6730563389673407,1.0000066470974245,1.000175320381403,14,24,6.452615261077881,4.638762950897217,18,8
1573,64,1.750079337539116,3.6308168834584174,0.9990202830376029,1.0027046723686404,29,52,6.9249067306518555,4.638762950897217,35,12
1573,128,0.7592267346339784,3.622067358566521,0.9975318443899965,1.0032290400203943,76,115,7.549895763397217,4.638762950897217,52,13
1574,1,10.679725262251939,10.679725262251937,0.9426283950228147,0.9426283950228171,0,0,10.817652702331543,10.817652702331543,1,1
1574,2,8.478938588844699,8.478938588844699,0.9889865432554006,0.9889865432554026,0,0,10.962411880493164,10.817652702331543,2,2
1574,3,7.74898846877623,7.748988468776229,1.003524909595383,1.0035249095953842,0,0,11.474665641784668,10.817652702331543,3,3
1574,4,7.313644137050666,7.313644137050666,1.0152977519958966,1.0152977519958961,0,0,11.616515159606934,10.817652702331543,4,4
1574,8,6.903999750395085,6.9039997503950845,1.0261751314039587,1.026175131403959,0,0,11.949055671691895,10.817652702331543,8,8
1574,16,6.385610662504931,6.464021566741568,1.0382749656405807,1.037957540579508,3,4,12.57866096496582,10.817652702331543,13,12
1574,32,5.955722881990818,6.412770865923134,1.0399488314971752,1.0402913540603618,10,18,13.38742733001709,10.817652702331543,22,14
1574,64,4.509100072503228,6.364571436953891,1.0246289254691945,1.0434385174418377,26,48,14.288771629333496,10.817652702331543,38,16
1574,128,2.5086158522438735,6.27843629995958,1.0038815951427624,1.0482337467820808,59,113,15.147817611694336,10.817652702331543,69,15
1575,1,8.425757252686704,8.425757252686703,0.9604519752475446,0.9604519752475469,0,0,8.510552406311035,8.510552406311035,1,1
1575,2,7.048331934689056,7.048331934689057,0.9856385648482551,0.9856385648482557,0,0,8.605973243713379,8.510552406311035,2,2
1575,3,6.656599039489733,6.656599039489735,0.9919556252961264,0.9919556252961277,0,0,8.714323997497559,8.510552406311035,3,3
1575,4,6.54739856913114,6.547398569131142,0.9935570288062885,0.9935570288062889,0,0,8.82130241394043,8.510552406311035,4,4
1575,8,5.991255756874325,6.02404042223123,1.0023398445732703,1.00238451922677,1,1,9.146282196044922,8.510552406311035,7,7
1575,16,5.542919242700849,5.721398661133632,1.0083590526409174,1.0085202967979878,7,9,9.661805152893066,8.510552406311035,9,7
1575,32,4.303844521391098,5.3510916381471905,1.0168741310909142,1.0197513730628798,12,22,10.329022407531738,8.510552406311035,20,10
1575,64,2.4886674624809135,5.31763929630494,1.0063424034739077,1.0221470306872265,29,52,11.111357688903809,8.510552406311035,35,12
1575,128,1.156219987877521,5.309182730455093,0.9992195346594552,1.0228690741871282,62,116,11.927305221557617,8.510552406311035,66,12
1576,1,8.697234939020289,8.69723493902029,0.956622576997532,0.9566225769975336,0,0,8.793693542480469,8.793693542480469,1,1
1576,2,7.374776176375647,7.374776176375647,0.9867710932765084,0.9867710932765087,0,0,10.469793319702148,8.793693542480469,2,2
1576,3,6.395246032752611,6.39524603275261,1.00756400733271,1.0075640073327112,0,0,10.714472770690918,8.793693542480469,3,3
1576,4,6.371421696675759,6.371421696675759,1.0087712075382607,1.0087712075382618,0,0,10.785207748413086,8.793693542480469,4,4
1576,8,5.56987240180987,5.569872401809869,1.028041301891782,1.028041301891782,0,0,11.549099922180176,8.793693542480469,8,8
1576,16,5.225395441706896,5.411591742075149,1.0316354918202362,1.031709035807736,3,5,12.223088264465332,8.793693542480469,13,11
1576,32,4.498195479950264,5.226583568286856,1.026825691883806,1.0386066187066954,11,15,12.708256721496582,8.793693542480469,21,17
1576,64,3.678828800923408,5.060429086349465,1.0261963278548984,1.0427564094751947,27,44,13.079148292541504,8.793693542480469,37,20
1576,128,2.6474083135261797,5.055296039681325,1.0108329038201118,1.0433586024760422,68,106,13.541533470153809,8.793693542480469,60,22
1577,1,10.952918770913017,10.95291877091302,0.9184611106137612,0.9184611106137635,0,0,11.217164993286133,11.217164993286133,1,1
1577,2,9.615144868106569,9.615144868106569,0.9509701893405349,0.9509701893405356,0,0,11.2777681350708,11.217164993286133,2,2
1577,3,8.27170074547968,8.271700745479682,0.9795930279027498,0.9795930279027517,0,0,11.286298751831055,11.217164993286133,3,3
1577,4,8.26897536760234,8.26897536760234,0.9795261728676992,0.9795261728676985,0,0,11.335943222045898,11.217164993286133,4,4
1577,8,7.4212358224634905,7.534795585306627,0.9969823360120116,0.993952718627876,2,2,11.60183048248291,11.217164993286133,6,6
1577,16,7.056428754651463,7.338978481577662,1.0060276753390818,0.9998234718776223,4,5,12.325763702392578,11.217164993286133,12,11
1577,32,5.951824539023196,6.9579655181100035,1.0234974813723146,1.0164083906880657,11,17,12.86142635345459,11.217164993286133,21,15
1577,64,4.728418842621894,6.644150906512734,1.024875934742976,1.02957390583467,28,49,13.410176277160645,11.217164993286133,36,15
1577,128,3.345275062099072,6.46211303797746,1.0109001793148717,1.0368140684475735,68,108,14.160837173461914,11.217164993286133,60,20
1578,1,7.471890862610671,7.471890862610673,0.9607379124799452,0.9607379124799472,0,0,7.566878318786621,7.566878318786621,1,1
1578,2,6.060972100699169,6.060972100699169,0.9870608863029509,0.987060886302952,0,0,8.337554931640625,7.566878318786621,2,2
1578,3,5.766868775825258,5.766868775825258,0.9947331223309954,0.9947331223309961,0,0,8.925481796264648,7.566878318786621,3,3
1578,4,5.711056404889545,5.711056404889546,0.9964501267579433,0.9964501267579446,0,0,8.994003295898438,7.566878318786621,4,4
1578,8,5.322846880591262,5.335875678179101,1.0030487545386606,1.0030726973053212,2,3,9.458361625671387,7.566878318786621,6,5
1578,16,4.6248182008509815,5.240130766845882,1.0073088174608864,1.0061864778559455,5,7,10.293866157531738,7.566878318786621,11,9
1578,32,3.7293965822936674,5.073682318265334,1.018177053616062,1.0135437431825265,14,21,10.979080200195312,7.566878318786621,18,11
1578,64,2.999960784731358,4.859904516205896,1.0067326881974406,1.020706587292753,30,49,11.678380966186523,7.566878318786621,34,15
1578,128,1.6219025082964924,4.791712785647849,1.000856192782483,1.022647673095069,55,116,12.472331047058105,7.566878318786621,73,12
1579,1,7.4809553941675695,7.4809553941675695,0.9564314509685389,0.9564314509685425,0,0,7.593095779418945,7.593095779418945,1,1
1579,2,6.473335224695488,6.4733352246954885,0.9806034044954468,0.9806034044954488,0,0,8.839646339416504,7.593095779418945,2,2
1579,3,5.8540182952580455,5.854018295258045,0.9899880223046993,0.9899880223047002,0,0,8.844714164733887,7.593095779418945,3,3
1579,4,5.768537359399192,5.8540182952580455,0.9892602611356939,0.9899880223047002,1,1,8.993553161621094,7.593095779418945,3,3
1579,8,4.749613230111671,4.775759812515876,1.0105678038390724,1.0116866813698784,2,2,9.643503189086914,7.593095779418945,6,6
1579,16,4.383627526462772,4.588275169052113,1.0182837673048217,1.0193564631596914,3,4,10.1266450881958,7.593095779418945,13,12
1579,32,3.9469984412385455,4.523400777934708,1.0193542581018349,1.0223090593526127,13,19,10.97696590423584,7.593095779418945,19,13
1579,64,2.890356002026244,4.357199223911185,1.0105447583305185,1.0281299541982738,30,51,11.732454299926758,7.593095779418945,34,13
1579,128,1.9032812720580303,4.353454339903726,1.0036683517828306,1.02889332529573,68,114,12.476414680480957,7.593095779418945,60,14
1580,1,12.153864052972047,12.153864052972041,0.9151631126790183,0.9151631126790205,0,0,12.400458335876465,12.400458335876465,1,1
1580,2,10.549813629066195,10.549813629066197,0.9609829721276102,0.9609829721276126,0,0,12.630254745483398,12.400458335876465,2,2
1580,3,8.743608798622436,8.743608798622436,1.0016758962203647,1.0016758962203678,0,0,12.65921688079834,12.400458335876465,3,3
1580,4,8.671977849936113,8.671977849936113,1.0044137662854526,1.004413766285455,0,0,13.326725006103516,12.400458335876465,4,4
1580,8,8.435317614754338,8.496379118671191,1.0096548482971217,1.0089868878399513,3,3,13.660162925720215,12.400458335876465,5,5
1580,16,7.951665420498676,8.308181725576707,1.018550228994536,1.0156817430362184,7,9,14.157987594604492,12.400458335876465,9,7
1580,32,7.072429414932405,8.022583434599973,1.0309259210067852,1.0293130132970278,13,19,14.545360565185547,12.400458335876465,19,13
1580,64,5.601640094741009,7.98020846827454,1.0252397222138734,1.0327270317737833,31,48,15.095012664794922,12.400458335876465,33,16
1580,128,3.1912720646556525,7.960021943200578,1.0092052282109376,1.03380679914166,62,112,15.587017059326172,12.400458335876465,66,16
1581,1,8.766273409213577,8.766273409213575,0.9477299747997474,0.9477299747997514,0,0,8.90472412109375,8.90472412109375,1,1
1581,2,7.2655765229063904,7.2655765229063904,0.9805849400404041,0.9805849400404063,0,0,9.669072151184082,8.90472412109375,2,2
1581,3,6.819075692552424,6.819075692552424,0.9907963060525664,0.9907963060525684,0,0,10.071399688720703,8.90472412109375,3,3
1581,4,6.79419571643106,6.79419571643106,0.9915026648388838,0.9915026648388853,0,0,10.294686317443848,8.90472412109375,4,4
1581,8,6.27463090153753,6.274630901537529,1.0036769974798523,1.0036769974798543,0,0,10.83760929107666,8.90472412109375,8,8
1581,16,5.532915478301617,5.728006907567854,1.0197681024111995,1.018787443363225,6,7,11.400388717651367,8.90472412109375,10,9
1581,32,4.496524333259865,5.5783723811861075,1.0206857507373683,1.0245746962929605,13,20,11.90149974822998,8.90472412109375,19,12
1581,64,3.281129396207884,5.388583564473911,1.0112680947859802,1.0306235774869654,29,52,12.615630149841309,8.90472412109375,35,12
1581,128,2.116341066992262,5.353473727743701,1.0004278201135617,1.0330072678521827,61,113,13.689815521240234,8.90472412109375,67,15
1582,1,3.428143964288722,3.428143964288721,0.9890661080937908,0.9890661080937926,0,0,3.444719076156616,3.444719076156616,1,1
1582,2,3.0131007256415305,3.013100725641531,0.992147422998181,0.9921474229981819,0,0,3.6465697288513184,3.444719076156616,2,2
1582,3,2.8189398075895116,2.818939807589512,0.9937319544026517,0.9937319544026535,0,0,3.7668404579162598,3.444719076156616,3,3
1582,4,2.818837742997176,2.8189398075895116,0.9937251582771819,0.9937319544026535,1,1,3.8492441177368164,3.444719076156616,3,3
1582,8,2.5480545823795464,2.603567706190843,0.9955796732596311,0.9952890874124734,2,3,3.928060293197632,3.444719076156616,6,5
1582,16,2.2089455238533136,2.389678224852903,0.9973296822166925,0.9966999636551361,6,8,4.095814228057861,3.444719076156616,10,8
1582,32,1.6187285084457992,2.2446964046866635,1.0008694192056184,0.9984586610885322,12,20,4.236349105834961,3.444719076156616,20,12
1582,64,1.1244196140784748,2.0516144096502194,1.0006467566832462,1.0002311417629466,35,54,4.631603717803955,3.444719076156616,29,10
1582,128,0.23328337103500152,2.0008151117225412,0.9989949048940949,1.0008250430467283,61,115,5.120327949523926,3.444719076156616,67,13
1583,1,8.817822197358854,8.817822197358854,0.9483607163224501,0.9483607163224522,0,0,8.949666976928711,8.949666976928711,1,1
1583,2,7.661301842051901,7.6613018420519,0.9710297167959128,0.9710297167959153,0,0,9.007259368896484,8.949666976928711,2,2
1583,3,7.507419762715817,7.507419762715819,0.9764839874939741,0.9764839874939766,0,0,9.877153396606445,8.949666976928711,3,3
1583,4,6.725986998662904,6.725986998662904,0.9904144199425601,0.9904144199425611,0,0,10.054527282714844,8.949666976928711,4,4
1583,8,6.232242225237795,6.246297477132748,1.0053767359746693,1.0052603221555017,1,1,10.470070838928223,8.949666976928711,7,7
1583,16,5.59910329617556,5.8470167983218655,1.0124946173615685,1.015122427369142,5,5,11.024558067321777,8.949666976928711,11,11
1583,32,5.036956835432876,5.512420529529994,1.0204974399384519,1.0264303823773249,12,19,11.630853652954102,8.949666976928711,20,13
1583,64,3.5339931716657538,5.078083284153067,1.0187042231163448,1.0383332318477174,29,51,12.362875938415527,8.949666976928711,35,13
1583,128,2.499124558939412,5.050461688807093,1.0088652942856364,1.0408980310683449,60,113,13.320120811462402,8.949666976928711,68,15
1584,1,8.38904994065081,8.389049940650802,0.9585082274313461,0.9585082274313484,0,0,8.481646537780762,8.481646537780762,1,1
1584,2,7.70269154440779,7.7026915444077915,0.9731544057386728,0.9731544057386747,0,0,9.060717582702637,8.481646537780762,2,2
1584,3,6.799716155751113,6.799716155751114,0.990120000287074,0.9901200002870758,0,0,9.312657356262207,8.481646537780762,3,3
1584,4,6.799386710317638,6.799386710317637,0.9901990833275974,0.9901990833275992,0,0,9.390778541564941,8.481646537780762,4,4
1584,8,6.146000255067106,6.18250762611209,1.003432076522465,1.0033033522010575,2,3,9.525412559509277,8.481646537780762,6,5
1584,16,5.234444438685979,5.559935153711745,1.0147606538954044,1.0139121619650688,5,5,9.790420532226562,8.481646537780762,11,11
1584,32,4.934990895236489,5.458827899829526,1.0160431333671114,1.0160818419432922,10,17,10.157219886779785,8.481646537780762,22,15
1584,64,3.4235815030504173,5.1961924903993895,1.0195189929935522,1.025722305371594,32,49,10.608659744262695,8.481646537780762,32,15
1584,128,1.8896826695223439,5.182756028889363,1.0015276914312827,1.0267803870409242,64,109,11.369779586791992,8.481646537780762,64,19
1585,1,6.67315005110557,6.67315005110557,0.9716398614780959,0.9716398614780971,0,0,6.727213382720947,6.727213382720947,1,1
1585,2,5.626363811924397,5.626363811924397,0.9867835981695456,0.9867835981695467,0,0,6.989503860473633,6.727213382720947,2,2
1585,3,5.5307528622135385,5.5307528622135385,0.9878358634595492,0.9878358634595492,0,0,7.144797325134277,6.727213382720947,3,3
1585,4,4.757682727996266,4.757682727996267,0.9971902016780707,0.9971902016780699,0,0,7.410571575164795,6.727213382720947,4,4
1585,8,4.36785109863096,4.4055606723144916,1.0035883381796102,1.003781857056976,1,1,8.226410865783691,6.727213382720947,7,7
1585,16,3.5946320428349825,3.930180145621979,1.009959785235744,1.0131010751153906,4,5,9.250926971435547,6.727213382720947,12,11
1585,32,3.0952457294971176,3.831356105463401,1.0074701950074407,1.0167673580546492,14,21,10.543744087219238,6.727213382720947,18,11
1585,64,2.2321289103899833,3.8199564693070216,1.0031680144556274,1.0185083158162773,27,49,11.464725494384766,6.727213382720947,37,15
1585,128,1.2991011206487966,3.7983972649545112,0.9988922219597011,1.0197431596203166,69,116,12.19653606414795,6.727213382720947,59,12
1586,1,9.436594791591416,9.436594791591416,0.9601683297244242,0.9601683297244247,0,0,9.511636734008789,9.511636734008789,1,1
1586,2,7.745777722428935,7.745777722428935,0.9931371550180166,0.9931371550180164,0,0,9.854499816894531,9.511636734008789,2,2
1586,3,6.638455466715971,6.638455466715971,1.0106504495456188,1.0106504495456181,0,0,10.14601993560791,9.511636734008789,3,3
1586,4,6.380120717662994,6.380120717662995,1.0149133383589528,1.0149133383589524,0,0,10.284173011779785,9.511636734008789,4,4
1586,8,5.603478381268933,5.613468338206791,1.027735209219181,1.0277757146373325,3,3,10.935564994812012,9.511636734008789,5,5
1586,16,5.035994947898755,5.433664208439136,1.029718051824182,1.0312885370602036,6,7,11.768259048461914,9.511636734008789,10,9
1586,32,4.307089108874702,5.134261861558561,1.0311798791628104,1.0428760394530225,15,20,12.088643074035645,9.511636734008789,17,12
1586,64,3.2078113798474455,5.078276367219285,1.0163557125153273,1.0451547740414018,30,51,12.821295738220215,9.511636734008789,34,13
1586,128,1.8922319571741426,5.045599860252846,1.004257876234481,1.0468373024562163,59,112,13.480657577514648,9.511636734008789,69,16
1587,1,7.502201015722504,7.5022010157225045,0.9554193093687455,0.9554193093687465,0,0,7.6184916496276855,7.6184916496276855,1,1
1587,2,6.609506636327828,6.609506636327829,0.9734772386389289,0.9734772386389294,0,0,9.78227424621582,7.6184916496276855,2,2
1587,3,6.327573434586468,6.327573434586468,0.9833267274303399,0.9833267274303397,0,0,10.00245475769043,7.6184916496276855,3,3
1587,4,6.136469997532588,6.136469997532588,0.9887259605917013,0.9887259605917016,0,0,10.09205150604248,7.6184916496276855,4,4
1587,8,5.796565384271841,5.796565384271841,0.996786143358574,0.9967861433585736,0,0,10.737071990966797,7.6184916496276855,8,8
1587,16,5.274321750401123,5.58771325509965,1.0035031138978037,1.0022359615316512,5,6,11.248252868652344,7.6184916496276855,11,10
1587,32,4.798110827544606,5.445649612236945,1.0054195243036625,1.0063228553186947,13,20,11.648846626281738,7.6184916496276855,19,12
1587,64,3.234910296055769,5.187700436440048,1.0035624559346312,1.0172583932893524,34,52,12.52746295928955,7.6184916496276855,30,12
1587,128,2.216758733194259,5.152616542253128,0.9970572879388576,1.020230257659994,66,112,13.042006492614746,7.6184916496276855,62,16
1588,1,14.237386040125557,14.237386040125559,0.8746433434108463,0.8746433434108497,0,0,14.70611572265625,14.70611572265625,1,1
1588,2,13.82436307778727,13.824363077787275,0.8951877190848587,0.8951877190848606,0,0,15.647002220153809,14.70611572265625,2,2
1588,3,13.715608502221437,13.71560850222144,0.9030931085679048,0.9030931085679066,0,0,16.371063232421875,14.70611572265625,3,3
1588,4,12.757889967207722,12.757889967207724,0.9492846373521744,0.949284637352176,0,0,16.609975814819336,14.70611572265625,4,4
1588,8,11.837276100720116,12.035213033028645,0.9804768205137244,0.9795140331330716,2,3,16.979162216186523,14.70611572265625,6,5
1588,16,11.132361590103582,11.39369798451691,1.008176937766829,1.0089583554273014,6,8,17.839937210083008,14.70611572265625,10,8
1588,32,10.431394963476677,11.263828809190095,0.9887785160961529,1.0162541029659111,18,23,18.446117401123047,14.70611572265625,14,9
1588,64,8.70059402529856,10.916647877019948,1.001723719852948,1.0403719721056004,27,56,19.07155418395996,14.70611572265625,37,8
1588,128,6.41485265214063,10.871710870217434,0.9922834672727808,1.04352032938908,65,116,19.75496482849121,14.70611572265625,63,12
1589,1,7.7987762611884035,7.798776261188406,0.9648702851836467,0.9648702851836489,0,0,7.869777202606201,7.869777202606201,1,1
1589,2,6.274285203788043,6.274285203788042,0.9901803899919807,0.9901803899919814,0,0,8.195616722106934,7.869777202606201,2,2
1589,3,5.66928325296228,5.6692832529622805,0.9976256519474034,0.9976256519474035,0,0,8.333106994628906,7.869777202606201,3,3
1589,4,5.359413146576153,5.359413146576153,1.0017677799517886,1.0017677799517886,0,0,8.489721298217773,7.869777202606201,4,4
1589,8,5.035841456237728,5.069225463938183,1.0093560032398343,1.010102948282492,2,2,9.293537139892578,7.869777202606201,6,6
1589,16,4.743395535542954,4.892593268018023,1.0140815400421679,1.0151338571704378,5,5,9.83340072631836,7.869777202606201,11,11
1589,32,4.222039459338475,4.7176047603119935,1.0175956801250818,1.021253806040627,13,17,10.351103782653809,7.869777202606201,19,15
1589,64,3.297179352907003,4.5531203180013184,1.015244361355435,1.0277223574800982,27,48,10.975571632385254,7.869777202606201,37,16
1589,128,1.817396708204364,4.535839521355044,1.0015458417700378,1.0299101477016395,67,107,11.545806884765625,7.869777202606201,61,21
1590,1,12.085862489696968,12.08586248969697,0.9339940942998934,0.9339940942998946,0,0,12.247061729431152,12.247061729431152,1,1
1590,2,11.4874211071359,11.4874211071359,0.9537245142416736,0.9537245142416743,0,0,12.74769115447998,12.247061729431152,2,2
1590,3,10.110525657787878,10.11052565778788,0.9904650642653927,0.9904650642653933,0,0,13.141648292541504,12.247061729431152,3,3
1590,4,8.922852588708158,8.922852588708157,1.019461780267545,1.0194617802675452,0,0,13.225147247314453,12.247061729431152,4,4
1590,8,7.891127266653772,7.89112726665377,1.0441097255149807,1.0441097255149816,0,0,13.619697570800781,12.247061729431152,8,8
1590,16,7.2549959407656255,7.402713220513205,1.053299316932999,1.0536933795387025,5,6,14.0355863571167,12.247061729431152,11,10
1590,32,6.462021259233947,7.064445854697937,1.0625650438772316,1.0657238999737233,13,16,14.524137496948242,12.247061729431152,19,16
1590,64,5.422449213062463,7.012351989995259,1.0565232174618353,1.0694600235529594,28,46,14.999689102172852,12.247061729431152,36,18
1590,128,3.627829371548244,7.010706246052851,1.0283385550993978,1.069903616255663,60,108,15.591839790344238,12.247061729431152,68,20
1591,1,10.518729163824005,10.518729163824007,0.9253167984043345,0.925316798404338,0,0,10.754558563232422,10.754558563232422,1,1
1591,2,9.140939214902291,9.140939214902293,0.9662621925242652,0.9662621925242674,0,0,11.997394561767578,10.754558563232422,2,2
1591,3,9.067733990295102,9.067733990295102,0.9713075438180303,0.9713075438180322,0,0,12.492568969726562,10.754558563232422,3,3
1591,4,8.654283686786268,8.654283686786265,0.9813671148953793,0.9813671148953811,0,0,12.530254364013672,10.754558563232422,4,4
1591,8,8.159230127697334,8.171376304001067,0.9957618082471771,0.9962066208100242,1,1,12.78049087524414,10.754558563232422,7,7
1591,16,6.330384988362665,7.266543654902394,1.0256545444970233,1.0220596978467014,4,10,13.357259750366211,10.754558563232422,12,6
1591,32,5.551464427206019,7.2018082080752865,1.030654419967616,1.0244607982903067,10,25,13.632333755493164,10.754558563232422,22,7
1591,64,4.540917690484818,7.1832146906701695,1.0240170359978098,1.0258077901740443,33,51,14.164361000061035,10.754558563232422,31,13
1591,128,2.755183092538349,7.053213241482577,1.0068207773484952,1.030598411142989,63,117,14.72793197631836,10.754558563232422,65,11
1592,1,7.678621640462103,7.678621640462104,0.9685690262572552,0.9685690262572558,0,0,7.737173080444336,7.737173080444336,1,1
1592,2,7.048083462010633,7.048083462010635,0.9847364098161364,0.984736409816137,0,0,9.701003074645996,7.737173080444336,2,2
1592,3,6.681344871080969,6.68134487108097,0.9909818154459337,0.9909818154459337,0,0,9.817340850830078,7.737173080444336,3,3
1592,4,6.444628928752965,6.444628928752964,0.9978070010181712,0.9978070010181714,0,0,9.921533584594727,7.737173080444336,4,4
1592,8,6.211639193076998,6.253551518761769,1.0038213667865727,1.0028542644808327,2,2,10.325469017028809,7.737173080444336,6,6
1592,16,5.523759910447721,5.652700614013242,1.0149129628875722,1.0131950692390475,5,5,10.705170631408691,7.737173080444336,11,11
1592,32,4.992711173748429,5.4464847113524275,1.0124092125304456,1.0154103747533387,13,22,11.316231727600098,7.737173080444336,19,10
1592,64,4.048154792323564,5.321212844415565,1.0166232681469562,1.0223954528506574,32,53,11.713775634765625,7.737173080444336,32,11
1592,128,2.3400007766022606,5.254600294648548,1.0041806089227043,1.0281224361586159,63,113,11.978342056274414,7.737173080444336,65,15
1593,1,13.295225186128304,13.295225186128313,0.89110971638407,0.8911097163840728,0,0,13.658124923706055,13.658124923706055,1,1
1593,2,10.719912845189874,10.719912845189876,0.9654866400128586,0.9654866400128613,0,0,13.731884002685547,13.658124923706055,2,2
1593,3,10.438957890170132,10.438957890170135,0.9746493049142083,0.9746493049142112,0,0,14.53736686706543,13.658124923706055,3,3
1593,4,10.307556319875934,10.438957890170135,0.9759249796595519,0.9746493049142112,1,1,14.72477912902832,13.658124923706055,3,3
1593,8,9.553350976625914,9.794256765794348,1.0050278340446144,1.000603676823813,1,1,15.381125450134277,13.658124923706055,7,7
1593,16,8.69870005308277,9.450712366006654,1.0242962676398037,1.0190663345843054,5,5,16.267269134521484,13.658124923706055,11,11
1593,32,7.470937978658087,9.389094678289128,1.0028695850176834,1.0227537365209947,14,20,17.134523391723633,13.658124923706055,18,12
1593,64,5.327262441441526,9.380954069295456,1.0119239840987766,1.0250486415330249,32,51,17.91741180419922,13.658124923706055,32,13
1593,128,3.378866758435812,9.37319586737768,1.0088177707249817,1.0276636216206017,54,113,18.825660705566406,13.658124923706055,74,15
1594,1,7.8314141741642365,7.831414174164241,0.9642652400005483,0.9642652400005509,0,0,7.90455436706543,7.90455436706543,1,1
1594,2,5.925137508696674,5.925137508696676,0.9958680604771857,0.9958680604771885,0,0,7.993966579437256,7.90455436706543,2,2
1594,3,5.710083418984507,5.7100834189845076,0.9987307726690714,0.9987307726690733,0,0,8.068044662475586,7.90455436706543,3,3
1594,4,5.47441132263646,5.474411322636459,1.0037013540809954,1.0037013540809974,0,0,8.718644142150879,7.90455436706543,4,4
1594,8,4.361755847446972,4.361755847446969,1.0197614959002141,1.0197614959002153,0,0,9.404080390930176,7.90455436706543,8,8
1594,16,4.048643384099649,4.3615552300497065,1.0153096068681027,1.0198546390997265,6,7,10.055676460266113,7.90455436706543,10,9
1594,32,3.3995509052139936,4.34940271511879,1.0070027876157237,1.0207270852691481,14,22,10.807767868041992,7.90455436706543,18,10
1594,64,2.646129449210377,4.233124565466358,1.0069101203365358,1.025101533112843,30,52,11.489655494689941,7.90455436706543,34,12
1594,128,1.5380213511800593,4.206410725517771,1.0029403350076023,1.0268748821576863,57,115,12.22305965423584,7.90455436706543,71,13
1595,1,7.189220381472762,7.189220381472763,0.9619096347539838,0.9619096347539849,0,0,7.284801006317139,7.284801006317139,1,1
1595,2,6.937851398449187,6.937851398449187,0.9651575698783083,0.9651575698783087,0,0,7.290074348449707,7.284801006317139,2,2
1595,3,6.92872292467408,6.928722924674081,0.9654794669962734,0.9654794669962741,0,0,7.6414289474487305,7.284801006317139,3,3
1595,4,6.849281427964593,6.8545837164782295,0.9674465530334015,0.9673760207463596,1,1,7.716838836669922,7.284801006317139,3,3
1595,8,6.750801232978775,6.8059651713436065,0.970442167272697,0.968973482723005,2,4,7.893416881561279,7.284801006317139,6,4
1595,16,5.742872158531461,5.88890792042351,0.9934270900748958,0.9919506587618695,7,10,8.12818431854248,7.284801006317139,9,6
1595,32,4.934692856263226,5.516487696333251,0.9974184720224047,0.998898813719194,12,25,8.694045066833496,7.284801006317139,20,7
1595,64,4.1102899293687845,5.308382162419072,0.9995645481704036,1.0046855237739254,27,57,9.048239707946777,7.284801006317139,37,7
1595,128,2.9715798340621533,4.8958901391096115,0.9986036517565684,1.0143587460179133,69,118,9.602869987487793,7.284801006317139,59,10
1596,1,11.35657021921017,11.356570219210175,0.9242871418854232,0.924287141885426,0,0,11.575404167175293,11.575404167175293,1,1
1596,2,10.734893997085928,10.734893997085932,0.9402790866709694,0.9402790866709716,0,0,11.849608421325684,11.575404167175293,2,2
1596,3,9.733670605405718,9.733670605405718,0.9629684032125567,0.9629684032125572,0,0,11.885077476501465,11.575404167175293,3,3
1596,4,8.67763544511014,8.67763544511014,0.9893164457362801,0.9893164457362813,0,0,11.942636489868164,11.575404167175293,4,4
1596,8,7.942505983521741,8.104066754657008,1.0058030799904367,1.0020431244365113,2,2,12.3455810546875,11.575404167175293,6,6
1596,16,7.38791827641415,7.802880696796925,1.0173798716312439,1.009592458901545,5,9,12.903162002563477,11.575404167175293,11,7
1596,32,6.075308354315129,7.63601510881505,1.0204156879345647,1.013957995293477,14,21,13.649190902709961,11.575404167175293,18,11
1596,64,4.7849968688258055,7.512765603159236,1.0064726682330303,1.019761535549625,34,51,14.282553672790527,11.575404167175293,30,13
1596,128,3.2979298498620784,6.994071120803935,1.0060084630439459,1.04260356007038,70,114,15.145705223083496,11.575404167175293,58,14
1597,1,7.576755532604013,7.576755532604014,0.9690243153390145,0.9690243153390168,0,0,7.632693767547607,7.632693767547607,1,1
1597,2,6.717401425077133,6.717401425077133,0.9905831210554292,0.9905831210554303,0,0,9.290846824645996,7.632693767547607,2,2
1597,3,6.178868905457799,6.178868905457798,1.0002847560944526,1.0002847560944534,0,0,9.844569206237793,7.632693767547607,3,3
1597,4,6.16508241455047,6.178868905457798,0.9994974915963241,1.0002847560944534,1,1,10.026864051818848,7.632693767547607,3,3
1597,8,5.889028658734974,5.892532279148777,1.0102679308728906,1.0109236647139819,1,1,10.730090141296387,7.632693767547607,7,7
1597,16,5.313616063615624,5.774243944295645,1.0113685618652601,1.0150660966943197,6,9,11.495285987854004,7.632693767547607,10,7
1597,32,4.098558185016555,5.612801924991768,1.0177550211641355,1.022194864968865,15,23,12.28947925567627,7.632693767547607,17,9
1597,64,3.2658541932957545,5.551822015169588,1.0033232205003473,1.0251118457761295,31,54,13.055572509765625,7.632693767547607,33,10
1597,128,2.2283479213767796,5.389260406971899,1.0003955258591803,1.0325503694164566,72,116,13.78389835357666,7.632693767547607,56,12
1598,1,9.56030265386571,9.56030265386571,0.9568311122511458,0.9568311122511474,0,0,9.648911476135254,9.648911476135254,1,1
1598,2,8.417041968249709,8.417041968249709,0.9816722618308644,0.9816722618308653,0,0,9.698725700378418,9.648911476135254,2,2
1598,3,7.591008922617041,7.591008922617042,0.9971359656938679,0.9971359656938681,0,0,9.830975532531738,9.648911476135254,3,3
1598,4,7.439032258013586,7.439032258013587,1.0015511110057511,1.0015511110057516,0,0,10.123015403747559,9.648911476135254,4,4
1598,8,6.502732939135465,6.722894861485917,1.0196441644923615,1.0173685097763838,2,2,10.548917770385742,9.648911476135254,6,6
1598,16,5.940513236629863,6.407375295366649,1.0305733010142049,1.026107564049426,5,7,11.081815719604492,9.648911476135254,11,9
1598,32,5.4615964894511615,6.038787950760351,1.0331358280985627,1.0352469440855208,16,22,11.587986946105957,9.648911476135254,16,10
1598,64,4.180279005646405,5.865421170084018,1.0302424456850052,1.0397018909432831,29,47,12.129446983337402,9.648911476135254,35,17
1598,128,2.3156183532842256,5.601976948389564,1.0141580935657746,1.0526829503843247,60,107,12.628705978393555,9.648911476135254,68,21
1599,1,3.870096929186359,3.870096929186359,0.9920289009185801,0.9920289009185819,0,0,3.8779196739196777,3.8779196739196777,1,1
1599,2,3.361377975391485,3.361377975391484,0.9971167603935658,0.9971167603935669,0,0,4.144230365753174,3.8779196739196777,2,2
1599,3,3.3129179853376614,3.3129179853376622,0.9970517782828938,0.9970517782828946,0,0,4.181528091430664,3.8779196739196777,3,3
1599,4,3.264422263880144,3.264422263880144,0.9976183827329062,0.9976183827329067,0,0,4.182003021240234,3.8779196739196777,4,4
1599,8,3.067401316349328,3.0704974267042386,0.9998588885255162,0.999722952797363,2,1,4.586945533752441,3.8779196739196777,6,7
1599,16,2.601078428350205,2.832928941830304,1.003035807499558,1.0015860159607832,5,6,4.710178852081299,3.8779196739196777,11,10
1599,32,1.9750499686401777,2.6307867473543407,1.0050380727894892,1.002228908028899,14,21,4.9223103523254395,3.8779196739196777,18,11
1599,64,0.7636768772067695,2.398042592819367,1.0004281289828838,1.0037906291150236,29,54,5.3147292137146,3.8779196739196777,35,10
1599,128,0.0944049691358019,2.2698475263756506,0.999685633692903,1.0067461176322956,68,117,5.849764347076416,3.8779196739196777,60,11
1600,1,9.365979910668456,9.365979910668454,0.9418553875813519,0.9418553875813559,0,0,9.52346134185791,9.52346134185791,1,1
1600,2,8.549049279497783,8.549049279497785,0.9657072197784445,0.9657072197784462,0,0,10.669121742248535,9.52346134185791,2,2
1600,3,8.545294173393351,8.545294173393348,0.9664330275727243,0.966433027572726,0,0,11.502849578857422,9.52346134185791,3,3
1600,4,8.247281046001692,8.272824268546472,0.9779106026906697,0.9783053593581402,1,1,11.90064525604248,9.52346134185791,3,3
1600,8,7.216274142151333,7.319136575341111,1.0085084940969842,1.007676892245121,2,3,13.293214797973633,9.52346134185791,6,5
1600,16,6.755828786926464,7.140564350535057,1.0242392297807779,1.0215335529481377,6,7,14.301763534545898,9.52346134185791,10,9
1600,32,5.563716476967985,7.023744930033092,1.0186296664574375,1.0314516458679788,15,21,15.467819213867188,9.52346134185791,17,11
1600,64,4.120437357372512,7.0065184667809275,1.009306119536166,1.033889403288411,31,52,16.588109970092773,9.52346134185791,33,12
1600,128,3.0140693730112504,7.0065184667809275,1.0039303707029608,1.033889403288411,67,116,17.514204025268555,9.52346134185791,61,12
1601,1,7.889168969663413,7.889168969663408,0.96679431306509,0.9667943130650923,0,0,7.950995922088623,7.950995922088623,1,1
1601,2,6.451298283346735,6.451298283346735,0.9956770967883007,0.9956770967883021,0,0,9.763102531433105,7.950995922088623,2,2
1601,3,6.09998291659789,6.099982916597892,1.0022681630479313,1.0022681630479324,0,0,9.955340385437012,7.950995922088623,3,3
1601,4,6.0281608666552415,6.028160866655241,1.005103537187173,1.0051035371871744,0,0,10.12465763092041,7.950995922088623,4,4
1601,8,5.920546265858644,5.967490403099068,1.0078712805855126,1.0081320347435396,3,3,11.186924934387207,7.950995922088623,5,5
1601,16,5.368800175739422,5.888045620638506,1.010096177541436,1.0124279894002326,8,10,11.66016960144043,7.950995922088623,8,6
1601,32,4.359808002593047,5.713238690734672,1.014640007628017,1.018980475401222,15,26,12.404937744140625,7.950995922088623,17,6
1601,64,3.252257010567297,5.616690139851291,1.0071913356118405,1.0274075349633351,28,55,13.418397903442383,7.950995922088623,36,9
1601,128,2.170526054935323,5.426912286189912,1.0048729299224928,1.0383981651481817,62,115,14.668628692626953,7.950995922088623,66,13
1602,1,9.636980408670006,9.636980408670006,0.9485578720687285,0.9485578720687295,0,0,9.76163387298584,9.76163387298584,1,1
1602,2,8.515850981617946,8.515850981617948,0.972689084199029,0.9726890841990301,0,0,10.305505752563477,9.76163387298584,2,2
1602,3,7.182169991707858,7.182169991707859,1.003997349963309,1.0039973499633092,0,0,10.642495155334473,9.76163387298584,3,3
1602,4,7.078932316166528,7.078932316166531,1.0072437772605536,1.0072437772605547,0,0,10.652844429016113,9.76163387298584,4,4
1602,8,6.304264515787835,6.308945035106651,1.0257012043215377,1.0256357950570612,1,1,10.987553596496582,9.76163387298584,7,7
1602,16,5.719927896398368,5.866152884225882,1.0354289352647896,1.0337857350742103,4,3,11.579930305480957,9.76163387298584,12,13
1602,32,5.254015180899231,5.525181050464332,1.0419704642370053,1.0427276024188317,12,13,12.02845573425293,9.76163387298584,20,19
1602,64,4.221063865506092,5.421024093895127,1.0358405790553675,1.0463293035870742,27,44,12.497724533081055,9.76163387298584,37,20
1602,128,2.481873285886753,5.251019353504327,1.016961380991955,1.051854473341711,68,108,13.14699649810791,9.76163387298584,60,20
1603,1,5.2841609491814925,5.284160949181492,0.9795772602007967,0.9795772602007983,0,0,5.319028854370117,5.319028854370117,1,1
1603,2,4.801607835834167,4.801607835834167,0.991441436260857,0.9914414362608585,0,0,8.270401000976562,5.319028854370117,2,2
1603,3,4.7317353958297605,4.7317353958297605,0.9946681218554793,0.9946681218554803,0,0,8.415151596069336,5.319028854370117,3,3
1603,4,4.164414435744748,4.164414435744748,1.0047555002255717,1.0047555002255721,0,0,8.724236488342285,5.319028854370117,4,4
1603,8,4.130718314080874,4.131392211959109,1.0062580149957168,1.0062531210698848,1,2,9.235830307006836,5.319028854370117,7,6
1603,16,3.8837913393751116,3.9320340194901173,1.0088780530129355,1.0100427788305195,5,6,9.654001235961914,5.319028854370117,11,10
1603,32,3.07436320174657,3.8340881976746863,1.0049542512457768,1.0138527708922704,14,17,10.088090896606445,5.319028854370117,18,15
1603,64,2.2497425876845187,3.791198158669833,1.0030378789519154,1.0155437546550397,32,48,10.981268882751465,5.319028854370117,32,16
1603,128,1.3985105017545596,3.753354538589071,0.9986473042331228,1.0168809008698507,63,111,11.92619800567627,5.319028854370117,65,17
1604,1,8.766941560225934,8.766941560225934,0.9554239683283204,0.9554239683283223,0,0,8.871658325195312,8.871658325195312,1,1
1604,2,7.034062167145508,7.034062167145509,0.9894097719914556,0.9894097719914565,0,0,9.130820274353027,8.871658325195312,2,2
1604,3,6.10751110428246,6.10751110428246,1.0024009891595396,1.002400989159541,0,0,9.264052391052246,8.871658325195312,3,3
1604,4,6.058249093464154,6.058249093464154,1.0035472965849415,1.0035472965849412,0,0,9.306819915771484,8.871658325195312,4,4
1604,8,6.029574173714644,6.037638441429874,1.004043603754522,1.00419578498047,2,2,9.527613639831543,8.871658325195312,6,6
1604,16,5.3433422924961285,5.6520176277809835,1.0146299994105767,1.0133684374028173,5,8,9.830967903137207,8.871658325195312,11,8
1604,32,4.718106175877915,5.363646587023851,1.0196757760728659,1.0212857337065482,14,17,10.16118335723877,8.871658325195312,18,15
1604,64,3.0560768206275135,5.147047542220806,1.0109283584904252,1.0280593672523715,30,48,10.59056568145752,8.871658325195312,34,16
1604,128,1.6198076695433143,4.910302613193156,1.0015309371867749,1.0322736710870815,64,110,11.198107719421387,8.871658325195312,64,18
1605,1,3.107238630483953,3.1072386304839537,0.9931000340133009,0.9931000340133023,0,0,3.1145968437194824,3.1145968437194824,1,1
1605,2,2.6670266525370017,2.6670266525370026,0.9967311519245445,0.9967311519245456,0,0,3.2439942359924316,3.1145968437194824,2,2
1605,3,2.6042784251576623,2.6042784251576623,0.9972299679828426,0.9972299679828434,0,0,3.2706663608551025,3.1145968437194824,3,3
1605,4,2.601794170251432,2.601794170251432,0.997337361271005,0.9973373612710057,0,0,3.3453011512756348,3.1145968437194824,4,4
1605,8,2.209598567060413,2.2411602758444396,1.0005892661296223,1.000356562258803,3,3,3.4951815605163574,3.1145968437194824,5,5
1605,16,1.8946388073694436,2.0750598052787246,1.0029491517517193,1.0016503221573236,6,8,3.768838882446289,3.1145968437194824,10,8
1605,32,1.5233539341201778,1.9927345591889944,1.0040544090860133,1.0030836186818801,14,21,4.187295913696289,3.1145968437194824,18,11
1605,64,0.7266961787858899,1.8339666649681732,1.0000531081770978,1.0039483862039387,31,52,4.606071949005127,3.1145968437194824,33,12
1605,128,0.09366169108840124,1.827190815111322,0.9994857922034832,1.0042754222437975,61,114,5.247834205627441,3.1145968437194824,67,14
1606,1,5.486053578016311,5.486053578016311,0.9839906740965912,0.9839906740965914,0,0,5.507565021514893,5.507565021514893,1,1
1606,2,4.328593866118511,4.328593866118511,0.9984088115207318,0.9984088115207311,0,0,5.7070698738098145,5.507565021514893,2,2
1606,3,3.7857087089346315,3.7857087089346315,1.0047565211083456,1.004756521108346,0,0,6.575407028198242,5.507565021514893,3,3
1606,4,3.661168157752184,3.661168157752184,1.0066035861954736,1.006603586195473,0,0,6.578048229217529,5.507565021514893,4,4
1606,8,3.3070130788053156,3.340817704041,1.010304220420796,1.0105362439001757,2,2,7.005470275878906,5.507565021514893,6,6
1606,16,2.8985574816083695,3.338663798886314,1.0073765761973428,1.0106669780552333,8,9,7.714399814605713,5.507565021514893,8,7
1606,32,2.5751396699168665,3.2593467842998716,1.0079362700914876,1.0131340161060076,15,21,8.256091117858887,5.507565021514893,17,11
1606,64,1.912632659504829,3.1671371484250077,1.0054306379474873,1.0169315972544677,29,50,8.9072265625,5.507565021514893,35,14
1606,128,0.9062680926159293,3.1350106787573337,1.001345135163816,1.0178190056243737,59,110,9.511563301086426,5.507565021514893,69,18
1607,1,8.470744358047753,8.470744358047751,0.9520341198615697,0.9520341198615724,0,0,8.588980674743652,8.588980674743652,1,1
1607,2,7.170964698867471,7.17096469886747,0.9817787972014289,0.9817787972014302,0,0,9.240966796875,8.588980674743652,2,2
1607,3,5.984095234937256,5.984095234937255,1.0009623676705877,1.0009623676705883,0,0,9.79884147644043,8.588980674743652,3,3
1607,4,5.824702283558453,5.824702283558454,1.0051971708173322,1.0051971708173326,0,0,10.65057373046875,8.588980674743652,4,4
1607,8,5.559497513926356,5.570490445411805,1.0130229730807174,1.013310519169047,1,1,11.001760482788086,8.588980674743652,7,7
1607,16,5.213551773291999,5.325405300148785,1.0215683075102884,1.0212803223595757,7,6,11.668770790100098,8.588980674743652,9,10
1607,32,4.856083807789793,5.2227896597849535,1.0298271465167312,1.0263687377608388,13,18,12.376574516296387,8.588980674743652,19,14
1607,64,3.9379209266517545,5.179507617982904,1.0252744864149435,1.029827652448731,24,43,13.073907852172852,8.588980674743652,40,21
1607,128,2.42995438809031,5.147473151509537,1.0072632656994776,1.033157287260055,66,109,13.75810432434082,8.588980674743652,62,19
1608,1,5.5135647528255,5.5135647528255,0.9856420219561953,0.9856420219561963,0,0,5.530633449554443,5.530633449554443,1,1
1608,2,4.635237715136535,4.635237715136536,0.9977355151005747,0.9977355151005749,0,0,6.22354793548584,5.530633449554443,2,2
1608,3,4.410321388935518,4.410321388935519,1.001505125817769,1.0015051258177692,0,0,6.300634860992432,5.530633449554443,3,3
1608,4,4.2912006372660025,4.291200637266002,1.0025011706728197,1.00250117067282,0,0,6.3491644859313965,5.530633449554443,4,4
1608,8,3.5570440153040623,3.55704401530406,1.0097798069013533,1.009779806901355,0,0,6.932707786560059,5.530633449554443,8,8
1608,16,3.175262054169489,3.4159116453503247,1.0131637404526688,1.0127567235833568,4,8,7.550108432769775,5.530633449554443,12,8
1608,32,2.8113536261129872,3.3200697702326916,1.0108656760638708,1.016244307981296,12,21,8.201533317565918,5.530633449554443,20,11
1608,64,2.076686972075776,3.171261135405766,1.007185213695277,1.0192957036216599,26,49,9.060564994812012,5.530633449554443,38,15
1608,128,1.1747455525608759,3.1273700293102444,1.0021922847495048,1.0212768338303246,59,111,9.991104125976562,5.530633449554443,69,17
1609,1,10.063621646555863,10.063621646555863,0.9451897360616556,0.9451897360616585,0,0,10.193929672241211,10.193929672241211,1,1
1609,2,9.017797184817418,9.01779718481742,0.9664916526305922,0.9664916526305934,0,0,10.354480743408203,10.193929672241211,2,2
1609,3,7.061806947990991,7.061806947990991,1.0046380714454455,1.004638071445445,0,0,10.595868110656738,10.193929672241211,3,3
1609,4,6.9718072462814344,6.9718072462814344,1.0067507590218128,1.0067507590218128,0,0,10.707756996154785,10.193929672241211,4,4
1609,8,6.341034345518766,6.341034345518765,1.0251125485374324,1.0251125485374326,0,0,12.079055786132812,10.193929672241211,8,8
1609,16,5.869061880788232,6.036061132940193,1.03189190800705,1.0331572519216046,3,7,13.092370986938477,10.193929672241211,13,9
1609,32,5.043879922870811,5.5763871883516565,1.0348562961446617,1.0475407542985558,10,17,13.679964065551758,10.193929672241211,22,15
1609,64,3.619877559537623,5.536078474454712,1.0150825753185695,1.0497472318308012,27,45,14.450884819030762,10.193929672241211,37,19
1609,128,2.371368856778383,5.514324469029743,1.0071698297072045,1.0516138663991084,62,109,15.433258056640625,10.193929672241211,66,19
1610,1,5.332103522447844,5.3321035224478335,0.9863863318105119,0.9863863318105135,0,0,5.347775936126709,5.347775936126709,1,1
1610,2,4.915960048106567,4.915960048106567,0.9952258710972963,0.9952258710972975,0,0,7.525918483734131,5.347775936126709,2,2
1610,3,4.455043236834204,4.455043236834203,1.0016714394780168,1.0016714394780175,0,0,7.629294395446777,5.347775936126709,3,3
1610,4,4.398647337265998,4.398647337265997,1.003809802873762,1.003809802873763,0,0,7.703025817871094,5.347775936126709,4,4
1610,8,4.26203968798245,4.293728834443265,1.005488007078528,1.005982422306988,1,1,8.068921089172363,5.347775936126709,7,7
1610,16,3.951564404272404,4.062734190350569,1.0103602716281204,1.0110465708657188,6,8,8.540863990783691,5.347775936126709,10,8
1610,32,3.249279080039264,3.9176222870627235,1.0115689518135809,1.0159098275970346,16,21,9.134716987609863,5.347775936126709,16,11
1610,64,2.1652250618701054,3.6792089317780965,1.004613917368466,1.0186900963395666,30,49,9.796318054199219,5.347775936126709,34,15
1610,128,1.0148627485203525,3.6160568754083244,1.0018940832643581,1.020214793848562,64,109,10.405479431152344,5.347775936126709,64,19
1611,1,4.643592696479245,4.6435926964792325,0.9868507682774744,0.9868507682774762,0,0,4.660841941833496,4.660841941833496,1,1
1611,2,3.919591227663849,3.919591227663849,0.9937078488285994,0.9937078488286007,0,0,5.104835033416748,4.660841941833496,2,2
1611,3,3.364659980552333,3.3646599805523327,0.9993509490120324,0.9993509490120336,0,0,5.185219764709473,4.660841941833496,3,3
1611,4,2.87047725492058,2.8704772549205795,1.0027862622724082,1.0027862622724093,0,0,5.244095802307129,4.660841941833496,4,4
1611,8,2.6930516708923613,2.7312271569515523,1.0049760304908761,1.0050049032501143,2,2,5.772426605224609,4.660841941833496,6,6
1611,16,2.363309570105119,2.5951005140959422,1.0087508169884116,1.007708818546602,5,6,6.5284552574157715,4.660841941833496,11,10
1611,32,2.0253823657118573,2.5457554933634072,1.007791619027162,1.0089959922198317,13,19,7.098005771636963,4.660841941833496,19,13
1611,64,1.4465696749431018,2.440918606148914,1.0036315891926084,1.011650710691288,28,51,7.76574182510376,4.660841941833496,36,13
1611,128,0.8808634546610411,2.422382359622095,0.9997749095995881,1.012481926707471,67,112,8.682175636291504,4.660841941833496,61,16
1612,1,7.9494116305221025,7.949411630522102,0.9698004976598643,0.9698004976598655,0,0,8.002381324768066,8.002381324768066,1,1
1612,2,7.0862709584108705,7.0862709584108705,0.9882441258184975,0.9882441258184977,0,0,8.474199295043945,8.002381324768066,2,2
1612,3,6.055505592262907,6.055505592262908,1.004127305372149,1.0041273053721482,0,0,8.85515308380127,8.002381324768066,3,3
1612,4,5.755115107667897,5.755115107667898,1.0089058344076447,1.008905834407645,0,0,9.014959335327148,8.002381324768066,4,4
1612,8,5.407938872704542,5.407938872704542,1.0189572582177537,1.0189572582177524,0,0,9.624524116516113,8.002381324768066,8,8
1612,16,4.941266773646722,5.163806581680866,1.0183460819767112,1.0219985527805997,5,5,10.146595001220703,8.002381324768066,11,11
1612,32,4.087262913622872,5.158246076041541,1.019701528272909,1.0224915020888576,14,20,10.905285835266113,8.002381324768066,18,12
1612,64,3.115402273567961,4.982327302794766,1.0086023588524924,1.0290665471051241,29,51,11.528585433959961,8.002381324768066,35,13
1612,128,1.3011693915081106,4.982327302794768,1.0003078939945262,1.0290665471051241,59,115,12.14202880859375,8.002381324768066,69,13
1613,1,12.420313273424277,12.420313273424275,0.89683178028013,0.8968317802801313,0,0,12.780905723571777,12.780905723571777,1,1
1613,2,9.894513156868321,9.89451315686832,0.9690575640694596,0.9690575640694628,0,0,12.84379768371582,12.780905723571777,2,2
1613,3,8.753448356487665,8.753448356487665,0.9942762172844316,0.9942762172844329,0,0,13.194791793823242,12.780905723571777,3,3
1613,4,8.705748238983382,8.705748238983382,0.9955935548415147,0.9955935548415159,0,0,13.213582038879395,12.780905723571777,4,4
1613,8,8.353888090786047,8.355244966879054,1.0071476821167438,1.0073312811323438,1,1,13.601884841918945,12.780905723571777,7,7
1613,16,7.698067575787506,8.074610200579308,1.0181736463833535,1.0155828404412444,4,5,14.462602615356445,12.780905723571777,12,11
1613,32,6.6481177368139255,7.944445575432801,1.0264584751062273,1.0234612371010523,10,20,14.936844825744629,12.780905723571777,22,12
1613,64,5.0665071457267175,7.889429492993346,1.0310217134632587,1.028892843239013,27,50,15.459152221679688,12.780905723571777,37,14
1613,128,3.3713052913498194,7.60630387845186,1.0217688721890497,1.0432500316071445,67,109,16.036203384399414,12.780905723571777,61,19
1614,1,12.456422958299045,12.456422958299036,0.907872215629973,0.9078722156299759,0,0,12.746634483337402,12.746634483337402,1,1
1614,2,10.283788471991377,10.283788471991379,0.9824990234279695,0.9824990234279714,0,0,12.944117546081543,12.746634483337402,2,2
1614,3,9.724104695926705,9.724104695926707,0.9914802109204764,0.9914802109204781,0,0,13.300873756408691,12.746634483337402,3,3
1614,4,9.243040709627952,9.243040709627952,1.0109930584599924,1.0109930584599935,0,0,14.630938529968262,12.746634483337402,4,4
1614,8,8.907542846335364,8.944135076896254,1.017374903508057,1.019276572347756,1,1,14.833320617675781,12.746634483337402,7,7
1614,16,8.386775737387477,8.73495881414887,1.033774032072961,1.03141923774827,5,7,15.430291175842285,12.746634483337402,11,9
1614,32,7.657553805826153,8.502953238142275,1.0499516279903183,1.0447489513290804,15,20,15.694245338439941,12.746634483337402,17,12
1614,64,6.365321307724759,8.489681808860382,1.038214614249143,1.0467110768610859,33,50,16.63469886779785,12.746634483337402,31,14
1614,128,3.9783363805981233,8.489379693584178,1.0075278006269033,1.0470744227624156,64,113,17.231613159179688,12.746634483337402,64,15
1615,1,3.9818877275149513,3.981887727514951,0.9896435264246829,0.9896435264246837,0,0,3.994537353515625,3.994537353515625,1,1
1615,2,3.4482107407208784,3.4482107407208784,0.994018870363049,0.9940188703630493,0,0,4.149621486663818,3.994537353515625,2,2
1615,3,3.367338429614518,3.367338429614518,0.9955058661941849,0.9955058661941849,0,0,4.4084553718566895,3.994537353515625,3,3
1615,4,3.237384232899469,3.2373842328994686,0.9964093856696863,0.9964093856696862,0,0,4.416796684265137,3.994537353515625,4,4
1615,8,2.961870374096418,2.9873266456096754,1.0007053814754114,1.000327117349226,3,3,5.213273048400879,3.994537353515625,5,5
1615,16,2.546725016066904,2.7373792810698614,1.0045692941570108,1.0039358671279972,4,8,5.6982269287109375,3.994537353515625,12,8
1615,32,2.0273389403600817,2.6426952638673336,1.0034434153987317,1.0049212460052794,13,21,6.090122699737549,3.994537353515625,19,11
1615,64,1.2779785739051293,2.3760512344516673,1.0009052801356386,1.0091123281192704,30,51,6.680627346038818,3.994537353515625,34,13
1615,128,0.3631638481888888,2.3299011818901487,0.998324645405692,1.0097588068370582,60,114,7.646241664886475,3.994537353515625,68,14
1616,1,9.789380865965953,9.789380865965954,0.9485760679566365,0.9485760679566383,0,0,9.909409523010254,9.909409523010254,1,1
1616,2,8.260418304857222,8.26041830485722,0.9773854128431947,0.9773854128431958,0,0,9.986359596252441,9.909409523010254,2,2
1616,3,8.149692389822095,8.149692389822095,0.98296162834192,0.9829616283419211,0,0,10.677233695983887,9.909409523010254,3,3
1616,4,7.828693270161782,7.828693270161782,0.9905080487550585,0.9905080487550592,0,0,11.106368064880371,9.909409523010254,4,4
1616,8,7.2966166778516355,7.298375403370348,1.0048916311831362,1.0048467536281778,1,1,11.502924919128418,9.909409523010254,7,7
1616,16,6.90042712970512,7.189558742808409,1.01381869163093,1.0107385080867037,5,7,11.858003616333008,9.909409523010254,11,9
1616,32,5.762406494557762,6.668746056171581,1.0353991104464035,1.027766663645885,12,19,12.406811714172363,9.909409523010254,20,13
1616,64,3.9656897496490244,6.27116973585253,1.0157795276066766,1.0394019719959304,30,44,13.108911514282227,9.909409523010254,34,20
1616,128,2.3854449566195615,6.123637819364964,1.006435076947597,1.0470307273621495,63,110,13.825139999389648,9.909409523010254,65,18
1617,1,8.369971835619548,8.369971835619548,0.9645247281730013,0.9645247281730037,0,0,8.437556266784668,8.437556266784668,1,1
1617,2,6.944628677731422,6.944628677731422,0.9907482267181058,0.9907482267181075,0,0,8.890933990478516,8.437556266784668,2,2
1617,3,6.663465838874579,6.663465838874579,0.9961636125387805,0.9961636125387819,0,0,9.02699089050293,8.437556266784668,3,3
1617,4,5.994331869741326,5.994331869741326,1.0048213607889165,1.0048213607889183,0,0,9.078551292419434,8.437556266784668,4,4
1617,8,5.133579970555241,5.267835051828101,1.0204088844128139,1.017885658098204,2,2,9.452466011047363,8.437556266784668,6,6
1617,16,4.408384135838408,4.701428732505178,1.0316501991178857,1.0294842952938892,3,6,10.147502899169922,8.437556266784668,13,10
1617,32,4.121586350785092,4.508040337169541,1.0344784324075422,1.0353075193859023,14,18,10.669960975646973,8.437556266784668,18,14
1617,64,3.0849375278999296,4.465793932712492,1.0154712671065365,1.036883866678287,29,48,11.487822532653809,8.437556266784668,35,16
1617,128,1.8153305384025942,4.45335437179976,1.004833582898424,1.0382762415016638,69,110,12.296669960021973,8.437556266784668,59,18
1618,1,7.715380729233062,7.715380729233064,0.967285765948494,0.9672857659484957,0,0,7.77838659286499,7.77838659286499,1,1
1618,2,6.304547088318811,6.304547088318814,0.9860056658183696,0.9860056658183723,0,0,7.77996301651001,7.77838659286499,2,2
1618,3,6.284191437080302,6.284191437080302,0.9868372311925065,0.9868372311925081,0,0,8.698671340942383,7.77838659286499,3,3
1618,4,5.56503306359749,5.56503306359749,0.9996377737325643,0.9996377737325659,0,0,8.743499755859375,7.77838659286499,4,4
1618,8,4.886775502852277,4.9622334210071735,1.0100401474279646,1.01021141813124,2,2,9.21821117401123,7.77838659286499,6,6
1618,16,4.095748248977793,4.425707775101257,1.0188284161566727,1.0200414622214198,6,7,9.727157592773438,7.77838659286499,10,9
1618,32,3.7024447194869565,4.360724283090176,1.020437627402197,1.0221770282138583,14,17,10.056957244873047,7.77838659286499,18,15
1618,64,3.1036043934352917,4.288410656911029,1.010076717326311,1.0260582991114124,31,48,10.580289840698242,7.77838659286499,33,16
1618,128,1.417515426120918,4.196454490381125,1.0022549839796984,1.0274820419443826,66,115,11.14390754699707,7.77838659286499,62,13
1619,1,8.813869662169594,8.813869662169594,0.95297547709266,0.9529754770926611,0,0,8.925562858581543,8.925562858581543,1,1
1619,2,7.543861632497862,7.543861632497862,0.9883819897962777,0.9883819897962789,0,0,10.34273624420166,8.925562858581543,2,2
1619,3,7.167065365189148,7.167065365189148,0.9990363261478161,0.9990363261478163,0,0,10.647607803344727,8.925562858581543,3,3
1619,4,7.07513679360568,7.07513679360568,1.0021239958862018,1.0021239958862025,0,0,10.699694633483887,8.925562858581543,4,4
1619,8,6.699716510522478,6.756063860282644,1.0122832387318215,1.0114634867544288,1,2,11.21835708618164,8.925562858581543,7,6
1619,16,5.762255847498258,6.51762219045654,1.0263020032456334,1.0176588835187677,5,8,12.02919864654541,8.925562858581543,11,8
1619,32,4.8668792043784235,6.030164537510664,1.0279686051721466,1.0295551973271049,13,22,12.63193416595459,8.925562858581543,19,10
1619,64,3.7195543970167506,6.0284475287409,1.0177253380430875,1.0303028543226662,32,52,13.461359977722168,8.925562858581543,32,12
1619,128,2.7392865626466363,5.929349685326072,1.0072650271500843,1.0365642116541094,60,113,14.319907188415527,8.925562858581543,68,15
1620,1,9.65072422335792,9.65072422335792,0.9416474857795293,0.9416474857795311,0,0,9.810173034667969,9.810173034667969,1,1
1620,2,8.464435726195282,8.464435726195282,0.9749322315437803,0.9749322315437812,0,0,9.995500564575195,9.810173034667969,2,2
1620,3,7.748664905187264,7.748664905187264,0.993193641841614,0.9931936418416144,0,0,10.333561897277832,9.810173034667969,3,3
1620,4,7.724717633872709,7.724717633872708,0.9936957774854087,0.9936957774854097,0,0,10.376376152038574,9.810173034667969,4,4
1620,8,7.289615553481651,7.4012203421563205,1.0012747646185587,0.9999452775960258,2,2,10.745309829711914,9.810173034667969,6,6
1620,16,6.463541960473033,6.6010909491689125,1.0195655015567333,1.019783911647691,5,5,11.155515670776367,9.810173034667969,11,11
1620,32,5.658692380204261,6.297428269449704,1.028754506542248,1.025806188923638,13,20,11.431978225708008,9.810173034667969,19,12
1620,64,4.393969977556236,6.048093304938312,1.0239144810024265,1.0345032500939446,32,47,11.876750946044922,9.810173034667969,32,17
1620,128,2.1608985526076756,5.948032651555331,1.0061797576576657,1.036718978000497,60,110,12.459192276000977,9.810173034667969,68,18
1621,1,6.6481672460241015,6.6481672460241015,0.9796094761603392,0.9796094761603409,0,0,6.676685333251953,6.676685333251953,1,1
1621,2,5.216283922667073,5.216283922667073,0.9972343638260094,0.9972343638260102,0,0,7.0988450050354,6.676685333251953,2,2
1621,3,5.1899172079796365,5.189917207979637,0.998031716160096,0.9980317161600966,0,0,7.310266971588135,6.676685333251953,3,3
1621,4,4.996663665938149,4.996663665938149,1.0007936877229777,1.0007936877229782,0,0,7.3243937492370605,6.676685333251953,4,4
1621,8,4.656927098287609,4.720341136572699,1.0062134415635542,1.0069032399895377,1,1,7.868995189666748,6.676685333251953,7,7
1621,16,4.296679743744635,4.574602993810385,1.0119470735817075,1.0110599426776234,6,7,8.35924243927002,6.676685333251953,10,9
1621,32,3.6745032228111887,4.4044662871708855,1.0120173334103728,1.0154755709875618,14,19,8.85836410522461,6.676685333251953,18,13
1621,64,2.8597004558289276,4.245853874630103,1.0062432141019138,1.0225295241013996,30,47,9.4707612991333,6.676685333251953,34,17
1621,128,1.6463697673301585,4.215879720152117,0.9996869748922924,1.0248243689921686,60,110,10.22162914276123,6.676685333251953,68,18
1622,1,9.020007604094262,9.020007604094264,0.9548245138086394,0.9548245138086415,0,0,9.119649887084961,9.119649887084961,1,1
1622,2,8.138637001589158,8.13863700158916,0.9756942950988269,0.9756942950988283,0,0,9.79031753540039,9.119649887084961,2,2
1622,3,6.736869854762368,6.736869854762369,1.0047085787909666,1.0047085787909666,0,0,10.048065185546875,9.119649887084961,3,3
1622,4,6.73682678920324,6.736869854762369,1.0047032226843413,1.0047085787909666,1,1,10.580096244812012,9.119649887084961,3,3
1622,8,6.290962990584309,6.377128648242609,1.0112490357463906,1.0128612441644376,1,1,10.758244514465332,9.119649887084961,7,7
1622,16,5.7875147327542535,6.1605112212809425,1.0195827351225601,1.018803805518448,5,6,11.264137268066406,9.119649887084961,11,10
1622,32,5.017459207712558,6.0913787907306425,1.0227188293477278,1.0231154802148024,12,20,11.782520294189453,9.119649887084961,20,12
1622,64,3.7400005363149442,6.043339394459447,1.0090748037274346,1.0281573038912792,28,48,12.419875144958496,9.119649887084961,36,16
1622,128,2.3257397550065133,5.960245165303767,1.0014816227956025,1.0312184787575496,60,111,13.35142707824707,9.119649887084961,68,17
1623,1,10.649491628230136,10.649491628230138,0.9364367346919459,0.9364367346919472,0,0,10.819761276245117,10.819761276245117,1,1
1623,2,9.033825270741739,9.033825270741737,0.9769192928599941,0.9769192928599946,0,0,11.805890083312988,10.819761276245117,2,2
1623,3,8.66777039816035,8.66777039816035,0.9836179658508302,0.9836179658508304,0,0,12.07730484008789,10.819761276245117,3,3
1623,4,8.619217246266603,8.619217246266603,0.9855095109243751,0.9855095109243747,0,0,12.161788940429688,10.819761276245117,4,4
1623,8,7.923463497351198,7.925385024056986,1.0044709671118988,1.0044634012264364,1,1,12.485936164855957,10.819761276245117,7,7
1623,16,7.042638217851982,7.303940395639551,1.0267759676650359,1.0252005521441268,5,6,13.207717895507812,10.819761276245117,11,10
1623,32,6.29793555363869,7.119319516908596,1.027716540089213,1.0324514314859303,11,18,13.73798656463623,10.819761276245117,21,14
1623,64,5.154798451568517,6.999450489841142,1.029268248414945,1.0403060740942072,31,47,14.202232360839844,10.819761276245117,33,17
1623,128,3.432593892090952,6.798073254179528,1.0177814950665107,1.0518618637317627,60,109,14.885085105895996,10.819761276245117,68,19
1624,1,8.345607087844327,8.345607087844323,0.9582010858262278,0.9582010858262322,0,0,8.43697738647461,8.43697738647461,1,1
1624,2,6.435755768706392,6.435755768706391,0.9952168034777333,0.9952168034777361,0,0,8.714279174804688,8.43697738647461,2,2
1624,3,6.320689495314393,6.320689495314393,0.9974903792430204,0.9974903792430225,0,0,8.883224487304688,8.43697738647461,3,3
1624,4,6.306578589987193,6.320689495314393,0.9972417902981124,0.9974903792430225,1,1,9.547677993774414,8.43697738647461,3,3
1624,8,5.122189192910012,5.436683959927541,1.0199749707327337,1.0190484112761675,2,2,9.920528411865234,8.43697738647461,6,6
1624,16,4.7044218289632855,5.088750033636935,1.0264043314735791,1.025458452458305,6,8,10.585738182067871,8.43697738647461,10,8
1624,32,4.198771251429755,5.010389052200625,1.0289469511984377,1.0289456254634244,12,22,11.208580017089844,8.43697738647461,20,10
1624,64,3.4039988146731304,4.930634030960111,1.020264443350209,1.0335742439869753,26,48,12.076272010803223,8.43697738647461,38,16
1624,128,2.1184938176770247,4.921856631583655,1.0069857070428383,1.0345337028455868,59,111,13.013252258300781,8.43697738647461,69,17
1625,1,10.642331228436408,10.642331228436408,0.9175348301195401,0.9175348301195413,0,0,10.925745010375977,10.925745010375977,1,1
1625,2,8.57101454633353,8.57101454633353,0.9751975819312522,0.9751975819312533,0,0,11.975287437438965,10.925745010375977,2,2
1625,3,7.975056475913348,7.975056475913348,0.992771287370128,0.9927712873701289,0,0,12.1083345413208,10.925745010375977,3,3
1625,4,7.594238404530476,7.594238404530476,1.0026855684862581,1.0026855684862588,0,0,12.383252143859863,10.925745010375977,4,4
1625,8,7.084218087013016,7.251453230372753,1.0143485613352738,1.0117086187096345,2,2,12.876099586486816,10.925745010375977,6,6
1625,16,6.815762635721344,7.151550651384513,1.0173348066982113,1.0155202447689102,7,6,13.572604179382324,10.925745010375977,9,10
1625,32,6.023174266999396,7.008819450599081,1.017193195798531,1.022712309815422,12,20,14.281267166137695,10.925745010375977,20,12
1625,64,5.212886024013555,6.822020017870016,1.0180237983116327,1.0299804457090045,32,46,14.833510398864746,10.925745010375977,32,18
1625,128,3.493592232874177,6.734983195962476,1.0027881914498586,1.03287339725704,65,113,15.666570663452148,10.925745010375977,63,15
1626,1,9.716180148066076,9.716180148066078,0.9582492477313388,0.9582492477313392,0,0,9.796284675598145,9.796284675598145,1,1
1626,2,7.310854679911982,7.310854679911983,1.0096069346886138,1.0096069346886136,0,0,10.293966293334961,9.796284675598145,2,2
1626,3,6.890842422643528,6.890842422643529,1.0146913262536923,1.0146913262536918,0,0,10.550529479980469,9.796284675598145,3,3
1626,4,6.792748462690072,6.792748462690072,1.0174322827078246,1.0174322827078233,0,0,10.680753707885742,9.796284675598145,4,4
1626,8,6.217061942102924,6.218005302519458,1.027791958426079,1.0279534176718648,1,1,11.838314056396484,9.796284675598145,7,7
1626,16,5.697316885442219,5.725439418906833,1.0452140859513017,1.0459966320885776,3,4,12.448628425598145,9.796284675598145,13,12
1626,32,5.087286089165461,5.633389192852144,1.0406769837852146,1.048997574957963,12,17,13.086954116821289,9.796284675598145,20,15
1626,64,3.8169911698972205,5.603531434663397,1.0234898482815897,1.0511275232297952,30,48,13.711586952209473,9.796284675598145,34,16
1626,128,2.6829674147589966,5.593063765097097,1.0148889376171595,1.0525933462695303,61,108,14.317069053649902,9.796284675598145,67,20
1627,1,8.689458758882928,8.68945875888292,0.962494556295399,0.9624945562954051,0,0,8.759952545166016,8.759952545166016,1,1
1627,2,7.004769366816598,7.004769366816597,0.9901392610177777,0.990139261017779,0,0,8.860508918762207,8.759952545166016,2,2
1627,3,6.49604525919517,6.49604525919517,0.9980579274180078,0.9980579274180091,0,0,9.747380256652832,8.759952545166016,3,3
1627,4,6.3380710188204725,6.338071018820473,1.0014224497461206,1.0014224497461215,0,0,9.786054611206055,8.759952545166016,4,4
1627,8,5.9850332835925935,5.985575302715651,1.0106188701498438,1.0106064813053115,1,1,10.297931671142578,8.759952545166016,7,7
1627,16,5.160535958108353,5.572574342233731,1.0212965123709699,1.0197829949233777,7,7,10.784952163696289,8.759952545166016,9,9
1627,32,4.4378321085005865,5.271741662517946,1.028185747929582,1.0312233573010512,13,21,11.838224411010742,8.759952545166016,19,11
1627,64,3.273258663739819,5.102820888104328,1.0113620115654234,1.0399442368066696,30,51,12.856276512145996,8.759952545166016,34,13
1627,128,2.191856297484053,5.097300384124746,1.0028719496677212,1.0407458757804038,65,114,13.78373908996582,8.759952545166016,63,14
1628,1,9.584829700945255,9.58482970094526,0.9453413439239885,0.9453413439239925,0,0,9.718927383422852,9.718927383422852,1,1
1628,2,7.973999706384592,7.973999706384581,0.9834630633103758,0.9834630633103782,0,0,10.441594123840332,9.718927383422852,2,2
1628,3,7.963474455849761,7.963474455849761,0.9838215734155632,0.9838215734155653,0,0,10.987104415893555,9.718927383422852,3,3
1628,4,6.752163824681511,6.756652586366569,1.0045993749286137,1.0046255010315357,1,1,11.01802921295166,9.718927383422852,3,3
1628,8,6.387805737865211,6.446639201323071,1.0159749527285553,1.0156543010004306,2,2,11.820962905883789,9.718927383422852,6,6
1628,16,5.967408245217824,6.231706035828485,1.0202282950815222,1.021664012499369,6,8,12.144231796264648,9.718927383422852,10,8
1628,32,5.3587829078378055,6.103519331961014,1.0287575617155789,1.0284883980113932,10,20,12.72009563446045,9.718927383422852,22,12
1628,64,4.120729427075721,5.930197334029405,1.0244031034634915,1.0390389351438578,28,52,13.400472640991211,9.718927383422852,36,12
1628,128,2.2706090944485005,5.915481098453003,1.001576496165186,1.0403962410888838,59,115,14.600641250610352,9.718927383422852,69,13
1629,1,7.168018421240649,7.168018421240649,0.9664949564018953,0.9664949564018953,0,0,7.238651275634766,7.238651275634766,1,1
1629,2,6.476046766281486,6.476046766281486,0.9774789451493655,0.9774789451493657,0,0,7.258951187133789,7.238651275634766,2,2
1629,3,6.161259360947302,6.161259360947301,0.9826635429232834,0.9826635429232833,0,0,7.286038875579834,7.238651275634766,3,3
1629,4,5.4323644559647315,5.432364455964731,0.9941027517583505,0.99410275175835,0,0,7.458791732788086,7.238651275634766,4,4
1629,8,4.7707972887214485,4.848737925023423,1.0052228258978806,1.0046116815426198,3,3,7.94686222076416,7.238651275634766,5,5
1629,16,4.289817497924049,4.550076841873425,1.0119114976388999,1.0121718633054897,5,8,8.498082160949707,7.238651275634766,11,8
1629,32,3.415768918439035,4.444525499154843,1.0087276360443305,1.0148559679479825,13,20,9.118353843688965,7.238651275634766,19,12
1629,64,2.3498549517906446,4.437982893916028,1.0041255933976339,1.015753952796344,29,50,9.824976921081543,7.238651275634766,35,14
1629,128,1.2677516303826017,4.3483811456407455,1.001726798577596,1.0174495497312241,67,113,10.524123191833496,7.238651275634766,61,15
1630,1,8.36102475600454,8.36102475600454,0.9642293868483633,0.9642293868483643,0,0,8.42982292175293,8.42982292175293,1,1
1630,2,6.94706132462909,6.94706132462909,0.9820668979750979,0.9820668979750975,0,0,8.430569648742676,8.42982292175293,2,2
1630,3,6.809536043513776,6.809536043513776,0.9846513580865675,0.984651358086567,0,0,8.847386360168457,8.42982292175293,3,3
1630,4,6.471634446771818,6.473518776594796,0.9910798871195958,0.9910334841483255,1,1,8.877251625061035,8.42982292175293,3,3
1630,8,5.993864893939339,6.098790580809651,0.9970976877772011,0.9986997707724117,1,2,9.41131591796875,8.42982292175293,7,6
1630,16,5.074502919054068,5.128681437178895,1.0154964343433088,1.0165271531219418,2,4,9.50054931640625,8.42982292175293,14,12
1630,32,4.178379728539898,4.976501892360556,1.0187948225349839,1.0224234006937052,12,19,10.0523042678833,8.42982292175293,20,13
1630,64,3.266167641283081,4.916538287938315,1.011959288305445,1.0247242661761353,30,49,10.655538558959961,8.42982292175293,34,15
1630,128,1.694159574405668,4.70597836475409,1.0058755885454516,1.0315179702107014,61,112,11.276482582092285,8.42982292175293,67,16
1631,1,7.275385053896394,7.275385053896394,0.9660697290356963,0.9660697290356978,0,0,7.34475564956665,7.34475564956665,1,1
1631,2,6.129448598817698,6.129448598817699,0.9844337837376793,0.9844337837376802,0,0,7.444450855255127,7.34475564956665,2,2
1631,3,5.559358087834017,5.559358087834017,0.9925733698155799,0.9925733698155803,0,0,8.15451431274414,7.34475564956665,3,3
1631,4,5.359711422342303,5.359711422342303,0.9954180231805189,0.9954180231805193,0,0,8.24767017364502,7.34475564956665,4,4
1631,8,4.924804837710525,5.1101646641713785,1.0024256167978518,1.0017230980806255,1,1,9.31997013092041,7.34475564956665,7,7
1631,16,4.651781000076605,4.968013911674554,1.007879764278366,1.0087950886849413,5,4,9.929640769958496,7.34475564956665,11,12
1631,32,3.5158410325681673,4.8505687634201555,1.010244461243689,1.0128595299199814,13,16,10.449647903442383,7.34475564956665,19,16
1631,64,2.5040578474700563,4.788742927651445,1.0042039198657222,1.0158786671912337,28,48,11.189661979675293,7.34475564956665,36,16
1631,128,1.640864163658555,4.539708184819953,1.0010690295408138,1.0226108097231088,65,115,11.743749618530273,7.34475564956665,63,13
1632,1,7.575872910921307,7.575872910921304,0.9672359618575376,0.9672359618575397,0,0,7.639280796051025,7.639280796051025,1,1
1632,2,6.477487845891716,6.477487845891716,0.9875630294463014,0.9875630294463025,0,0,8.113738059997559,7.639280796051025,2,2
1632,3,5.705786006234921,5.705786006234921,0.9967042057045095,0.9967042057045099,0,0,8.224360466003418,7.639280796051025,3,3
1632,4,5.55756974308576,5.55756974308576,0.9978543605059402,0.9978543605059408,0,0,8.245458602905273,7.639280796051025,4,4
1632,8,4.813563986919986,4.8153004858146495,1.0145788333590815,1.0145591341505158,1,1,8.94328498840332,7.639280796051025,7,7
1632,16,4.394344938405489,4.564654821070197,1.020755189928924,1.020215507304923,5,6,9.256153106689453,7.639280796051025,11,10
1632,32,3.906843070969769,4.3504402647353,1.020896911966385,1.0264433500354324,12,18,9.765591621398926,7.639280796051025,20,14
1632,64,3.0399474168130793,4.312209030848756,1.0121300998529135,1.0281738083116752,28,47,10.408758163452148,7.639280796051025,36,17
1632,128,1.719012904081093,4.26127389699548,1.0006172134915374,1.0314775497248392,56,108,11.202686309814453,7.639280796051025,72,20
1633,1,8.237066342255064,8.237066342255064,0.9530651856503415,0.9530651856503426,0,0,8.358787536621094,8.358787536621094,1,1
1633,2,6.856229452012026,6.856229452012027,0.9835768335443901,0.9835768335443904,0,0,8.620356559753418,8.358787536621094,2,2
1633,3,6.253049776272645,6.253049776272644,0.9928357946045274,0.9928357946045279,0,0,9.268060684204102,8.358787536621094,3,3
1633,4,6.217178450520657,6.217178450520657,0.9943110047007426,0.9943110047007431,0,0,9.298609733581543,8.358787536621094,4,4
1633,8,6.1623311732110615,6.190728602021383,0.9954640897082903,0.9952994402895381,3,3,9.498448371887207,8.358787536621094,5,5
1633,16,5.607522388918735,5.863329391000869,1.0072764570969452,1.0041637389348534,6,8,9.933636665344238,8.358787536621094,10,8
1633,32,4.477768970506616,5.66517986519434,1.0119265049584178,1.0087657887054606,15,24,10.431071281433105,8.358787536621094,17,8
1633,64,2.778785446679071,5.5064541567962655,1.0041692868233543,1.0132286793873737,30,54,10.861271858215332,8.358787536621094,34,10
1633,128,1.4045880185605022,5.293804673007421,1.0006787302734097,1.0205602500413047,65,115,11.614282608032227,8.358787536621094,63,13
1634,1,7.987782272843389,7.98778227284339,0.9598950855788951,0.9598950855788992,0,0,8.076184272766113,8.076184272766113,1,1
1634,2,6.46180333447728,6.461803334477279,0.9866347304317671,0.9866347304317704,0,0,8.475138664245605,8.076184272766113,2,2
1634,3,6.291081174469207,6.291081174469207,0.9902272616493116,0.9902272616493148,0,0,8.488618850708008,8.076184272766113,3,3
1634,4,6.0668368437920455,6.066836843792047,0.9951485056662411,0.9951485056662434,0,0,8.752023696899414,8.076184272766113,4,4
1634,8,5.698574717521489,5.769871351176972,1.0033884108232294,1.0042035779942455,1,1,9.511159896850586,8.076184272766113,7,7
1634,16,5.13741900985221,5.250439034507822,1.0128163717778729,1.0144581689075014,6,7,10.037542343139648,8.076184272766113,10,9
1634,32,4.398959294303953,4.939033545609927,1.0187121449184922,1.0230113797781657,14,22,10.608059883117676,8.076184272766113,18,10
1634,64,3.5538996825492704,4.811613286794498,1.01817742241478,1.0309291193042016,30,50,11.420631408691406,8.076184272766113,34,14
1634,128,2.0694924695619945,4.69168859879472,1.0055997612841447,1.0383266352134928,59,108,12.276865005493164,8.076184272766113,69,20
1635,1,9.183897900859488,9.18389790085949,0.9373480193482274,0.937348019348229,0,0,9.3705415725708,9.3705415725708,1,1
1635,2,7.473851997078786,7.473851997078785,0.9760941037052344,0.976094103705235,0,0,9.642398834228516,9.3705415725708,2,2
1635,3,7.2847592038028655,7.2847592038028655,0.982125483691618,0.9821254836916187,0,0,10.290910720825195,9.3705415725708,3,3
1635,4,7.255528954015284,7.255528954015284,0.9835411619648469,0.9835411619648468,0,0,10.29483699798584,9.3705415725708,4,4
1635,8,6.947308907361464,7.015513419882932,0.9898407716164951,0.9906731508395015,3,3,11.027944564819336,9.3705415725708,5,5
1635,16,6.678697212919085,6.860747825829149,0.9996270988112805,0.9995102491828812,7,8,11.987570762634277,9.3705415725708,9,8
1635,32,5.914027486772543,6.650630845782962,1.0062674657477506,1.0071229775347559,15,21,12.734128952026367,9.3705415725708,17,11
1635,64,4.502157033159409,6.298129562337133,1.0121607466744675,1.0257234168840397,31,51,13.584558486938477,9.3705415725708,33,13
1635,128,2.7095349281765766,6.177016841391468,1.0050972322063843,1.0347122876356316,64,110,14.258516311645508,9.3705415725708,64,18
1636,1,2.7985705437200803,2.7985705437200807,0.997900847731745,0.9979008477317463,0,0,2.799316644668579,2.799316644668579,1,1
1636,2,2.640044411362301,2.6400444113623003,0.9982520989183561,0.9982520989183574,0,0,3.009603977203369,2.799316644668579,2,2
1636,3,2.4137885851219427,2.413788585121943,0.9996673311512159,0.9996673311512165,0,0,3.460571527481079,2.799316644668579,3,3
1636,4,2.0437885409060947,2.043788540906095,1.0018322035448548,1.001832203544856,0,0,3.524104356765747,2.799316644668579,4,4
1636,8,1.90756175731156,1.9078997623251488,1.0024874827422758,1.0025353358647713,1,1,3.8812992572784424,2.799316644668579,7,7
1636,16,1.6425746261174812,1.736158281261806,1.0030144087588018,1.0033892222055996,5,9,4.100672245025635,2.799316644668579,11,7
1636,32,1.1938262842991145,1.6886755519237941,1.0025933288386077,1.003863182036783,15,21,4.460273742675781,2.799316644668579,17,11
1636,64,0.7500294800002677,1.656532516483377,1.0000923221296611,1.0047253026771865,34,51,4.944962501525879,2.799316644668579,30,13
1636,128,0.16122219612664865,1.630547241161413,0.999478999940218,1.004884778120577,64,116,5.534023284912109,2.799316644668579,64,12
1637,1,11.908992682048021,11.908992682048025,0.9136210770938993,0.9136210770939033,0,0,12.172799110412598,12.172799110412598,1,1
1637,2,9.542583841475713,9.542583841475713,0.974824469296308,0.974824469296309,0,0,12.536876678466797,12.172799110412598,2,2
1637,3,9.084085803048259,9.08408580304826,0.9855927463111689,0.9855927463111691,0,0,12.595823287963867,12.172799110412598,3,3
1637,4,8.601241580162977,8.601241580162975,0.9999094920562297,0.9999094920562297,0,0,12.869664192199707,12.172799110412598,4,4
1637,8,8.228006787703556,8.243968489264214,1.0133954009218957,1.0119190275638066,2,2,13.501487731933594,12.172799110412598,6,6
1637,16,7.9299044280423665,8.002493671199096,1.0270398343876765,1.0227378508529927,4,5,14.1432523727417,12.172799110412598,12,11
1637,32,6.855618361784873,7.829045024819809,1.0412555276474822,1.0340321404355466,10,18,14.696712493896484,12.172799110412598,22,14
1637,64,5.273678114897391,7.719996975823232,1.0286636091897876,1.038851433806281,29,47,15.528519630432129,12.172799110412598,35,17
1637,128,3.0733217682877285,7.5716407224650615,1.0083792835353285,1.0499924474345264,65,105,16.558937072753906,12.172799110412598,63,23
1638,1,6.849564729812988,6.849564729812988,0.9740189924530168,0.9740189924530172,0,0,6.895172595977783,6.895172595977783,1,1
1638,2,4.90938681288463,4.90938681288463,1.0015245783964353,1.0015245783964355,0,0,7.5939040184021,6.895172595977783,2,2
1638,3,4.483331302161814,4.483331302161814,1.0078516512315059,1.0078516512315054,0,0,8.222589492797852,6.895172595977783,3,3
1638,4,4.471062648485335,4.483331302161814,1.0069884842093488,1.0078516512315054,1,1,8.434052467346191,6.895172595977783,3,3
1638,8,4.16149067847857,4.236397771746551,1.0120935412757797,1.0122210199338364,2,3,9.077922821044922,6.895172595977783,6,5
1638,16,3.622073006438941,4.195077653765116,1.0075570113947894,1.0138386839932103,6,8,9.778022766113281,6.895172595977783,10,8
1638,32,3.2797686221288957,4.176199373754952,1.0088519405212861,1.0151930336479438,14,22,10.298123359680176,6.895172595977783,18,10
1638,64,2.1060486871034074,4.147327309503347,1.001143453553497,1.0179862548796623,32,52,11.096379280090332,6.895172595977783,32,12
1638,128,0.9996272462798047,4.135133462252684,0.9991914043960675,1.0191777795936487,62,114,11.837199211120605,6.895172595977783,66,14
1639,1,9.08297984214313,9.08297984214313,0.9467140667195256,0.9467140667195285,0,0,9.219527244567871,9.219527244567871,1,1
1639,2,7.526638354471365,7.5266383544713635,0.9784315364987726,0.9784315364987749,0,0,9.319738388061523,9.219527244567871,2,2
1639,3,6.481550052275763,6.481550052275764,0.9971774353431739,0.9971774353431756,0,0,9.336548805236816,9.219527244567871,3,3
1639,4,6.4596258082808165,6.4596258082808165,0.9970952859331393,0.9970952859331391,0,0,9.35327434539795,9.219527244567871,4,4
1639,8,5.019669928654718,5.215387396123807,1.0208364929645906,1.01870754361775,2,3,10.08408260345459,9.219527244567871,6,5
1639,16,4.562506905026134,5.0949188925738165,1.026136526150948,1.0230018805640513,5,6,10.569999694824219,9.219527244567871,11,10
1639,32,4.220051053814086,4.982619668609568,1.0320580778451767,1.0259277236003652,14,22,11.10666561126709,9.219527244567871,18,10
1639,64,3.592281192451221,4.946763729221412,1.0199925376472543,1.0291577118800377,30,52,11.761956214904785,9.219527244567871,34,12
1639,128,2.322022036518325,4.893609747965426,1.008474626583501,1.0337156084296308,59,111,12.4627685546875,9.219527244567871,69,17
1640,1,11.05787255999979,11.057872559999796,0.9412553585538745,0.9412553585538768,0,0,11.19763469696045,11.19763469696045,1,1
1640,2,8.31683437524719,8.31683437524719,1.005436863799631,1.005436863799631,0,0,11.733918190002441,11.19763469696045,2,2
1640,3,7.91479386552448,7.914793865524479,1.012351401362147,1.0123514013621482,0,0,11.74339771270752,11.19763469696045,3,3
1640,4,7.837006006758694,7.837006006758695,1.0144107368215332,1.014410736821534,0,0,11.914556503295898,11.19763469696045,4,4
1640,8,7.54889384750296,7.573891939179408,1.0213831378861207,1.021466173243982,1,1,12.31452751159668,11.19763469696045,7,7
1640,16,6.674046328568301,6.796698142552425,1.0411436710686381,1.040557806014744,6,6,12.769556999206543,11.19763469696045,10,10
1640,32,5.7232259837093284,6.503938634635738,1.043943189584293,1.050221603126938,12,18,13.532536506652832,11.19763469696045,20,14
1640,64,4.257912377014677,6.413719540437127,1.0280689520160318,1.056983367943734,28,44,14.373269081115723,11.19763469696045,36,20
1640,128,2.7468737192410786,6.3852868107443665,1.0097705339200764,1.0588060210911936,61,108,15.187939643859863,11.19763469696045,67,20
1641,1,6.350066163736736,6.350066163736739,0.9728762533522364,0.9728762533522376,0,0,6.403618812561035,6.403618812561035,1,1
1641,2,5.799316000952811,5.79931600095281,0.9813477149804786,0.9813477149804793,0,0,6.426382064819336,6.403618812561035,2,2
1641,3,5.123366390482734,5.123366390482734,0.9918278961049953,0.9918278961049953,0,0,6.78037691116333,6.403618812561035,3,3
1641,4,4.957202847316597,4.957388380846713,0.9957591667651382,0.9956871616133975,1,1,6.836833477020264,6.403618812561035,3,3
1641,8,4.100124427155478,4.100124427155478,1.0078119165011599,1.0078119165011594,0,0,7.1651811599731445,6.403618812561035,8,8
1641,16,3.5673340964926084,3.6254701286169864,1.014752271540606,1.0153919823503612,4,5,7.713028907775879,6.403618812561035,12,11
1641,32,2.959782453269784,3.44621404660252,1.0117849856030356,1.0184164352636615,10,19,8.209726333618164,6.403618812561035,22,13
1641,64,1.9706228487358313,3.3991332852448393,1.0060371086785662,1.0193803177485878,32,48,8.791217803955078,6.403618812561035,32,16
1641,128,0.9823652835803219,3.3164234624054676,1.0002332362365467,1.0220099303704973,69,110,9.525339126586914,6.403618812561035,59,18
1642,1,7.484602307833108,7.484602307833107,0.9618955475002333,0.9618955475002355,0,0,7.57008171081543,7.57008171081543,1,1
1642,2,6.755144236051665,6.755144236051665,0.9758816830875553,0.9758816830875565,0,0,8.125384330749512,7.57008171081543,2,2
1642,3,6.2698703365593556,6.269870336559356,0.9847951336977759,0.9847951336977763,0,0,8.139028549194336,7.57008171081543,3,3
1642,4,5.6550864140934936,5.655086414093494,0.9934465963179077,0.9934465963179089,0,0,8.144411087036133,7.57008171081543,4,4
1642,8,5.600606413382004,5.6271773130790494,0.994668292748021,0.9949904339919989,2,2,9.000618934631348,7.57008171081543,6,6
1642,16,4.307520570244456,4.672527023992452,1.0096763044175352,1.009100368327427,6,7,9.600313186645508,7.57008171081543,10,9
1642,32,3.9195676366182615,4.603601902873493,1.0120617889104762,1.0121904616834887,15,22,9.986248016357422,7.57008171081543,17,10
1642,64,2.8417438627876352,4.517421095539155,1.0112288207550366,1.0164839803159809,30,50,10.706195831298828,7.57008171081543,34,14
1642,128,1.7226764004861688,4.441465147202596,1.0021164720955906,1.021005173051825,65,111,11.563079833984375,7.57008171081543,63,17
1643,1,8.833486024076945,8.833486024076937,0.9500910528465215,0.9500910528465235,0,0,8.954760551452637,8.954760551452637,1,1
1643,2,7.937695440758794,7.937695440758793,0.9691305438375244,0.9691305438375261,0,0,9.066181182861328,8.954760551452637,2,2
1643,3,7.386790657510058,7.386790657510057,0.9816627773987923,0.9816627773987933,0,0,9.701574325561523,8.954760551452637,3,3
1643,4,7.111646025816775,7.111646025816774,0.9877535515962466,0.9877535515962468,0,0,9.737314224243164,8.954760551452637,4,4
1643,8,6.376587245357058,6.384616612595472,1.0020319981202999,1.0024373069593224,1,2,10.34374713897705,8.954760551452637,7,6
1643,16,6.118720936395031,6.167946618421856,1.0110023707227063,1.0121085833985686,3,5,10.863143920898438,8.954760551452637,13,11
1643,32,5.0843733004579885,5.865782152873009,1.0144685638980573,1.0218968339595234,16,19,11.51907730102539,8.954760551452637,16,13
1643,64,4.0023241648576215,5.548517436953934,1.0118386530945203,1.0282354758113328,30,50,12.340088844299316,8.954760551452637,34,14
1643,128,2.2266458709613968,5.508613282752109,1.0017294986209586,1.0334955950107638,64,110,13.175863265991211,8.954760551452637,64,18
1644,1,11.685884143948968,11.685884143948972,0.909733420835625,0.9097334208356265,0,0,12.000239372253418,12.000239372253418,1,1
1644,2,10.596551360709665,10.596551360709666,0.9435803438156848,0.9435803438156851,0,0,12.027084350585938,12.000239372253418,2,2
1644,3,10.107984432376663,10.107984432376663,0.9563452835293996,0.9563452835293995,0,0,12.74719524383545,12.000239372253418,3,3
1644,4,10.095290527891214,10.107984432376663,0.9555514188499538,0.9563452835293995,1,1,13.187431335449219,12.000239372253418,3,3
1644,8,9.681519851981259,9.766193277997985,0.9707161285408175,0.9717947605940633,3,3,13.508655548095703,12.000239372253418,5,5
1644,16,8.544918147053453,9.469705861955154,0.9865489263008915,0.9829838091123639,4,8,13.966333389282227,12.000239372253418,12,8
1644,32,6.899228813380787,8.651413522786202,1.016528851743262,1.0130491768318357,12,20,14.170897483825684,12.000239372253418,20,12
1644,64,5.2623045835013835,8.103706631629903,1.0305995457369121,1.0358478601018697,32,51,14.68946647644043,12.000239372253418,32,13
1644,128,2.8759666176256315,8.034641591087807,1.0087932053105306,1.0391983727027494,58,114,15.106122970581055,12.000239372253418,70,14
1645,1,2.746575038579152,2.746575038579151,0.9953787823045369,0.9953787823045376,0,0,2.750281572341919,2.750281572341919,1,1
1645,2,2.0292876346426576,2.029287634642657,0.9980798981982758,0.9980798981982753,0,0,3.0681052207946777,2.750281572341919,2,2
1645,3,2.010529632297503,2.010529632297503,0.9983284651055044,0.9983284651055039,0,0,3.2889580726623535,2.750281572341919,3,3
1645,4,1.9033800152299376,1.9033800152299376,0.9999203627890002,0.9999203627889995,0,0,3.323606014251709,2.750281572341919,4,4
1645,8,1.7572724617553592,1.7719564966456482,1.0009410131032739,1.000631587731758,1,2,4.060617923736572,2.750281572341919,7,6
1645,16,1.5521060396616688,1.6796133447487192,1.0017042984431543,1.0015695797159374,6,10,4.358657360076904,2.750281572341919,10,6
1645,32,1.2035035514319736,1.6353892772949963,1.0032545484900819,1.0021840139100662,14,25,4.917891025543213,2.750281572341919,18,7
1645,64,0.7178976519980192,1.6353892772949963,1.00161212143341,1.0021840139100662,33,57,5.359899044036865,2.750281572341919,31,7
1645,128,0.2061895536332235,1.6312727260719122,1.000447361867793,1.0026496149460782,56,119,5.842987537384033,2.750281572341919,72,9
1646,1,11.13728922926148,11.137289229261482,0.9242419070125328,0.9242419070125345,0,0,11.357881546020508,11.357881546020508,1,1
1646,2,9.942858082973665,9.942858082973666,0.9567663487425072,0.9567663487425083,0,0,12.031795501708984,11.357881546020508,2,2
1646,3,9.432151089401145,9.432151089401145,0.9736763549433624,0.9736763549433627,0,0,12.160238265991211,11.357881546020508,3,3
1646,4,9.139943024820079,9.13994302482008,0.9852288420616546,0.9852288420616551,0,0,12.788154602050781,11.357881546020508,4,4
1646,8,7.641218342051108,7.659422084688313,1.0232678174191072,1.0229014755940207,1,1,12.901094436645508,11.357881546020508,7,7
1646,16,7.338007274687622,7.429921209388066,1.0261265981535763,1.0285271989167102,5,6,13.066965103149414,11.357881546020508,11,10
1646,32,6.332248385057934,6.793155673828006,1.037865656249367,1.0442953642650816,13,17,13.861013412475586,11.357881546020508,19,15
1646,64,5.012975323174979,6.5466527718495815,1.031153876964677,1.0495707419718099,31,44,14.418673515319824,11.357881546020508,33,20
1646,128,3.5446629980815487,6.502166573039074,1.0161925196318355,1.0519958609188746,62,110,15.072589874267578,11.357881546020508,66,18
1647,1,2.6771613821333085,2.6771613821333085,0.9950963567210642,0.995096356721065,0,0,2.6814351081848145,2.6814351081848145,1,1
1647,2,2.494352454169298,2.494352454169298,0.9970709515288907,0.9970709515288911,0,0,3.3908016681671143,2.6814351081848145,2,2
1647,3,2.3853854950116324,2.3853854950116324,0.9984791966914963,0.9984791966914965,0,0,3.4313466548919678,2.6814351081848145,3,3
1647,4,2.3699160452531647,2.3699160452531642,0.9986731919237509,0.998673191923751,0,0,3.5630149841308594,2.6814351081848145,4,4
1647,8,1.9241739480336015,2.101871136948521,1.0007740730329675,1.0003210290232283,1,1,4.119339466094971,2.6814351081848145,7,7
1647,16,1.7749657287926188,2.0720615313347106,1.0021977994675404,1.0012673170644886,4,10,4.465664863586426,2.6814351081848145,12,6
1647,32,1.4742223731418345,1.9846288373820544,1.00250100700278,1.003041428002075,15,24,4.70861291885376,2.6814351081848145,17,8
1647,64,0.8303566515764255,1.9457626899705125,0.9995963898068355,1.003658107115219,28,54,5.102273464202881,2.6814351081848145,36,10
1647,128,0.1754525588865429,1.8762854211854287,0.9986344288469728,1.004920847113376,63,116,5.619500637054443,2.6814351081848145,65,12
1648,1,13.37067432800831,13.370674328008313,0.8809920642998895,0.8809920642998923,0,0,13.831924438476562,13.831924438476562,1,1
1648,2,10.76054188619858,10.760541886198581,0.9713525388187327,0.9713525388187332,0,0,15.083656311035156,13.831924438476562,2,2
1648,3,10.425331181781116,10.425331181781116,0.9834965137784731,0.9834965137784735,0,0,15.268580436706543,13.831924438476562,3,3
1648,4,10.106743585474536,10.106743585474536,0.9938679354993736,0.9938679354993755,0,0,15.438446044921875,13.831924438476562,4,4
1648,8,9.946367578120173,10.077853049079037,0.999028611972932,0.9957035487064835,1,2,15.755531311035156,13.831924438476562,7,6
1648,16,9.455938876228446,9.898154653784152,1.0127745229626532,1.002292980375786,7,7,15.99328899383545,13.831924438476562,9,9
1648,32,8.433475580791331,8.99158920294028,1.042830071580225,1.0397836914700829,13,19,16.367752075195312,13.831924438476562,19,13
1648,64,6.973451962720422,8.526429753694867,1.042853944193941,1.0593675060471401,27,48,16.744028091430664,13.831924438476562,37,16
1648,128,4.728220867058888,8.206711302945044,1.0219934164521356,1.0733895662870736,60,107,17.261995315551758,13.831924438476562,68,21
1649,1,2.7065078622818937,2.7065078622818937,0.9910823651735778,0.9910823651735783,0,0,2.7206366062164307,2.7206366062164307,1,1
1649,2,2.2967867466351977,2.2967867466351977,0.9952747622708491,0.9952747622708491,0,0,2.937662363052368,2.7206366062164307,2,2
1649,3,2.2242661877693766,2.2242661877693766,0.9966385625280867,0.9966385625280862,0,0,3.23917293548584,2.7206366062164307,3,3
1649,4,2.061471465568006,2.061471465568006,0.9979448266628823,0.9979448266628821,0,0,3.588735342025757,2.7206366062164307,4,4
1649,8,1.9588228375929466,1.9592801603936392,0.9992834889005666,0.9992965546063783,1,1,3.669172763824463,2.7206366062164307,7,7
1649,16,1.7337208119640817,1.7866954453357913,1.000587541859333,1.0011174092876691,4,8,4.041138648986816,2.7206366062164307,12,8
1649,32,1.3110496257040867,1.72262409071136,1.0003542439247908,1.0017545566566817,12,19,4.3775434494018555,2.7206366062164307,20,13
1649,64,0.7300232007615616,1.6934492684282159,0.9982080652610666,1.0021978880319686,31,53,4.707739353179932,2.7206366062164307,33,11
1649,128,0.12225157945297707,1.553547727963358,0.998388187546035,1.0046197393056757,63,112,5.061262607574463,2.7206366062164307,65,16
1650,1,10.367000613809815,10.367000613809815,0.9287646319792972,0.928764631979298,0,0,10.583940505981445,10.583940505981445,1,1
1650,2,8.78816704870439,8.78816704870439,0.9623043218088785,0.9623043218088796,0,0,10.624330520629883,10.583940505981445,2,2
1650,3,8.766105278891594,8.766105278891594,0.9636861332992199,0.9636861332992211,0,0,11.311593055725098,10.583940505981445,3,3
1650,4,8.120522311272957,8.120522311272957,0.9854264301522843,0.9854264301522845,0,0,11.93260383605957,10.583940505981445,4,4
1650,8,7.491310185687616,7.5452056495505095,1.0024463833366848,1.0019000214265952,2,2,12.17297077178955,10.583940505981445,6,6
1650,16,7.115541626495209,7.477323016222755,1.0049773073525332,1.005401260189537,8,10,12.782820701599121,10.583940505981445,8,6
1650,32,6.382376883372029,7.369523414450611,1.0117147012198142,1.01030889521851,17,23,13.37210464477539,10.583940505981445,15,9
1650,64,5.4207868329514675,7.334315478631432,1.0091718824081706,1.0132139761952523,37,53,13.979851722717285,10.583940505981445,27,11
1650,128,3.2552531903411595,7.079198986049375,1.002525607338436,1.0268205552863856,65,115,14.691068649291992,10.583940505981445,63,13
1651,1,11.89502611674684,11.89502611674684,0.903150167181667,0.9031501671816675,0,0,12.243305206298828,12.243305206298828,1,1
1651,2,10.747083303417629,10.747083303417629,0.9342579208357947,0.934257920835797,0,0,12.59575080871582,12.243305206298828,2,2
1651,3,9.761417463425753,9.761417463425754,0.9625662208514533,0.9625662208514527,0,0,12.893606185913086,12.243305206298828,3,3
1651,4,9.750378293531556,9.750378293531556,0.9626554981120163,0.9626554981120162,0,0,12.93345832824707,12.243305206298828,4,4
1651,8,9.46034650267473,9.507238326733768,0.9692906154766348,0.9688496938669764,3,4,13.467982292175293,12.243305206298828,5,4
1651,16,7.939998832167731,8.486462325525412,1.0153834750807569,1.0059413336328236,6,8,13.833537101745605,12.243305206298828,10,8
1651,32,7.198797152067623,8.321410996591478,1.0220966945965597,1.0136154700096545,15,24,14.214394569396973,12.243305206298828,17,8
1651,64,5.699358577775583,8.300345040261538,1.015125823190858,1.0152400186032569,29,53,14.5260591506958,12.243305206298828,35,11
1651,128,3.4357846820734594,8.08530324539175,1.0073549476181736,1.0213619906659104,62,115,15.018447875976562,12.243305206298828,66,13
1652,1,5.410927481896696,5.410927481896695,0.9901186786727395,0.9901186786727404,0,0,5.419307231903076,5.419307231903076,1,1
1652,2,3.955568033517313,3.955568033517313,1.0058301115445583,1.005830111544559,0,0,6.362728118896484,5.419307231903076,2,2
1652,3,3.5833369783098514,3.5833369783098514,1.0101262270508813,1.0101262270508808,0,0,6.463832378387451,5.419307231903076,3,3
1652,4,3.5761092563792753,3.5761092563792762,1.0104652103995386,1.0104652103995395,0,0,6.591188907623291,5.419307231903076,4,4
1652,8,3.2140345318556727,3.4780409310813503,1.0113644495576344,1.0125769159561193,3,3,7.206103324890137,5.419307231903076,5,5
1652,16,2.8212920240633905,3.4367974225765225,1.009593268086153,1.0143229365295339,7,10,7.6125054359436035,5.419307231903076,9,6
1652,32,2.295255962566159,3.2850394951319344,1.0084175624617093,1.0182064325419695,15,23,8.109518051147461,5.419307231903076,17,9
1652,64,1.4823115084536993,3.281497892227836,1.0021117943529512,1.018311279219716,31,54,8.589648246765137,5.419307231903076,33,10
1652,128,0.6816564123083824,3.240970567624305,0.9993396050605208,1.0201703474907777,63,116,9.227957725524902,5.419307231903076,65,12
1653,1,11.962194649118489,11.96219464911849,0.9119118604930085,0.9119118604930111,0,0,12.252406120300293,12.252406120300293,1,1
1653,2,10.356819653417089,10.356819653417089,0.9593258956688187,0.9593258956688191,0,0,12.514623641967773,12.252406120300293,2,2
1653,3,9.78841063704928,9.788410637049278,0.9770153913473829,0.9770153913473837,0,0,12.903430938720703,12.252406120300293,3,3
1653,4,9.067164082236202,9.0671640822362,0.9997077215930879,0.9997077215930893,0,0,12.925103187561035,12.252406120300293,4,4
1653,8,8.80184317477225,8.828935415134374,1.0052828098491786,1.0053231303999683,2,2,13.268714904785156,12.252406120300293,6,6
1653,16,7.308413999433358,8.159966785574147,1.0370941005334589,1.025592268181995,6,7,13.7798433303833,12.252406120300293,10,9
1653,32,6.580272452808512,8.002196443367774,1.0385206023963303,1.031754188749673,11,22,14.45377254486084,12.252406120300293,21,10
1653,64,5.227342077028175,7.947966574723852,1.0277194203396658,1.0345648102524923,30,52,14.97380256652832,12.252406120300293,34,12
1653,128,2.9217238197876867,7.761036766334828,1.008319176747275,1.0440351295104433,58,110,15.406878471374512,12.252406120300293,70,18
1654,1,6.7499606917837,6.749960691783701,0.9711614015806787,0.9711614015806806,0,0,6.804903984069824,6.804903984069824,1,1
1654,2,5.448353683144998,5.4483536831449975,0.9909532191568655,0.9909532191568668,0,0,7.1741251945495605,6.804903984069824,2,2
1654,3,4.892797439673045,4.892797439673045,1.0020712709251858,1.0020712709251864,0,0,8.148504257202148,6.804903984069824,3,3
1654,4,4.8927089467217835,4.892708946721783,1.0021363653662962,1.0021363653662974,0,0,8.506393432617188,6.804903984069824,4,4
1654,8,4.6054957781658,4.633296779650892,1.0098109295961355,1.0108684514758441,2,3,9.166362762451172,6.804903984069824,6,5
1654,16,3.867129551038155,4.311333946644082,1.014452799811441,1.017037869713651,5,6,9.679485321044922,6.804903984069824,11,10
1654,32,3.4423619853303986,4.229146000448628,1.0123283533633192,1.0198955862310188,13,20,10.452277183532715,6.804903984069824,19,12
1654,64,2.6958087944828293,4.152739348041155,1.0070075293846863,1.0231731653981067,32,50,11.310794830322266,6.804903984069824,32,14
1654,128,1.3297762137438223,4.1442844330522055,0.9994918479964677,1.0240351344688934,64,113,12.409271240234375,6.804903984069824,64,15
1655,1,7.231981869067574,7.231981869067574,0.9701360462767203,0.9701360462767218,0,0,7.287712097167969,7.287712097167969,1,1
1655,2,6.20104889009971,6.201048890099711,0.9865644889268468,0.9865644889268481,0,0,7.837510108947754,7.287712097167969,2,2
1655,3,5.985260238279772,5.985260238279774,0.9891170315546369,0.9891170315546376,0,0,8.1515531539917,7.287712097167969,3,3
1655,4,5.325104908691303,5.325104908691304,1.0001403455830968,1.0001403455830973,0,0,8.247452735900879,7.287712097167969,4,4
1655,8,5.122438885690968,5.17207224049451,1.0028884448713087,1.0032237091191742,2,2,8.714325904846191,7.287712097167969,6,6
1655,16,4.650269998752342,4.8092485424341564,1.015329051539629,1.0154806296807997,4,6,9.13414192199707,7.287712097167969,12,10
1655,32,3.8303198560436384,4.620458124290234,1.013630198595782,1.0180324782630856,13,17,9.821877479553223,7.287712097167969,19,15
1655,64,2.994434023543058,4.431081482561196,1.0062333178809006,1.0222375847157703,30,48,10.367056846618652,7.287712097167969,34,16
1655,128,1.7106373547691192,4.378606775017858,1.0015367920451799,1.0252983981255073,60,111,10.98911190032959,7.287712097167969,68,17
1656,1,10.397120957036785,10.397120957036783,0.9345016198257696,0.9345016198257716,0,0,10.577531814575195,10.577531814575195,1,1
1656,2,8.364145349840078,8.364145349840076,0.9846999507684325,0.9846999507684331,0,0,11.268997192382812,10.577531814575195,2,2
1656,3,7.936971523093748,7.936971523093747,0.9945071638638117,0.9945071638638121,0,0,11.418829917907715,10.577531814575195,3,3
1656,4,7.69755038054251,7.69755038054251,1.000381745610295,1.0003817456102948,0,0,11.848615646362305,10.577531814575195,4,4
1656,8,6.821634458876987,6.871483367164738,1.021163388105908,1.0204421686511038,1,1,11.999238014221191,10.577531814575195,7,7
1656,16,6.0933120117251836,6.571547834932553,1.0344780471245063,1.0300890325168446,3,5,12.268404006958008,10.577531814575195,13,11
1656,32,5.679530891283855,6.47496990629689,1.033214512542828,1.0322440514038944,11,17,12.781146049499512,10.577531814575195,21,15
1656,64,4.431028001605088,6.365160605503648,1.025810006655726,1.036467029793183,28,48,13.560759544372559,10.577531814575195,36,16
1656,128,2.8468113681086047,6.236531737421299,1.0063692002089115,1.0435794442927901,62,107,14.184910774230957,10.577531814575195,66,21
1657,1,5.817604292262588,5.817604292262587,0.9825316350572251,0.9825316350572264,0,0,5.842162132263184,5.842162132263184,1,1
1657,2,5.21783161648317,5.21783161648317,0.9927479492820327,0.9927479492820335,0,0,6.640681266784668,5.842162132263184,2,2
1657,3,5.052545076456652,5.052545076456653,0.9945286668904969,0.9945286668904977,0,0,7.039990425109863,5.842162132263184,3,3
1657,4,4.894026825411846,4.894026825411846,0.9970062978404345,0.9970062978404355,0,0,7.225366592407227,5.842162132263184,4,4
1657,8,4.792129675027365,4.8892126114292545,0.9984268895904973,0.9972517056494943,3,3,7.585270881652832,5.842162132263184,5,5
1657,16,3.7457774846060983,4.6218323713941265,1.0015159288900193,1.001018520886834,7,10,8.063830375671387,5.842162132263184,9,6
1657,32,2.891479077665053,4.23424723327063,1.0034147893705776,1.0085697379137717,17,26,8.756569862365723,5.842162132263184,15,6
1657,64,2.2661305269725482,4.231931139639303,1.003031162800528,1.008849823858497,31,56,9.27131462097168,5.842162132263184,33,8
1657,128,1.0151975344651472,4.175127883216869,0.9990177061711444,1.0108802486619497,64,122,10.07671070098877,5.842162132263184,64,6
1658,1,8.254059470488476,8.254059470488478,0.9502851310730643,0.9502851310730672,0,0,8.386007308959961,8.386007308959961,1,1
1658,2,7.2928009618258365,7.292800961825837,0.9722235320327908,0.9722235320327927,0,0,9.958105087280273,8.386007308959961,2,2
1658,3,7.199830494166092,7.199830494166093,0.9772097467629858,0.9772097467629874,0,0,10.485316276550293,8.386007308959961,3,3
1658,4,6.48250995481062,6.487718044559693,0.9961061315915165,0.9964621887607108,1,1,10.544706344604492,8.386007308959961,3,3
1658,8,5.677531958613543,5.798592723184012,1.0103397845688868,1.0126358653436678,2,2,10.96359634399414,8.386007308959961,6,6
1658,16,5.24204350385786,5.719949261926909,1.0172592299103536,1.0164017300998105,6,9,11.372876167297363,8.386007308959961,10,7
1658,32,4.798855142749879,5.678593070862429,1.019388152473739,1.0189852868432836,15,23,12.019937515258789,8.386007308959961,17,9
1658,64,4.123308807645371,5.610690049791962,1.0153180495590384,1.023456573870285,30,53,12.995327949523926,8.386007308959961,34,11
1658,128,2.8443516483235176,5.568725800059757,1.0059889981947694,1.0279120751951174,61,115,13.922257423400879,8.386007308959961,67,13
1659,1,8.378247207497507,8.378247207497507,0.9615211014184737,0.9615211014184744,0,0,8.456819534301758,8.456819534301758,1,1
1659,2,6.4059729392485965,6.405972939248596,0.999034399717833,0.9990343997178326,0,0,8.727002143859863,8.456819534301758,2,2
1659,3,6.0907337941914035,6.090733794191403,1.0060954331301302,1.0060954331301302,0,0,9.283632278442383,8.456819534301758,3,3
1659,4,6.048007123193738,6.048007123193738,1.0073789518904301,1.0073789518904301,0,0,9.411694526672363,8.456819534301758,4,4
1659,8,5.35730643644203,5.367845415652406,1.021141540804628,1.0210972844652608,2,2,10.187307357788086,8.456819534301758,6,6
1659,16,4.732823446587028,4.890342337106095,1.0270396691219679,1.0288582781020772,5,6,10.722458839416504,8.456819534301758,11,10
1659,32,4.448638864231757,4.792996957141794,1.0318916730740137,1.033084654074921,14,16,11.308428764343262,8.456819534301758,18,16
1659,64,3.5836759471633277,4.785086560533368,1.024276898309932,1.0344613681774848,30,46,12.008044242858887,8.456819534301758,34,18
1659,128,2.204681050003615,4.776995798163713,1.0048516509253118,1.035076876158728,55,108,12.739518165588379,8.456819534301758,73,20
1660,1,5.410877129897997,5.4108771298979965,0.9860309915793606,0.9860309915793605,0,0,5.427508354187012,5.427508354187012,1,1
1660,2,4.682425286564394,4.682425286564393,0.9937822846898006,0.9937822846898006,0,0,5.973819732666016,5.427508354187012,2,2
1660,3,4.231932957684224,4.231932957684223,0.9979221504540523,0.997922150454053,0,0,6.061685562133789,5.427508354187012,3,3
1660,4,3.5525270999621825,3.5525270999621825,1.0043678085962395,1.0043678085962395,0,0,6.350935459136963,5.427508354187012,4,4
1660,8,3.3211351006363348,3.321445172398838,1.006088149834876,1.0061238903120282,1,1,6.5915961265563965,5.427508354187012,7,7
1660,16,2.670459454103429,2.868506275228807,1.0114766477769837,1.0105885367928922,5,9,7.131601810455322,5.427508354187012,11,7
1660,32,2.3150356152491223,2.813702960314356,1.0101955263034936,1.0125356270802508,14,21,7.642314434051514,5.427508354187012,18,11
1660,64,1.6041477972793332,2.7879015862420693,1.0033580958960593,1.013874994987106,35,54,8.23501968383789,5.427508354187012,29,10
1660,128,0.8012025105039549,2.781844149419514,0.998452654723651,1.0142506326181953,66,115,8.844345092773438,5.427508354187012,62,13
1661,1,3.3281774011208016,3.328177401120801,0.9909772595347196,0.9909772595347202,0,0,3.3399431705474854,3.3399431705474854,1,1
1661,2,2.9127635719107468,2.9127635719107468,0.9940057342795003,0.9940057342795008,0,0,3.460493326187134,3.3399431705474854,2,2
1661,3,2.306614821288887,2.306614821288887,0.9986743122979027,0.9986743122979032,0,0,3.5112223625183105,3.3399431705474854,3,3
1661,4,2.2981477188205495,2.2981477188205495,0.998695132454334,0.9986951324543337,0,0,3.549149990081787,3.3399431705474854,4,4
1661,8,2.0778429383470995,2.1547156583546676,0.9996826141378079,0.9999018482762068,2,2,4.091761112213135,3.3399431705474854,6,6
1661,16,1.7402220302044022,1.998821242600631,1.0013234468641052,1.0017848201950814,6,5,4.446263313293457,3.3399431705474854,10,11
1661,32,1.2029675152441752,1.929505290178775,0.9995357723461455,1.0028819545828185,16,20,4.978179454803467,3.3399431705474854,16,12
1661,64,0.7357623591692701,1.8686280487389397,0.9993983823669758,1.0040712196967703,29,52,5.642281532287598,3.3399431705474854,35,12
1661,128,0.09332169170835969,1.8673746292655458,0.998298963240156,1.0043473910120568,64,115,6.547919273376465,3.3399431705474854,64,13
1662,1,8.294025341650036,8.29402534165003,0.9626527843384821,0.9626527843384847,0,0,8.367744445800781,8.367744445800781,1,1
1662,2,7.3833934476758705,7.3833934476758705,0.9785229856461507,0.9785229856461525,0,0,8.424585342407227,8.367744445800781,2,2
1662,3,7.029734859160447,7.029734859160447,0.9858078443900384,0.9858078443900403,0,0,8.725482940673828,8.367744445800781,3,3
1662,4,6.912942037149727,6.912942037149727,0.9881678996576098,0.988167899657612,0,0,8.782756805419922,8.367744445800781,4,4
1662,8,6.001691171577264,6.057805963979443,1.005697534903078,1.0039887595505061,1,1,8.927511215209961,8.367744445800781,7,7
1662,16,5.3126358307285075,5.6561153760360545,1.0127580718527947,1.0105422003940092,5,8,9.637950897216797,8.367744445800781,11,8
1662,32,4.114179143325842,4.87776355169037,1.0177192323232236,1.0269535959936902,14,21,10.213678359985352,8.367744445800781,18,11
1662,64,3.154475777396439,4.796020814966651,1.0183710021192538,1.0310599474441458,28,47,11.063154220581055,8.367744445800781,36,17
1662,128,2.0581102795575585,4.739532007108249,1.0042602483386496,1.0340811621902541,60,110,11.888742446899414,8.367744445800781,68,18
1663,1,10.729517089135372,10.729517089135378,0.9306055214611575,0.9306055214611609,0,0,10.922932624816895,10.922932624816895,1,1
1663,2,8.594675275637224,8.594675275637224,0.9882444641981114,0.9882444641981134,0,0,11.43435287475586,10.922932624816895,2,2
1663,3,8.430934355311669,8.430934355311669,0.9936366801896366,0.9936366801896395,0,0,11.859732627868652,10.922932624816895,3,3
1663,4,8.173656192396646,8.173656192396649,1.0034400433281012,1.0034400433281034,0,0,12.141462326049805,10.922932624816895,4,4
1663,8,7.284190404542847,7.350566464949148,1.0221760637291808,1.0216452772936047,1,1,12.807000160217285,10.922932624816895,7,7
1663,16,6.413165313862435,7.020756750094317,1.0340643060761385,1.0337998080963953,6,8,13.656954765319824,10.922932624816895,10,8
1663,32,5.545619358261674,6.805764753684554,1.0446692518315799,1.0460098415975336,15,18,14.227925300598145,10.922932624816895,17,14
1663,64,4.511544387587646,6.665445907395266,1.0297841722599375,1.0525978344284213,30,48,14.959061622619629,10.922932624816895,34,16
1663,128,2.9667494360546827,6.601301597885742,1.008614462905981,1.0575669751830414,61,107,15.936777114868164,10.922932624816895,67,21
1664,1,12.523120153627927,12.523120153627927,0.9060930758462487,0.9060930758462516,0,0,12.839818954467773,12.839818954467773,1,1
1664,2,12.02096284135659,12.02096284135659,0.9242154088732155,0.9242154088732162,0,0,13.019076347351074,12.839818954467773,2,2
1664,3,11.135655046875751,11.135655046875751,0.9506879812687614,0.9506879812687612,0,0,13.064067840576172,12.839818954467773,3,3
1664,4,10.230217265547559,10.230217265547559,0.9758723643820395,0.9758723643820397,0,0,13.27077865600586,12.839818954467773,4,4
1664,8,9.618087315519832,9.619647693016182,0.992749145213855,0.9927035651520638,2,2,14.146162033081055,12.839818954467773,6,6
1664,16,8.214072753778984,8.686430220878474,1.0298344468360963,1.027153683850812,7,6,14.746512413024902,12.839818954467773,9,10
1664,32,7.318483237089053,8.46894558002682,1.036002802889998,1.0383602868205788,12,19,15.437479972839355,12.839818954467773,20,13
1664,64,5.142509918735854,8.21895717759764,1.0159868778392613,1.0447662200185046,31,53,16.062955856323242,12.839818954467773,33,11
1664,128,2.9720458914130234,8.169959490383338,1.0037325151276764,1.0512958145272833,65,114,17.00303077697754,12.839818954467773,63,14
1665,1,10.24165327461889,10.24165327461889,0.9261499978902953,0.9261499978902968,0,0,10.47309398651123,10.47309398651123,1,1
1665,2,8.641672000201796,8.641672000201796,0.966475913514849,0.9664759135148495,0,0,10.945048332214355,10.47309398651123,2,2
1665,3,8.526939050188263,8.526939050188263,0.9708515240724693,0.9708515240724694,0,0,10.990464210510254,10.47309398651123,3,3
1665,4,8.416774282007736,8.416774282007736,0.9723651928223457,0.9723651928223461,0,0,11.056313514709473,10.47309398651123,4,4
1665,8,7.910080525158299,7.910296421297805,0.9890811053013754,0.9891272221650048,2,2,12.23862075805664,10.47309398651123,6,6
1665,16,6.999931925992794,7.078066740909868,1.0154624604209468,1.0158634509856161,5,6,12.815811157226562,10.47309398651123,11,10
1665,32,5.501397745865735,7.042898707662426,1.0182056822142034,1.017976345739266,13,19,13.495077133178711,10.47309398651123,19,13
1665,64,4.218165343267842,6.641894078194206,1.0196328606694327,1.038053492155862,30,44,14.362702369689941,10.47309398651123,34,20
1665,128,3.014839181997936,6.5772779619923805,1.0096910360139568,1.0419081996654174,58,109,15.061582565307617,10.47309398651123,70,19
1666,1,5.796729864073839,5.796729864073841,0.9836110712034499,0.9836110712034527,0,0,5.817017555236816,5.817017555236816,1,1
1666,2,4.70354978094756,4.70354978094756,0.9988019782768431,0.9988019782768446,0,0,6.47021484375,5.817017555236816,2,2
1666,3,4.521105891142097,4.521105891142097,0.9997506048265858,0.9997506048265861,0,0,6.660689830780029,5.817017555236816,3,3
1666,4,4.52103497820546,4.521034978205459,0.99977181700771,0.9997718170077093,0,0,6.763840675354004,5.817017555236816,4,4
1666,8,4.223228357212249,4.286237165551167,1.004179491898229,1.0052545806659021,2,3,7.933516025543213,5.817017555236816,6,5
1666,16,3.860892583744604,3.943393805619178,1.0135977625399772,1.0157181152619954,5,7,8.27505111694336,5.817017555236816,11,9
1666,32,3.2194419920356547,3.817557333879828,1.0106154097904163,1.0198268539939799,14,20,9.11854362487793,5.817017555236816,18,12
1666,64,2.6067967516235178,3.759649971931671,1.0093060052703127,1.0227918966086855,34,48,10.104107856750488,5.817017555236816,30,16
1666,128,1.5618960129967334,3.744809027861382,0.9989406377890054,1.024037944528044,61,108,10.97071647644043,5.817017555236816,67,20
1667,1,9.488101797435753,9.488101797435752,0.938245217216406,0.9382452172164074,0,0,9.664237022399902,9.664237022399902,1,1
1667,2,7.941034480198654,7.941034480198654,0.9740442560217142,0.9740442560217144,0,0,10.12452220916748,9.664237022399902,2,2
1667,3,7.62331359815973,7.623313598159732,0.9823122274868465,0.982312227486847,0,0,10.492438316345215,9.664237022399902,3,3
1667,4,6.752129239581758,6.752129239581758,0.9998290023722993,0.9998290023723002,0,0,10.546639442443848,9.664237022399902,4,4
1667,8,6.472527486002501,6.475090557526922,1.0055326884324687,1.0056620548161694,1,1,11.150483131408691,9.664237022399902,7,7
1667,16,5.397766455541923,5.871380746988685,1.025843333145833,1.0245208726686408,5,7,11.858582496643066,9.664237022399902,11,9
1667,32,4.689080334167441,5.867577527274615,1.0184240940693086,1.0249203170217913,15,22,12.231139183044434,9.664237022399902,17,10
1667,64,3.9810302790330288,5.847595992673831,1.0135472482890275,1.026534646432197,31,52,12.728662490844727,9.664237022399902,33,12
1667,128,2.725482505066439,5.751675023057011,1.0017502349215435,1.0333810972299888,63,112,13.483097076416016,9.664237022399902,65,16
1668,1,10.062401512029199,10.062401512029194,0.9461313127519047,0.9461313127519063,0,0,10.18701457977295,10.18701457977295,1,1
1668,2,7.7047775333483015,7.704777533348303,0.9959733728064759,0.995973372806477,0,0,10.218847274780273,10.18701457977295,2,2
1668,3,7.386028854259173,7.386028854259172,1.002308789200072,1.0023087892000728,0,0,10.790963172912598,10.18701457977295,3,3
1668,4,7.210866695217495,7.210866695217496,1.0087662537731237,1.008766253773124,0,0,11.185647964477539,10.18701457977295,4,4
1668,8,6.64416872597899,6.64416872597899,1.0224941351187855,1.022494135118785,0,0,11.51488208770752,10.18701457977295,8,8
1668,16,6.237557271014044,6.51475475906894,1.028308836083104,1.0266889978386808,4,6,12.02484130859375,10.18701457977295,12,10
1668,32,5.064602464122014,5.9113355527778255,1.03934797330883,1.0438692299988825,10,16,12.514444351196289,10.18701457977295,22,16
1668,64,4.03490067584645,5.905433409137494,1.0303356371828052,1.0445060251976896,29,45,12.910835266113281,10.18701457977295,35,19
1668,128,3.0026967869963594,5.8287105833595945,1.018119867205936,1.04895917059945,67,107,13.697837829589844,10.18701457977295,61,21
1669,1,9.150043513858572,9.150043513858577,0.9499421667854882,0.9499421667854907,0,0,9.272055625915527,9.272055625915527,1,1
1669,2,7.604436749022823,7.604436749022827,0.9808794763841668,0.9808794763841693,0,0,9.532154083251953,9.272055625915527,2,2
1669,3,7.372912888458306,7.372912888458306,0.985336946406296,0.9853369464062975,0,0,9.555867195129395,9.272055625915527,3,3
1669,4,7.018386181280837,7.018386181280837,0.9943094196776094,0.9943094196776104,0,0,10.407955169677734,9.272055625915527,4,4
1669,8,6.963241278985607,7.003888455081273,0.9952832294988821,0.9958212319890339,2,2,10.97789192199707,9.272055625915527,6,6
1669,16,6.544709424053547,6.66710903501543,1.0092492043663182,1.0086937187880496,4,5,11.451360702514648,9.272055625915527,12,11
1669,32,5.619213030959411,6.506839367342999,1.018062308305146,1.0171636517838683,7,16,12.0795259475708,9.272055625915527,25,16
1669,64,3.9738228838932503,6.264647323841304,1.0099571220124008,1.0275920992748142,28,48,12.7524995803833,9.272055625915527,36,16
1669,128,2.6298912857296353,6.207153243658339,0.9997172096174008,1.0312082851429936,64,107,13.472071647644043,9.272055625915527,64,21
1670,1,7.158962788198503,7.1589627881985045,0.9689596741720077,0.9689596741720096,0,0,7.220383644104004,7.220383644104004,1,1
1670,2,5.3626395161726705,5.3626395161726705,0.9995188285753187,0.9995188285753205,0,0,7.279263019561768,7.220383644104004,2,2
1670,3,5.050068559750063,5.050068559750064,1.005907286825833,1.0059072868258339,0,0,7.385185718536377,7.220383644104004,3,3
1670,4,4.452014330520358,4.452014330520358,1.011623532885605,1.0116235328856054,0,0,7.586565017700195,7.220383644104004,4,4
1670,8,3.9789574723436756,3.985940610184618,1.019157372350247,1.0191391960109208,1,1,8.602494239807129,7.220383644104004,7,7
1670,16,3.59495984934157,3.892132266833421,1.017172201151407,1.020511944886633,6,8,9.250539779663086,7.220383644104004,10,8
1670,32,3.1503303629908213,3.8795370606153403,1.0138373948410042,1.0208637519155543,14,23,9.904348373413086,7.220383644104004,18,9
1670,64,2.5843712275160273,3.8631657139279683,1.0085779235054562,1.0224563790458485,26,53,10.601234436035156,7.220383644104004,38,11
1670,128,1.5778447598380423,3.780784177421786,1.001549154757562,1.0271088885355901,63,115,11.353955268859863,7.220383644104004,65,13
1671,1,8.663459945002918,8.663459945002918,0.9563171663164601,0.9563171663164626,0,0,8.761746406555176,8.761746406555176,1,1
1671,2,7.246055121254007,7.246055121254008,0.9837875286064687,0.9837875286064695,0,0,8.78015422821045,8.761746406555176,2,2
1671,3,5.806353701140684,5.806353701140684,1.0037369687860425,1.0037369687860438,0,0,9.372239112854004,8.761746406555176,3,3
1671,4,5.330121659699567,5.330121659699567,1.0122838477518854,1.0122838477518858,0,0,9.387723922729492,8.761746406555176,4,4
1671,8,4.847551179179189,4.8646892484965845,1.0189693369114525,1.019409043996378,1,1,9.558537483215332,8.761746406555176,7,7
1671,16,4.564141354288691,4.6095422841410185,1.0263622868428028,1.0263106656431749,4,4,10.283506393432617,8.761746406555176,12,12
1671,32,4.088382044114051,4.531458308239987,1.0241959062737669,1.0284869155985126,11,16,11.14358139038086,8.761746406555176,21,16
1671,64,3.0778899548111833,4.515801370088757,1.013287326288965,1.0293921936363113,28,47,11.797719955444336,8.761746406555176,36,17
1671,128,1.8163655775195298,4.494078029317617,1.0038144946308094,1.031773846806212,64,108,12.598971366882324,8.761746406555176,64,20
1672,1,6.615481316521688,6.61548131652169,0.9714940839231101,0.9714940839231129,0,0,6.672995567321777,6.672995567321777,1,1
1672,2,5.014740896635695,5.014740896635695,1.0007313384516714,1.0007313384516732,0,0,7.867859840393066,6.672995567321777,2,2
1672,3,4.588667445548904,4.5886674455489045,1.0053431816181901,1.0053431816181921,0,0,7.918594837188721,6.672995567321777,3,3
1672,4,4.51456051562118,4.514560515621181,1.0065044338294473,1.00650443382945,0,0,7.94385290145874,6.672995567321777,4,4
1672,8,4.478838974745959,4.478888188444698,1.0074788054244639,1.0074668268148281,1,1,8.365102767944336,6.672995567321777,7,7
1672,16,4.207003411177063,4.330195670111688,1.0116173396978771,1.011876114686701,3,5,9.174803733825684,6.672995567321777,13,11
1672,32,3.280781756204088,4.090055400606515,1.0118309667625103,1.016080405645242,13,17,9.982488632202148,6.672995567321777,19,15
1672,64,2.411037215547283,3.9948802375542103,1.0005215099887232,1.0183805366348253,32,49,10.896584510803223,6.672995567321777,32,15
1672,128,1.4368091988781988,3.9229278420662306,0.9968260553247655,1.02240874489289,62,113,11.887272834777832,6.672995567321777,66,15
1673,1,7.99393261150035,7.993932611500348,0.9616193715613874,0.9616193715613883,0,0,8.07863712310791,8.07863712310791,1,1
1673,2,5.990961756782187,5.990961756782187,0.9984746828207002,0.9984746828206998,0,0,8.571991920471191,8.07863712310791,2,2
1673,3,5.735705526392605,5.735705526392605,1.001873959180032,1.0018739591800314,0,0,8.692717552185059,8.07863712310791,3,3
1673,4,5.446696424555499,5.446696424555499,1.0053854612957016,1.0053854612957012,0,0,8.774576187133789,8.07863712310791,4,4
1673,8,4.686493236820122,4.726018026208608,1.018853492470075,1.0180655597913302,1,2,9.06247615814209,8.07863712310791,7,6
1673,16,4.57081519209147,4.647363880106785,1.0202321110609383,1.0209107585637995,5,7,9.680548667907715,8.07863712310791,11,9
1673,32,3.9802770818646884,4.510285763372822,1.0233526287926682,1.0262972412513414,11,16,10.48974323272705,8.07863712310791,21,16
1673,64,2.6443627303223245,4.496167289239243,1.0165092175883759,1.0274049700748333,28,49,11.193198204040527,8.07863712310791,36,15
1673,128,1.3936061039411758,4.447297700580843,1.0030739904070671,1.0293712828774975,68,109,11.930309295654297,8.07863712310791,60,19
1674,1,3.3310859560597565,3.3310859560597565,0.9928691657370662,0.9928691657370671,0,0,3.3384134769439697,3.3384134769439697,1,1
1674,2,2.7658687849345287,2.765868784934529,0.9962063390414169,0.996206339041417,0,0,3.522808313369751,3.3384134769439697,2,2
1674,3,2.7395400007768895,2.739540000776889,0.996634698115558,0.9966346981155585,0,0,3.8399133682250977,3.3384134769439697,3,3
1674,4,2.6919687392710983,2.6919687392710987,0.996725868634945,0.9967258686349455,0,0,3.95619535446167,3.3384134769439697,4,4
1674,8,2.4923299663960456,2.5066144155644987,0.9990188625188374,0.9990645974885214,2,2,4.100543022155762,3.3384134769439697,6,6
1674,16,2.171616011977732,2.5052600461908656,0.9993449857064202,0.9989905361600366,5,9,4.410073280334473,3.3384134769439697,11,7
1674,32,1.3855379444684641,2.3840738505445542,0.9975424432110094,1.0005952375095561,14,24,4.6251020431518555,3.3384134769439697,18,8
1674,64,0.6183398459885695,2.374751264756985,1.0004827853010378,1.0011597587551462,29,55,5.144053936004639,3.3384134769439697,35,9
1674,128,0.0788042572876597,2.277800212058511,0.9999807649050676,1.0027388405844584,67,118,5.640152931213379,3.3384134769439697,61,10
1675,1,6.901902757646397,6.901902757646398,0.9816064096340049,0.9816064096340055,0,0,6.923611164093018,6.923611164093018,1,1
1675,2,5.763462497892282,5.763462497892282,1.0005672709066245,1.0005672709066245,0,0,7.960245609283447,6.923611164093018,2,2
1675,3,4.840714251859382,4.840714251859383,1.0099232546013392,1.0099232546013397,0,0,7.984529972076416,6.923611164093018,3,3
1675,4,4.42600713193245,4.426007131932449,1.0168052807157641,1.0168052807157641,0,0,8.317893028259277,6.923611164093018,4,4
1675,8,4.238616969677013,4.291751881032235,1.0184881208955952,1.019341934047123,2,2,9.04196834564209,6.923611164093018,6,6
1675,16,3.86925985304894,3.992834324197185,1.024813299880273,1.0266187426665725,5,5,9.547425270080566,6.923611164093018,11,11
1675,32,3.415254171076906,3.9144297109393857,1.0233005939061703,1.030314749881128,13,15,10.157896041870117,6.923611164093018,19,17
1675,64,2.846510755884423,3.824878261243408,1.013940114580432,1.0352261860008798,30,43,10.862699508666992,6.923611164093018,34,21
1675,128,1.77063449263145,3.8244848194384566,1.0026755071644669,1.03535924981092,62,107,11.538817405700684,6.923611164093018,66,21
1676,1,2.4909738121827907,2.4909738121827907,0.9990740017655946,0.9990740017655958,0,0,2.4911234378814697,2.4911234378814697,1,1
1676,2,2.379169384148245,2.379169384148245,0.9997464091172444,0.9997464091172454,0,0,2.9701156616210938,2.4911234378814697,2,2
1676,3,2.236616613453966,2.2366166134539656,1.0003690050540597,1.000369005054059,0,0,3.002126693725586,2.4911234378814697,3,3
1676,4,2.1809989621040065,2.180998962104006,1.0009109086710668,1.0009109086710652,0,0,3.0288352966308594,2.4911234378814697,4,4
1676,8,2.04485688739086,2.0466580336391558,1.001521498659518,1.0015420400748782,2,2,3.4158878326416016,2.4911234378814697,6,6
1676,16,1.5950531322023458,1.7894582657264526,1.0014680428585307,1.0018445842475927,6,7,3.6581714153289795,2.4911234378814697,10,9
1676,32,1.2821747442387317,1.7658616068932507,1.001070979436011,1.0022379668966297,16,22,4.077850818634033,2.4911234378814697,16,10
1676,64,0.5918190027869621,1.7554862396051658,0.999058426317944,1.0021024630129585,32,50,4.4202961921691895,2.4911234378814697,32,14
1676,128,0.060277070625075375,1.7158842564444394,0.9990781146977328,1.002823239319357,62,119,4.832310676574707,2.4911234378814697,66,9
1677,1,9.616671746696639,9.61667174669664,0.9441607762792193,0.9441607762792226,0,0,9.761873245239258,9.761873245239258,1,1
1677,2,7.476981606884642,7.476981606884641,0.984000198395728,0.9840001983957269,0,0,9.900989532470703,9.761873245239258,2,2
1677,3,7.188228393032459,7.188228393032459,0.9922215934456268,0.9922215934456264,0,0,10.791959762573242,9.761873245239258,3,3
1677,4,7.186564850847369,7.18656485084737,0.9924901756688509,0.99249017566885,0,0,10.83151626586914,9.761873245239258,4,4
1677,8,6.789147798496212,6.837312287980836,1.0008389189831877,1.0006298177239685,3,4,11.00256633758545,9.761873245239258,5,4
1677,16,6.2772230523577495,6.675544774579906,1.0077243147231403,1.0053107870971127,7,9,11.566182136535645,9.761873245239258,9,7
1677,32,5.461676361311871,6.609863150128815,1.007934799945673,1.0093201112244383,12,23,12.022232055664062,9.761873245239258,20,9
1677,64,3.5948808250663156,6.443462748865959,1.0123213803870212,1.017175936154134,30,53,12.653348922729492,9.761873245239258,34,11
1677,128,2.103470064928073,6.333788010271368,1.0024209923059406,1.0245064899605059,65,115,13.344452857971191,9.761873245239258,63,13
1678,1,10.326641731601402,10.326641731601404,0.9409041912622861,0.9409041912622874,0,0,10.476500511169434,10.476500511169434,1,1
1678,2,8.974187257035037,8.974187257035037,0.9730118771854039,0.9730118771854044,0,0,10.569666862487793,10.476500511169434,2,2
1678,3,8.146966222922535,8.146966222922531,0.9907244365182113,0.9907244365182115,0,0,10.746689796447754,10.476500511169434,3,3
1678,4,8.14624523717474,8.14624523717474,0.990832836377394,0.990832836377394,0,0,10.885660171508789,10.476500511169434,4,4
1678,8,7.282805721985429,7.3123448207244595,1.0065792628691859,1.006382334040458,2,2,11.341482162475586,10.476500511169434,6,6
1678,16,6.606824169232729,7.116911524876886,1.0205914662440179,1.0130112569811949,5,5,11.849197387695312,10.476500511169434,11,11
1678,32,5.810833232744748,6.62280071079132,1.0333915341730844,1.0298454345899564,9,19,12.48770809173584,10.476500511169434,23,13
1678,64,4.071147499790638,6.594270825954592,1.0167478816909095,1.0307397678460004,29,51,13.287897109985352,10.476500511169434,35,13
1678,128,2.453375427713101,6.412942096050245,1.0013729534118578,1.0357901152653066,65,115,14.094585418701172,10.476500511169434,63,13
1679,1,3.1263219435292458,3.126321943529245,0.9950302881985952,0.9950302881985945,0,0,3.1300666332244873,3.1300666332244873,1,1
1679,2,2.5507886417881167,2.5507886417881163,0.9952170169429336,0.9952170169429336,0,0,3.254119634628296,3.1300666332244873,2,2
1679,3,2.4580081819656123,2.4580081819656123,0.9964224291553679,0.9964224291553674,0,0,3.396819591522217,3.1300666332244873,3,3
1679,4,2.0302379801924015,2.0302379801924015,1.0004166789765185,1.0004166789765183,0,0,3.506866216659546,3.1300666332244873,4,4
1679,8,1.6338833452070094,1.6578365316088124,1.0026537836412546,1.0024552349903137,2,2,4.0299153327941895,3.1300666332244873,6,6
1679,16,1.5089077604822012,1.618031437839606,1.0019858937079513,1.0031064391263,6,7,4.368698596954346,3.1300666332244873,10,9
1679,32,1.1822355961322157,1.5394877991348093,1.0030614495331738,1.004214819677744,13,19,4.641745090484619,3.1300666332244873,19,13
1679,64,0.735071119641738,1.5298114843554846,1.0017667761152724,1.0044820576391005,26,51,4.937300682067871,3.1300666332244873,38,13
1679,128,0.21355822746262848,1.495694128667838,1.0000150442570874,1.0055405720136457,66,112,5.435361385345459,3.1300666332244873,62,16
1680,1,3.704315558591184,3.704315558591185,0.9934714168174323,0.9934714168174343,0,0,3.7097716331481934,3.7097716331481934,1,1
1680,2,2.865777610454493,2.865777610454494,0.9986089816728061,0.9986089816728081,0,0,3.7707505226135254,3.7097716331481934,2,2
1680,3,2.7533093441486103,2.753309344148611,0.9992785913490798,0.999278591349082,0,0,3.8321735858917236,3.7097716331481934,3,3
1680,4,2.7495372544528283,2.7533093441486107,0.9991336031950541,0.999278591349082,1,1,3.8569180965423584,3.7097716331481934,3,3
1680,8,2.4574644947863145,2.471952669213431,1.0009337447795459,1.0012462724280504,3,3,4.150942325592041,3.7097716331481934,5,5
1680,16,1.9802798681708491,2.1778241749104215,1.003965790743603,1.003937061903189,5,7,4.466054439544678,3.7097716331481934,11,9
1680,32,1.5981554204004693,2.1269693940676913,1.0026009700242526,1.0040511454675223,14,23,4.897219181060791,3.7097716331481934,18,9
1680,64,0.9549998125274248,2.033581855431464,1.0017321821727827,1.0061972675963116,29,51,5.339449405670166,3.7097716331481934,35,13
1680,128,0.22493461524694733,1.9587283773010755,0.9997385219414413,1.0082109471559255,64,114,5.868191719055176,3.7097716331481934,64,14
1681,1,8.012794613542301,8.012794613542303,0.9638893960211002,0.963889396021102,0,0,8.085989952087402,8.085989952087402,1,1
1681,2,6.447111333514968,6.447111333514968,0.9934236678187259,0.993423667818726,0,0,8.204399108886719,8.085989952087402,2,2
1681,3,6.273765762045906,6.273765762045906,0.9959229015443989,0.9959229015443983,0,0,8.334369659423828,8.085989952087402,3,3
1681,4,6.067409348647758,6.06740934864776,0.9976280986142618,0.9976280986142614,0,0,8.59082317352295,8.085989952087402,4,4
1681,8,5.504417687451538,5.5046005728134855,1.0109489860384466,1.0109080870557274,1,1,9.434998512268066,8.085989952087402,7,7
1681,16,4.726438383474179,5.21492873031912,1.0182279093580295,1.0192966807403103,3,6,10.13033390045166,8.085989952087402,13,10
1681,32,3.894502159193223,4.763288498726909,1.0194199534784247,1.0315149308133584,12,18,10.60850715637207,8.085989952087402,20,14
1681,64,2.684169732707839,4.660215685860244,1.0085212871792817,1.0348635045592278,33,45,11.312698364257812,8.085989952087402,31,19
1681,128,1.6264821997280077,4.615715994796856,1.0041367055874906,1.0351324812540348,58,111,12.012871742248535,8.085989952087402,70,17
1682,1,3.4583715307084573,3.458371530708457,0.9967808982671899,0.9967808982671901,0,0,3.459813117980957,3.459813117980957,1,1
1682,2,3.316674983648826,3.316674983648826,0.997690001783553,0.9976900017835534,0,0,3.7460408210754395,3.459813117980957,2,2
1682,3,3.316617636247263,3.316617636247263,0.997690375925485,0.9976903759254854,0,0,3.98110032081604,3.459813117980957,3,3
1682,4,3.2953010790724844,3.2995113076886273,0.9979713279529845,0.997913118327641,1,1,4.2704925537109375,3.459813117980957,3,3
1682,8,3.2275169240880577,3.2909400151435912,0.9981363531187187,0.9980750703556509,3,4,4.428493976593018,3.459813117980957,5,4
1682,16,2.878092610818493,3.2776650030074066,0.9975850680582861,0.9983872677491129,7,11,4.542154312133789,3.459813117980957,9,5
1682,32,1.9179252197409187,3.2434902056327153,1.0003057249197165,0.9991030154685345,14,27,4.90152645111084,3.459813117980957,18,5
1682,64,0.6299977760345579,3.0253317769759542,0.9998446538509549,1.0013015476351288,29,60,5.287370204925537,3.459813117980957,35,4
1682,128,0.07490450496488152,2.745501507683921,0.9994603779818843,1.0044992391911107,63,120,5.672238826751709,3.459813117980957,65,8
1683,1,5.769663048136546,5.769663048136544,0.9807493138132085,0.980749313813211,0,0,5.7996907234191895,5.7996907234191895,1,1
1683,2,4.457555552457392,4.457555552457392,0.9986509154051975,0.9986509154051988,0,0,7.587490081787109,5.7996907234191895,2,2
1683,3,4.336818525860411,4.336818525860411,1.0018100797162193,1.001810079716221,0,0,7.698356628417969,5.7996907234191895,3,3
1683,4,4.318622995436541,4.318622995436541,1.0028883576401946,1.0028883576401957,0,0,8.408074378967285,5.7996907234191895,4,4
1683,8,4.094162262452799,4.217320470196604,1.0066568611848634,1.005552724790855,2,4,9.322607040405273,5.7996907234191895,6,4
1683,16,3.531873379508634,4.213977533175653,1.0025541600134438,1.0059879811383545,6,11,9.987255096435547,5.7996907234191895,10,5
1683,32,2.848174359206774,4.144389031361551,1.0027742731937048,1.0094920369783653,15,22,10.564981460571289,5.7996907234191895,17,10
1683,64,2.266442251475091,4.017651371108791,1.0024385531680902,1.0143611290031285,34,55,11.092098236083984,5.7996907234191895,30,9
1683,128,1.5082540588096645,3.923417864895237,1.0024423874664825,1.0180697162187902,61,117,11.664491653442383,5.7996907234191895,67,11
1684,1,9.503311468902647,9.503311468902647,0.9534448458147396,0.9534448458147398,0,0,9.604403495788574,9.604403495788574,1,1
1684,2,8.177412513095229,8.17741251309523,0.9855593653701895,0.9855593653701896,0,0,10.577102661132812,9.604403495788574,2,2
1684,3,7.876163214844908,7.876163214844908,0.9934990842149617,0.9934990842149608,0,0,11.640484809875488,9.604403495788574,3,3
1684,4,7.86501296532027,7.86501296532027,0.9937950044473821,0.9937950044473813,0,0,11.84632396697998,9.604403495788574,4,4
1684,8,7.147719950926181,7.162149185119206,1.0143266331034901,1.0136607107468096,1,2,12.277820587158203,9.604403495788574,7,6
1684,16,6.231563179504147,6.820476840665484,1.0237719693563434,1.0223781080060081,7,10,12.708566665649414,9.604403495788574,9,6
1684,32,5.686463672656828,6.798973634755721,1.0258255264197793,1.0228811707244514,14,23,13.093501091003418,9.604403495788574,18,9
1684,64,3.8679246468005086,6.7282660813287025,1.0167018731203696,1.0280658829081197,32,52,13.892480850219727,9.604403495788574,32,12
1684,128,2.768280208723823,6.524908619301048,1.0043364092027152,1.0356461809692457,59,117,14.426424026489258,9.604403495788574,69,11
1685,1,11.751685880128562,11.751685880128568,0.9110500595637453,0.9110500595637477,0,0,12.04555606842041,12.04555606842041,1,1
1685,2,8.953699925126053,8.953699925126053,0.9853513627582839,0.9853513627582854,0,0,12.13609504699707,12.04555606842041,2,2
1685,3,8.878047798288204,8.878047798288202,0.9882214259285719,0.9882214259285733,0,0,12.905200004577637,12.04555606842041,3,3
1685,4,8.82324956217873,8.82324956217873,0.9903312780882417,0.9903312780882428,0,0,12.97350025177002,12.04555606842041,4,4
1685,8,8.31239508478634,8.316392258332979,1.006742279344965,1.0068131499906636,2,2,13.279093742370605,12.04555606842041,6,6
1685,16,7.268769318385401,7.714077808513043,1.038046072530785,1.029906330373503,3,4,14.028295516967773,12.04555606842041,13,12
1685,32,6.1429246397320565,7.675659244010819,1.0364369742293689,1.0336159548599375,13,21,14.875650405883789,12.04555606842041,19,11
1685,64,4.308098762504207,7.349882023260293,1.0181434577309139,1.0513118113163917,29,49,15.72311782836914,12.04555606842041,35,15
1685,128,3.138727740700839,7.275804552547516,1.0061809125679784,1.0557128579829234,67,112,16.44145965576172,12.04555606842041,61,16
1686,1,12.52912241915296,12.529122419152962,0.9118605181343656,0.9118605181343667,0,0,12.800847053527832,12.800847053527832,1,1
1686,2,10.057893041469894,10.057893041469894,0.9923859035897573,0.992385903589759,0,0,13.874505996704102,12.800847053527832,2,2
1686,3,9.810473066877426,9.810473066877426,1.000303374211527,1.0003033742115282,0,0,13.980936050415039,12.800847053527832,3,3
1686,4,9.415763167168128,9.415763167168128,1.0118899293028552,1.0118899293028565,0,0,14.023788452148438,12.800847053527832,4,4
1686,8,8.178194620010286,8.239895029388135,1.045321217397433,1.043717898952319,1,1,14.49025821685791,12.800847053527832,7,7
1686,16,7.663036851838791,7.765855827580695,1.061451392686563,1.0600615030402392,5,6,15.035194396972656,12.800847053527832,11,10
1686,32,6.893463924473086,7.410081446200999,1.0764302857133774,1.0703085235535283,11,18,15.391853332519531,12.800847053527832,21,14
1686,64,5.7036572057870565,7.24752740811967,1.0724568340773923,1.0770490879571488,27,46,15.787149429321289,12.800847053527832,37,18
1686,128,4.054636178984056,6.958013204887472,1.0436943599944966,1.085369962587795,61,112,16.21337127685547,12.800847053527832,67,16
1687,1,8.357022416893649,8.35702241689365,0.9580080577316495,0.9580080577316512,0,0,8.45205020904541,8.45205020904541,1,1
1687,2,6.704747036923837,6.7047470369238376,0.9886217233204313,0.9886217233204322,0,0,8.499744415283203,8.45205020904541,2,2
1687,3,6.151644846724587,6.1516448467245874,0.9967226971135597,0.9967226971135605,0,0,8.594766616821289,8.45205020904541,3,3
1687,4,5.7994094919837496,5.799409491983738,1.0023078186373926,1.0023078186373922,0,0,8.70155143737793,8.45205020904541,4,4
1687,8,5.502345567291156,5.502345567291157,1.0072282914404957,1.0072282914404962,0,0,9.241962432861328,8.45205020904541,8,8
1687,16,4.923146280846161,5.106191724772832,1.0144388161145823,1.013508311053838,3,3,9.622166633605957,8.45205020904541,13,13
1687,32,4.186517646750108,4.9590577996902585,1.011707486244999,1.0170014408667614,12,15,10.357641220092773,8.45205020904541,20,17
1687,64,2.927775146264944,4.901917503169036,1.0083500773155871,1.0202610422908454,31,47,11.122100830078125,8.45205020904541,33,17
1687,128,1.8716044127414013,4.810397881931768,1.0038579307105666,1.0251302713256072,57,105,11.8981351852417,8.45205020904541,71,23
1688,1,7.652892469803789,7.652892469803789,0.9655258522846127,0.9655258522846143,0,0,7.723270893096924,7.723270893096924,1,1
1688,2,7.170802008670956,7.170802008670956,0.9795588734077552,0.9795588734077565,0,0,9.456202507019043,7.723270893096924,2,2
1688,3,6.372414464813467,6.372414464813467,0.9984324823099071,0.9984324823099064,0,0,9.489876747131348,7.723270893096924,3,3
1688,4,6.183760540011616,6.183760540011615,1.0002152004627736,1.0002152004627747,0,0,9.560657501220703,7.723270893096924,4,4
1688,8,5.182781304246203,5.35301171741777,1.018448189389535,1.0182550150448328,1,1,10.644770622253418,7.723270893096924,7,7
1688,16,4.89496233621599,5.311327366147971,1.0163828832817101,1.020355910410799,5,5,11.360648155212402,7.723270893096924,11,11
1688,32,3.9620040209880387,4.933178528291376,1.0160502249606524,1.0322267990481713,15,21,12.498164176940918,7.723270893096924,17,11
1688,64,3.0274916613393024,4.857940837222077,1.006924023089593,1.0340935732831293,33,50,13.306602478027344,7.723270893096924,31,14
1688,128,1.7554359568623603,4.850573455389763,1.0015885406425353,1.0347020793821662,61,115,14.195765495300293,7.723270893096924,67,13
1689,1,8.31696945185746,8.31696945185746,0.9613720644610733,0.9613720644610744,0,0,8.39499282836914,8.39499282836914,1,1
1689,2,7.170692903777481,7.170692903777481,0.9845313169572636,0.9845313169572645,0,0,8.83887004852295,8.39499282836914,2,2
1689,3,6.907890140432385,6.907890140432385,0.9925540324662374,0.9925540324662379,0,0,9.952089309692383,8.39499282836914,3,3
1689,4,6.672609581884474,6.672609581884474,0.9997805770260029,0.9997805770260028,0,0,10.076359748840332,8.39499282836914,4,4
1689,8,6.523180835497117,6.6031686498801,1.0031016976904252,1.00314570733094,2,2,10.307429313659668,8.39499282836914,6,6
1689,16,5.946578051122715,6.37892949127941,1.016603688923634,1.0139523869236209,5,6,11.128297805786133,8.39499282836914,11,10
1689,32,4.812854956786893,5.807317512326692,1.0251853408802363,1.029074027154718,14,21,11.847403526306152,8.39499282836914,18,11
1689,64,3.2982942819695493,5.77792476653748,1.0176274713960507,1.0312524022843474,30,52,12.648611068725586,8.39499282836914,34,12
1689,128,1.8343898645275134,5.777809261105728,1.0017023979730377,1.0313045113184895,61,115,13.621647834777832,8.39499282836914,67,13
1690,1,10.743148534110725,10.743148534110725,0.920626670323388,0.9206266703233907,0,0,11.000250816345215,11.000250816345215,1,1
1690,2,9.929661643545167,9.92966164354517,0.9466162010789541,0.9466162010789556,0,0,11.49524974822998,11.000250816345215,2,2
1690,3,9.615040193010284,9.615040193010284,0.9571163548176336,0.9571163548176348,0,0,11.82921028137207,11.000250816345215,3,3
1690,4,9.37768867230314,9.377688672303142,0.9641152813321721,0.9641152813321728,0,0,11.855297088623047,11.000250816345215,4,4
1690,8,8.88572505192144,8.924991045513792,0.9811565814286731,0.9797414820414795,1,1,11.96903133392334,11.000250816345215,7,7
1690,16,8.209082260183541,8.6666687888696,0.9964499535179645,0.9887923683078103,5,6,12.507991790771484,11.000250816345215,11,10
1690,32,6.9261622281791135,7.623816518326537,1.0288008591837012,1.0209425033618005,13,21,13.142338752746582,11.000250816345215,19,11
1690,64,4.885530452656275,7.562870630901623,1.0245664398798457,1.0242770450951046,28,47,13.926370620727539,11.000250816345215,36,17
1690,128,3.031080949360005,7.393653451506097,1.0090267710645435,1.03468524687576,63,111,14.592329025268555,11.000250816345215,65,17
1691,1,12.49416796420841,12.494167964208412,0.9063920170391834,0.9063920170391861,0,0,12.783156394958496,12.783156394958496,1,1
1691,2,11.255959844767775,11.255959844767778,0.9442601742975139,0.944260174297517,0,0,13.58046817779541,12.783156394958496,2,2
1691,3,9.821910798343598,9.821910798343596,0.9858041326827272,0.9858041326827294,0,0,13.597475051879883,12.783156394958496,3,3
1691,4,9.334092316178307,9.334092316178308,0.9979996888561523,0.9979996888561551,0,0,13.695992469787598,12.783156394958496,4,4
1691,8,8.327176710314168,8.36194593452241,1.0267268599016126,1.0258425269292955,1,1,14.144608497619629,12.783156394958496,7,7
1691,16,7.917973177668898,8.101551532248557,1.0411667912369618,1.0368663356934986,3,4,15.004106521606445,12.783156394958496,13,12
1691,32,7.174037878675986,7.929518082669174,1.0471759648556185,1.0474898831824628,13,17,15.525176048278809,12.783156394958496,19,15
1691,64,5.419721490747248,7.731809241937307,1.0374981650476118,1.0561918221722322,32,47,16.197553634643555,12.783156394958496,32,17
1691,128,3.739260256076929,7.663922368382771,1.0206069325102423,1.0606071369415278,63,108,17.027463912963867,12.783156394958496,65,20
1692,1,9.503318214421645,9.503318214421645,0.9591656555584126,0.959165655558414,0,0,9.582413673400879,9.582413673400879,1,1
1692,2,6.957924267558348,6.95792426755835,1.0055836335273896,1.0055836335273893,0,0,10.286155700683594,9.582413673400879,2,2
1692,3,6.932137753617478,6.95792426755835,1.0055316807434556,1.0055836335273893,1,1,10.467190742492676,9.582413673400879,2,2
1692,4,6.768156927625882,6.83210358615968,1.0090851374591412,1.0086465265217326,1,1,10.734044075012207,9.582413673400879,3,3
1692,8,6.4978866826854365,6.545250900173714,1.0152774500527004,1.0150704333869904,1,1,11.090373992919922,9.582413673400879,7,7
1692,16,6.214866323404491,6.313704276666337,1.0230480068992058,1.0250582455622532,5,6,11.639374732971191,9.582413673400879,11,10
1692,32,5.702629899495929,6.139909902512007,1.0288609469297452,1.0337352694425275,13,20,12.167730331420898,9.582413673400879,19,12
1692,64,4.112804056638014,6.076179565066604,1.0160283071768699,1.0367971690587985,31,50,12.773365020751953,9.582413673400879,33,14
1692,128,2.6144860565805805,5.879660685960881,1.0082239275630265,1.041583042572526,61,113,13.242873191833496,9.582413673400879,67,15
1693,1,5.528922656533923,5.528922656533924,0.9820564227686389,0.9820564227686417,0,0,5.55582857131958,5.55582857131958,1,1
1693,2,3.569947209277171,3.5699472092771716,1.003478804694724,1.003478804694725,0,0,5.658895015716553,5.55582857131958,2,2
1693,3,2.8226327736459242,2.8226327736459242,1.0107864526104644,1.0107864526104648,0,0,5.88189697265625,5.55582857131958,3,3
1693,4,2.7322639027578726,2.732263902757872,1.0115434786124538,1.0115434786124553,0,0,5.893313884735107,5.55582857131958,4,4
1693,8,2.6064131223679294,2.6679953948585804,1.011589899179794,1.0118208115792489,3,3,6.883829116821289,5.55582857131958,5,5
1693,16,2.3935652229833875,2.538565378958152,1.0130463877362903,1.0140726974880696,5,8,7.432698726654053,5.55582857131958,11,8
1693,32,2.213301180328181,2.502327745170571,1.0107110228496339,1.016129901671416,15,22,8.127057075500488,5.55582857131958,17,10
1693,64,1.6505127503136572,2.5000140775134114,1.0047856665373982,1.0166453800456732,30,52,8.612411499023438,5.55582857131958,34,12
1693,128,0.9843515624627838,2.4924791838444804,0.9988194078030607,1.0170176791647683,64,116,9.499890327453613,5.55582857131958,64,12
1694,1,8.61049140873268,8.610491408732681,0.9547462013764518,0.9547462013764536,0,0,8.713459014892578,8.713459014892578,1,1
1694,2,7.790689371939948,7.790689371939946,0.970316812993302,0.9703168129933037,0,0,8.884993553161621,8.713459014892578,2,2
1694,3,7.385546311405883,7.385546311405883,0.9808224423917865,0.9808224423917882,0,0,9.343221664428711,8.713459014892578,3,3
1694,4,6.926099363165307,6.926099363165308,0.9920813943735005,0.9920813943735021,0,0,9.58418083190918,8.713459014892578,4,4
1694,8,6.181577572370453,6.181800477093082,1.0100031690251239,1.0098740919640847,1,1,10.220475196838379,8.713459014892578,7,7
1694,16,5.276458931191664,5.628670088352612,1.0245055454649243,1.0212932544943185,4,5,10.70602035522461,8.713459014892578,12,11
1694,32,4.563681192715524,5.310176016559525,1.0210104083437863,1.0293308620991952,14,21,11.4769868850708,8.713459014892578,18,11
1694,64,3.69402712829629,5.239821912831437,1.0133396275118336,1.0315326932689928,27,49,12.036433219909668,8.713459014892578,37,15
1694,128,1.9608250225257033,5.188367007835745,1.0004515543609427,1.034730768344013,58,111,12.778557777404785,8.713459014892578,70,17
1695,1,9.701472448439505,9.701472448439489,0.93951795325096,0.9395179532509625,0,0,9.86799430847168,9.86799430847168,1,1
1695,2,7.884770733154664,7.884770733154665,0.9817713637765899,0.9817713637765926,0,0,9.93367862701416,9.86799430847168,2,2
1695,3,6.721038438767585,6.721038438767586,1.000716418242085,1.0007164182420867,0,0,10.032769203186035,9.86799430847168,3,3
1695,4,6.6869817241161575,6.686981724116159,1.0021296739331382,1.0021296739331402,0,0,10.249373435974121,9.86799430847168,4,4
1695,8,6.234900352115723,6.234900352115723,1.0133908692367821,1.0133908692367837,1,1,11.073344230651855,9.86799430847168,7,7
1695,16,6.0434805893091,6.189005832145847,1.0124357750142532,1.015439487129632,4,3,11.28950309753418,9.86799430847168,12,13
1695,32,5.23775444586007,6.037756426262288,1.0235008545683697,1.0219040225907812,13,20,11.895187377929688,9.86799430847168,19,12
1695,64,4.243657888588825,5.775993140586019,1.0183153921834232,1.033526402799052,35,50,12.425310134887695,9.86799430847168,29,14
1695,128,2.8018872132717365,5.5462665446952135,1.0078889642604234,1.0414269267486789,64,109,13.111504554748535,9.86799430847168,64,19
1696,1,8.307915174743824,8.307915174743826,0.9590938127752845,0.9590938127752875,0,0,8.400626182556152,8.400626182556152,1,1
1696,2,7.405027832255251,7.405027832255251,0.9779788098984572,0.9779788098984589,0,0,8.749382019042969,8.400626182556152,2,2
1696,3,7.216081951719074,7.216081951719073,0.9809794323137533,0.9809794323137537,0,0,8.895747184753418,8.400626182556152,3,3
1696,4,6.968935874907366,6.968935874907367,0.9890474358135368,0.9890474358135375,0,0,9.113097190856934,8.400626182556152,4,4
1696,8,5.451974792411511,5.45991075358051,1.0179212324327167,1.0183107521287775,1,1,9.744637489318848,8.400626182556152,7,7
1696,16,5.275663485679527,5.388180293109784,1.0202341718404762,1.0205771086726028,5,6,10.172917366027832,8.400626182556152,11,10
1696,32,4.572442603152568,5.206252984300827,1.0168758903034392,1.0259567037157677,11,20,10.906481742858887,8.400626182556152,21,12
1696,64,3.673617931824388,5.067582855315938,1.0075810457668597,1.0323305961487375,33,50,11.559866905212402,8.400626182556152,31,14
1696,128,2.286599895426055,4.989560834891775,1.0018127541178075,1.0365191690400817,62,114,12.246413230895996,8.400626182556152,66,14
1697,1,9.709582733878435,9.709582733878436,0.9409197243373437,0.9409197243373444,0,0,9.876917839050293,9.876917839050293,1,1
1697,2,8.751396640958653,8.751396640958655,0.9661224219993085,0.9661224219993092,0,0,10.378949165344238,9.876917839050293,2,2
1697,3,8.391330882926683,8.391330882926683,0.9768329207927838,0.9768329207927838,0,0,10.410920143127441,9.876917839050293,3,3
1697,4,8.172317206497468,8.17231720649747,0.980926847091639,0.9809268470916389,0,0,10.462736129760742,9.876917839050293,4,4
1697,8,7.604167678719219,7.604167678719218,0.9987096972278773,0.9987096972278768,0,0,10.63282585144043,9.876917839050293,8,8
1697,16,6.997948996753761,7.200164424274257,1.0131405386814265,1.0093142881252075,3,4,10.970939636230469,9.876917839050293,13,12
1697,32,6.355158480786647,6.927180097488473,1.0210677276564986,1.0175650460939658,13,20,11.186899185180664,9.876917839050293,19,12
1697,64,5.1070120441544,6.548335504317634,1.0322025497789284,1.0254189227183108,27,47,11.528160095214844,9.876917839050293,37,17
1697,128,2.4610354317273075,5.783335651755941,1.0106509359849576,1.0384809225452547,63,109,11.91569709777832,9.876917839050293,65,19
1698,1,2.9265050258935714,2.9265050258935714,0.9931871597698654,0.9931871597698657,0,0,2.934133291244507,2.934133291244507,1,1
1698,2,2.89612746786028,2.8961274678602806,0.9939535143454877,0.9939535143454876,0,0,3.8999481201171875,2.934133291244507,2,2
1698,3,2.8030087352417605,2.8030087352417605,0.9949396407741516,0.9949396407741518,0,0,3.901190996170044,2.934133291244507,3,3
1698,4,2.6644883143831497,2.8030087352417605,0.9941835295447692,0.9949396407741518,1,1,4.191795825958252,2.934133291244507,3,3
1698,8,2.392865658730963,2.55483390503886,0.9973706382231846,0.9972558090876606,3,3,4.334559440612793,2.934133291244507,5,5
1698,16,1.9193945244146196,2.5543186749679263,0.9984707997052047,0.997301480162122,7,10,4.516358375549316,2.934133291244507,9,6
1698,32,1.3995024406476462,2.458373422272599,0.9999463137917299,0.9983146768894576,17,26,4.848302364349365,2.934133291244507,15,6
1698,64,0.7611038937243656,2.3577118827113908,0.9989860039067886,0.999695128929623,36,55,5.381909370422363,2.934133291244507,28,9
1698,128,0.06635958157373788,2.1076695479446843,0.9986507029365805,1.0036207864045936,65,121,5.8426690101623535,2.934133291244507,63,7
1699,1,6.645554683695575,6.6455546836955754,0.9765461178611471,0.9765461178611488,0,0,6.683182239532471,6.683182239532471,1,1
1699,2,5.887893689313422,5.887893689313424,0.9861784902542685,0.9861784902542694,0,0,7.367403984069824,6.683182239532471,2,2
1699,3,5.0064372733898495,5.006437273389849,1.0009439610031148,1.0009439610031154,0,0,7.420454502105713,6.683182239532471,3,3
1699,4,4.568166259623359,4.568166259623357,1.0042050194681378,1.0042050194681391,0,0,7.424095630645752,6.683182239532471,4,4
1699,8,4.405933445603704,4.431651974799556,1.0065124071049971,1.00615643859625,2,2,7.601413249969482,6.683182239532471,6,6
1699,16,3.728428467237279,3.960165121459903,1.0164129192990121,1.0142523722750034,6,7,8.205833435058594,6.683182239532471,10,9
1699,32,3.3183810579293396,3.887118079971399,1.0150008746285406,1.0174912531648292,15,21,8.786653518676758,6.683182239532471,17,11
1699,64,2.2201535223450986,3.789984068771412,1.00654608093678,1.0189879982084908,32,52,9.57361125946045,6.683182239532471,32,12
1699,128,1.1438753751666837,3.777922106035625,1.0031841785915745,1.0197320735858089,60,113,10.135125160217285,6.683182239532471,68,15
1700,1,7.04419444863299,7.044194448632991,0.9664384296586567,0.966438429658658,0,0,7.115878582000732,7.115878582000732,1,1
1700,2,6.679080543088361,6.679080543088361,0.9760667128665648,0.9760667128665652,0,0,8.492451667785645,7.115878582000732,2,2
1700,3,6.1480135476625595,6.148013547662561,0.9856558629155004,0.9856558629155021,0,0,8.946942329406738,7.115878582000732,3,3
1700,4,6.136207641947722,6.136207641947722,0.9866857860501594,0.9866857860501606,0,0,9.156425476074219,7.115878582000732,4,4
1700,8,5.083249624310613,5.115021636456712,1.0067612123173706,1.0062830101485116,1,1,9.459771156311035,7.115878582000732,7,7
1700,16,4.685306101728103,4.7666441095456324,1.0128593895577211,1.013354848439036,5,7,9.911529541015625,7.115878582000732,11,9
1700,32,4.071931005062732,4.69531775563884,1.0125428056184185,1.0157750757119584,12,19,10.536612510681152,7.115878582000732,20,13
1700,64,2.705242283980697,4.6703382587718325,1.0009430052938946,1.017341966074027,31,49,11.416435241699219,7.115878582000732,33,15
1700,128,1.385548196704307,4.582657365300372,0.99781261440042,1.0220314238927162,65,109,12.053863525390625,7.115878582000732,63,19
1701,1,8.474743040738089,8.474743040738094,0.9426026306115464,0.9426026306115484,0,0,8.645842552185059,8.645842552185059,1,1
1701,2,7.179269612049223,7.179269612049225,0.9706318771652827,0.9706318771652832,0,0,8.79653263092041,8.645842552185059,2,2
1701,3,6.876027370182299,6.8760273701823005,0.9775729557226577,0.9775729557226578,0,0,8.949751853942871,8.645842552185059,3,3
1701,4,6.352497330599823,6.352497330599823,0.9893941245298543,0.9893941245298539,0,0,9.036195755004883,8.645842552185059,4,4
1701,8,5.298250233599431,5.440960942629623,1.0054324396359295,1.0031744828622444,1,1,9.272504806518555,8.645842552185059,7,7
1701,16,5.0456855798404066,5.208970727205707,1.0116371429810938,1.0094294553965202,4,6,10.119030952453613,8.645842552185059,12,10
1701,32,4.376631715545969,4.967452724962037,1.0121442831792342,1.017509520135538,12,19,10.71146297454834,8.645842552185059,20,13
1701,64,3.453381841068658,4.885833374930391,1.0100001463961923,1.020496700270969,32,48,11.717090606689453,8.645842552185059,32,16
1701,128,2.023749196560858,4.853899852359907,1.0016508956608645,1.0228747905010458,61,111,12.658476829528809,8.645842552185059,67,17
1702,1,10.341366354981945,10.341366354981949,0.9288008596473142,0.928800859647316,0,0,10.559274673461914,10.559274673461914,1,1
1702,2,9.24281797432281,9.242817974322785,0.9569175626149826,0.9569175626149846,0,0,10.911503791809082,10.559274673461914,2,2
1702,3,9.001073299597175,9.001073299597179,0.96397084334348,0.9639708433434815,0,0,11.22525405883789,10.559274673461914,3,3
1702,4,7.27355091987561,7.2735509198756105,1.0028839543155954,1.0028839543155945,0,0,11.389435768127441,10.559274673461914,4,4
1702,8,6.904802376230124,6.938383737262129,1.014704542167459,1.0158463640805286,2,2,12.554251670837402,10.559274673461914,6,6
1702,16,6.416836670932376,6.846906632134416,1.0135940432782111,1.020739814746772,5,7,13.564681053161621,10.559274673461914,11,9
1702,32,5.628641731542943,6.746857986141495,1.0104148945987934,1.0241299805816424,13,22,14.357547760009766,10.559274673461914,19,10
1702,64,4.183324621501487,6.703184674775169,0.9989489321458236,1.0278042117485546,32,54,15.31649112701416,10.559274673461914,32,10
1702,128,2.3845252121469636,6.63683149987459,0.9986469069726934,1.0338232592295702,55,114,16.676185607910156,10.559274673461914,73,14
1703,1,7.176370131081342,7.176370131081342,0.9728667299464527,0.9728667299464535,0,0,7.222043037414551,7.222043037414551,1,1
1703,2,5.52086820135186,5.520868201351859,0.9984911171593073,0.9984911171593074,0,0,7.896677494049072,7.222043037414551,2,2
1703,3,4.586246018980574,4.586246018980574,1.0098463801493271,1.0098463801493271,0,0,7.905864715576172,7.222043037414551,3,3
1703,4,4.512299651668492,4.512299651668492,1.0107580457834258,1.010758045783426,0,0,8.045594215393066,7.222043037414551,4,4
1703,8,4.007941439989468,4.170393953671815,1.0160154507078154,1.0157422136802494,2,3,8.800032615661621,7.222043037414551,6,5
1703,16,3.8781330134269374,4.133797884886058,1.0181354995597003,1.0175329843384668,5,9,9.403666496276855,7.222043037414551,11,7
1703,32,3.3343261190652593,4.0790439124869655,1.0208040835975243,1.0200521233380686,10,20,9.92567253112793,7.222043037414551,22,12
1703,64,2.696490806933053,3.9926433176271363,1.011781453784275,1.023806583986912,28,52,10.756163597106934,7.222043037414551,36,12
1703,128,1.5295459421757491,3.9907237202201276,1.0012780861499417,1.0244293856958278,69,115,11.817154884338379,7.222043037414551,59,13
1704,1,2.6026233178532814,2.602623317853282,0.9975275301920815,0.9975275301920826,0,0,2.603739023208618,2.603739023208618,1,1
1704,2,2.332408081330835,2.3324080813308354,0.9990702025278959,0.9990702025278968,0,0,2.618187189102173,2.603739023208618,2,2
1704,3,2.329440756380444,2.329440756380444,0.9991934747890932,0.9991934747890933,0,0,3.1221923828125,2.603739023208618,3,3
1704,4,1.8551611615315118,1.85516116153151,1.001685455469396,1.0016854554693955,0,0,3.2044894695281982,2.603739023208618,4,4
1704,8,1.7026216934165597,1.7026216934165597,1.0020388030696128,1.0020388030696123,0,0,3.446753740310669,2.603739023208618,8,8
1704,16,1.5339675687990129,1.6438761533904733,1.0015937558996109,1.0027136280306594,6,7,3.7055985927581787,2.603739023208618,10,9
1704,32,1.3011208829631724,1.5920059578336667,1.0011605408739985,1.0041209781095024,17,21,4.114595890045166,2.603739023208618,15,11
1704,64,0.576861613935903,1.5638390781102842,0.9999691703541264,1.004618792535041,32,50,4.535289287567139,2.603739023208618,32,14
1704,128,0.08708782525002715,1.5637892632464079,0.9995174599699375,1.0046315785052469,65,113,4.9896440505981445,2.603739023208618,63,15
1705,1,10.532786944438225,10.532786944438227,0.9428356199831645,0.942835619983169,0,0,10.667152404785156,10.667152404785156,1,1
1705,2,7.705607775897746,7.705607775897747,1.0040092059357733,1.004009205935777,0,0,10.994925498962402,10.667152404785156,2,2
1705,3,7.271264392996624,7.271264392996623,1.011327187979603,1.0113271879796026,0,0,11.256978988647461,10.667152404785156,3,3
1705,4,7.257425103445447,7.257425103445447,1.0112350052546177,1.011235005254616,0,0,11.270049095153809,10.667152404785156,4,4
1705,8,6.5730162915533565,6.5805798232029575,1.0247235761296059,1.0242298751449084,1,2,11.785929679870605,10.667152404785156,7,6
1705,16,6.116891813718308,6.367192629024121,1.0330379277036117,1.0344231624584954,3,4,12.898802757263184,10.667152404785156,13,12
1705,32,5.467731981592864,6.118976766224843,1.0295959067410723,1.0403086084683337,11,19,13.645466804504395,10.667152404785156,21,13
1705,64,4.133773227810208,6.005039040702411,1.0207524009403433,1.0491721660261768,29,43,14.216675758361816,10.667152404785156,35,21
1705,128,2.9814580363029277,5.831538044900702,1.0086829966467945,1.0582051376146067,64,106,14.817403793334961,10.667152404785156,64,22
1706,1,10.6765693170346,10.676569317034602,0.9406569564342625,0.940656956434264,0,0,10.826223373413086,10.826223373413086,1,1
1706,2,9.06044964198316,9.06044964198316,0.9863037395539102,0.9863037395539109,0,0,11.882800102233887,10.826223373413086,2,2
1706,3,8.584432410814799,8.584432410814799,1.0008749050374965,1.0008749050374979,0,0,11.891912460327148,10.826223373413086,3,3
1706,4,7.723615892702727,7.723615892702733,1.0176655581180636,1.0176655581180643,0,0,11.91799545288086,10.826223373413086,4,4
1706,8,7.185077438926009,7.185077438926008,1.0308833079476516,1.0308833079476543,0,0,12.836576461791992,10.826223373413086,8,8
1706,16,6.79448604739407,7.004325403019637,1.0387429587939085,1.039298469461465,8,7,13.011075019836426,10.826223373413086,8,9
1706,32,5.887992577577448,6.487535126495636,1.0502474718726893,1.0494325979313541,12,21,13.339940071105957,10.826223373413086,20,11
1706,64,4.372834386562947,6.394160863017112,1.0362931379752665,1.0531858862797165,33,49,14.079718589782715,10.826223373413086,31,15
1706,128,3.161821370876383,6.390266513136108,1.0212829870699904,1.0539044400000763,63,109,14.697650909423828,10.826223373413086,65,19
1707,1,6.660256272008889,6.660256272008889,0.9766196039863964,0.976619603986398,0,0,6.697168350219727,6.697168350219727,1,1
1707,2,5.735915184422727,5.735915184422728,0.988211181746384,0.9882111817463852,0,0,7.126531600952148,6.697168350219727,2,2
1707,3,4.807434651530231,4.807434651530231,0.9995878384925418,0.9995878384925418,0,0,7.401308059692383,6.697168350219727,3,3
1707,4,4.770718548646342,4.770718548646341,1.0003703998912354,1.0003703998912352,0,0,7.431998252868652,6.697168350219727,4,4
1707,8,4.240574943559121,4.241077028007965,1.0079291125948373,1.007844242678098,1,1,7.6046953201293945,6.697168350219727,7,7
1707,16,3.468034893506222,3.54150962358876,1.017583506812761,1.0169310211545977,4,4,8.093341827392578,6.697168350219727,12,12
1707,32,3.070075662550971,3.4834067516720464,1.0174026079910372,1.0188798594892552,14,15,8.719863891601562,6.697168350219727,18,17
1707,64,2.152209141419723,3.324106946574609,1.008714568104487,1.0224554397595154,28,44,9.438896179199219,6.697168350219727,36,20
1707,128,1.1511698963225052,3.3209858312756184,0.999916376105338,1.022602031564089,65,107,10.078255653381348,6.697168350219727,63,21
1708,1,10.437589892145763,10.437589892145764,0.9359333904802175,0.9359333904802192,0,0,10.61298942565918,10.61298942565918,1,1
1708,2,8.901607074169373,8.901607074169375,0.9735917583814474,0.9735917583814476,0,0,11.007831573486328,10.61298942565918,2,2
1708,3,8.151726654697343,8.151726654697343,0.991746504103993,0.9917465041039945,0,0,11.466349601745605,10.61298942565918,3,3
1708,4,8.036121628676453,8.036121628676453,0.9942336755678081,0.9942336755678091,0,0,11.521368980407715,10.61298942565918,4,4
1708,8,6.96991974810866,7.03995801889585,1.0131761519140337,1.0135703328154184,3,3,12.05903148651123,10.61298942565918,5,5
1708,16,6.650939834927769,6.950832495925199,1.0188408392865322,1.019229672046249,4,7,12.717649459838867,10.61298942565918,12,9
1708,32,5.724174075237058,6.502342046779996,1.0300797885726138,1.0329881476044012,15,21,13.479225158691406,10.61298942565918,17,11
1708,64,4.09940221731719,6.379132939543076,1.0177701897173512,1.0375414006675485,31,52,14.492674827575684,10.61298942565918,33,12
1708,128,2.613809492639025,6.352788142679236,1.0046641733290715,1.0397357417368251,65,116,15.576833724975586,10.61298942565918,63,12
1709,1,3.04160354659792,3.041603546597919,0.994705323419937,0.9947053234199367,0,0,3.0460422039031982,3.0460422039031982,1,1
1709,2,2.513406428681781,2.513406428681781,0.9980365868087289,0.9980365868087286,0,0,3.201864719390869,3.0460422039031982,2,2
1709,3,2.4727887244122413,2.472788724412241,0.9983409869870005,0.9983409869869996,0,0,3.214348793029785,3.0460422039031982,3,3
1709,4,2.185079154046528,2.2338303916798194,1.0009979411783025,1.000497782521515,1,1,3.354665994644165,3.0460422039031982,3,3
1709,8,2.154010740623024,2.215590145430432,1.0012505635616156,1.000820850542664,4,2,3.5033161640167236,3.0460422039031982,4,6
1709,16,1.675755585401565,2.090962717615898,1.0026226488188748,1.0016224864547227,5,8,3.9677820205688477,3.0460422039031982,11,8
1709,32,1.271375577894217,1.947466872242137,1.0030779216979866,1.0041569413047151,14,22,4.3153862953186035,3.0460422039031982,18,10
1709,64,0.43593509509926925,1.819371576707412,1.0005269686911649,1.00652955466225,33,50,4.791187286376953,3.0460422039031982,31,14
1709,128,0.07218495513845968,1.807888124472968,0.9999981138850571,1.0069091344516705,66,114,5.284117698669434,3.0460422039031982,62,14
1710,1,8.448379592656096,8.448379592656096,0.9634889711456618,0.9634889711456633,0,0,8.519400596618652,8.519400596618652,1,1
1710,2,7.177468003524816,7.177468003524815,0.982964020436572,0.9829640204365739,0,0,8.862826347351074,8.519400596618652,2,2
1710,3,6.965186001701354,6.965186001701353,0.9875580075169758,0.9875580075169768,0,0,9.164947509765625,8.519400596618652,3,3
1710,4,5.881527854408387,5.881527854408388,0.9955343268891792,0.9955343268891788,0,0,9.299278259277344,8.519400596618652,4,4
1710,8,5.584745595482428,5.592858788846373,0.9980501730122677,0.99847922278865,2,2,9.592649459838867,8.519400596618652,6,6
1710,16,5.175524301735037,5.35148591686616,1.003880002921772,1.0032470416515427,5,6,9.85203742980957,8.519400596618652,11,10
1710,32,4.353811628366433,4.989511767576998,1.0122710458582782,1.0128918028513767,12,20,9.987526893615723,8.519400596618652,20,12
1710,64,3.1728960897531517,4.9711898281114335,1.0070625326811753,1.013518877662527,30,51,10.124338150024414,8.519400596618652,34,13
1710,128,1.5309149118224672,4.964161293475105,1.0008523728427505,1.0138392473449693,64,113,10.273873329162598,8.519400596618652,64,15
1711,1,2.8482893643619995,2.8482893643619995,0.9990444750777268,0.9990444750777276,0,0,2.848454475402832,2.848454475402832,1,1
1711,2,2.4289603009720757,2.4289603009720757,1.000992531235616,1.0009925312356163,0,0,2.921786308288574,2.848454475402832,2,2
1711,3,2.3932200320177017,2.3932200320177017,1.0009922657817394,1.0009922657817392,0,0,2.9253039360046387,2.848454475402832,3,3
1711,4,2.3190008835759275,2.3190008835759275,1.000415604288616,1.0004156042886172,0,0,2.981863498687744,2.848454475402832,4,4
1711,8,2.1366217323467604,2.1706587530860766,1.0031161248310974,1.002144877553169,3,4,3.3460958003997803,2.848454475402832,5,4
1711,16,1.7152342842150288,2.0219323295032856,1.001747450034205,1.0029079894206014,9,10,3.6899044513702393,2.848454475402832,7,6
1711,32,1.0243362107217848,1.8831444990299122,1.0010456718081966,1.0043024058846628,14,24,4.079013347625732,2.848454475402832,18,8
1711,64,0.55127267825258,1.872135307119687,0.9992894846508004,1.0045242418161915,30,54,4.480274677276611,2.848454475402832,34,10
1711,128,0.07837335427474602,1.8095504182882876,0.9992921894584428,1.005790311456596,66,114,5.015351295471191,2.848454475402832,62,14
1712,1,4.101946072708884,4.101946072708885,0.9920235668586763,0.9920235668586771,0,0,4.109372138977051,4.109372138977051,1,1
1712,2,3.5506987244152075,3.5506987244152075,0.9965250914998975,0.9965250914998984,0,0,4.145798683166504,4.109372138977051,2,2
1712,3,3.073488477260993,3.074034862324231,0.9990802705796542,0.9990954105224393,1,1,4.221901893615723,4.109372138977051,2,2
1712,4,2.903630990843588,2.903630990843588,1.000613904962108,1.0006139049621074,0,0,4.222795486450195,4.109372138977051,4,4
1712,8,2.4655472065905517,2.465547206590552,1.0044588045315117,1.00445880453151,0,0,4.4355998039245605,4.109372138977051,8,8
1712,16,2.2633899584217203,2.315745610715178,1.006140366220532,1.0059531094416423,3,5,4.673429489135742,4.109372138977051,13,11
1712,32,1.9922441074796693,2.2531561460072442,1.004674197708567,1.0066115528556596,14,20,5.153713226318359,4.109372138977051,18,12
1712,64,1.0720644078154633,2.1810123403886683,1.001433244640983,1.0080981480898195,33,46,5.556758403778076,4.109372138977051,31,18
1712,128,0.11222059452968117,2.094601506386629,0.9992052000824698,1.010097336930605,66,111,6.057833194732666,4.109372138977051,62,17
1713,1,9.859023442555596,9.859023442555598,0.931532050291211,0.9315320502912133,0,0,10.069998741149902,10.069998741149902,1,1
1713,2,7.632765005497638,7.632765005497638,0.9831312303301512,0.9831312303301534,0,0,10.099653244018555,10.069998741149902,2,2
1713,3,7.347480587056167,7.347480587056167,0.9896023269587965,0.989602326958798,0,0,10.572056770324707,10.069998741149902,3,3
1713,4,7.124281024574375,7.124281024574375,0.9949529055381628,0.9949529055381641,0,0,10.671065330505371,10.069998741149902,4,4
1713,8,6.210850368599681,6.328543623597247,1.0109542454739802,1.0101904195450826,2,2,11.292057037353516,10.069998741149902,6,6
1713,16,5.561962132288107,6.081789010518711,1.0225216481747266,1.018527194545935,6,6,11.681083679199219,10.069998741149902,10,10
1713,32,4.533546770401546,6.04991615349129,1.0190799440044787,1.0199509890354739,16,19,12.616101264953613,10.069998741149902,16,13
1713,64,3.0742426029515775,5.7440825266498265,1.0076076178450466,1.031428296943051,33,53,13.328067779541016,10.069998741149902,31,11
1713,128,1.8713163172414224,5.7147987075233395,0.9990079813558433,1.034500999724083,66,115,14.107251167297363,10.069998741149902,62,13
1714,1,12.074420353833766,12.074420353833766,0.8975461032874882,0.8975461032874912,0,0,12.45344066619873,12.45344066619873,1,1
1714,2,11.135129360317647,11.135129360317645,0.9255299496004968,0.9255299496004983,0,0,12.497743606567383,12.45344066619873,2,2
1714,3,10.083320460314702,10.0833204603147,0.9565260879525305,0.9565260879525301,0,0,12.50525188446045,12.45344066619873,3,3
1714,4,9.408603351049036,9.408603351049035,0.9727614445407201,0.9727614445407196,0,0,12.77863883972168,12.45344066619873,4,4
1714,8,8.022195653753865,8.076755664818759,1.0063866620837794,1.0057498343717932,2,2,13.558382987976074,12.45344066619873,6,6
1714,16,7.2672752705429575,7.441800152665835,1.0314822125004426,1.0278684700192673,3,7,13.893392562866211,12.45344066619873,13,9
1714,32,6.83913378177649,7.4128406019576705,1.0298181327068785,1.0315948210941654,12,19,14.544145584106445,12.45344066619873,20,13
1714,64,5.011768143777919,7.190199377412054,1.0220227957038241,1.0425025822243912,23,49,15.46667194366455,12.45344066619873,41,15
1714,128,3.42923134566569,7.1497150686727755,1.0058527701623976,1.0462129493011074,60,110,16.094221115112305,12.45344066619873,68,18
1715,1,6.75541366259281,6.755413662592811,0.9659659919924521,0.965965991992454,0,0,6.832768440246582,6.832768440246582,1,1
1715,2,5.355791115731901,5.355791115731901,0.9887552760957294,0.9887552760957299,0,0,7.685928821563721,6.832768440246582,2,2
1715,3,5.04839900885142,5.048399008851419,0.995890881525142,0.9958908815251417,0,0,8.29218578338623,6.832768440246582,3,3
1715,4,4.97207323931827,4.972073239318269,0.997141557378191,0.9971415573781911,0,0,8.386003494262695,6.832768440246582,4,4
1715,8,4.663917514534475,4.667817830817982,1.0036647282908433,1.0037194512881464,2,2,8.764816284179688,6.832768440246582,6,6
1715,16,4.0020017502321155,4.099798655995833,1.0151091969867725,1.0147658858991644,4,7,9.416515350341797,6.832768440246582,12,9
1715,32,3.6187028461120345,4.0387436014638975,1.0119316725274443,1.0175439400608683,12,18,10.275156021118164,6.832768440246582,20,14
1715,64,2.955860677825306,3.9576235608371255,1.0083419983927095,1.022087828918074,30,46,11.077938079833984,6.832768440246582,34,18
1715,128,1.9579138971718333,3.899857405651926,1.002068002968913,1.0248385886211775,64,108,11.934813499450684,6.832768440246582,64,20
1716,1,6.269188008496291,6.269188008496294,0.9776362426010483,0.9776362426010491,0,0,6.305267333984375,6.305267333984375,1,1
1716,2,5.15460846460617,5.15460846460617,0.9947186475209723,0.9947186475209728,0,0,6.96450138092041,6.305267333984375,2,2
1716,3,4.969986168932088,4.9699861689320874,0.9968842898743291,0.9968842898743294,0,0,7.43374490737915,6.305267333984375,3,3
1716,4,4.740627880469303,4.740627880469303,1.0009221912852222,1.0009221912852222,0,0,7.684589385986328,6.305267333984375,4,4
1716,8,4.275692172914262,4.383576091368745,1.0066559324935938,1.0071130346695463,2,2,8.192635536193848,6.305267333984375,6,6
1716,16,4.038834532145538,4.18597852820764,1.0140133605645558,1.0131580485664566,4,7,8.675223350524902,6.305267333984375,12,9
1716,32,2.6868599451371975,4.18597852820764,1.0084780496225212,1.0131580485664566,12,23,9.400824546813965,6.305267333984375,20,9
1716,64,1.8829149500776714,4.096375245232973,1.0035263894249562,1.0155141337419868,34,52,9.831704139709473,6.305267333984375,30,12
1716,128,1.088165585416279,4.026447123634553,1.0017345500155543,1.0183165414154365,64,113,10.409130096435547,6.305267333984375,64,15
1717,1,3.057581558557107,3.0575815585571067,0.9969394809148407,0.9969394809148419,0,0,3.0590476989746094,3.0590476989746094,1,1
1717,2,2.6469694852333947,2.6469694852333947,0.9978432971751166,0.997843297175117,0,0,3.1697962284088135,3.0590476989746094,2,2
1717,3,2.3326163602749417,2.3326163602749417,0.9999284386000049,0.9999284386000059,0,0,3.341418504714966,3.0590476989746094,3,3
1717,4,2.3052898404247504,2.3052898404247504,0.9999654763964221,0.9999654763964223,0,0,3.382152795791626,3.0590476989746094,4,4
1717,8,2.193832791981463,2.227993330974313,1.001112936146503,1.0009673126345293,3,4,3.8659019470214844,3.0590476989746094,5,4
1717,16,1.7789757598820461,2.227993330974313,0.9985456212718474,1.0009673126345289,8,12,4.340174198150635,3.0590476989746094,8,4
1717,32,1.199175542685775,2.0591991433935766,1.0006085031892877,1.0035406078378801,13,24,4.769752025604248,3.0590476989746094,19,8
1717,64,0.5099992876502959,2.0384457728546335,0.999166514251064,1.0040847204285095,30,56,5.172693729400635,3.0590476989746094,34,8
1717,128,0.08698850896595722,2.038445772854634,0.9995506676741512,1.0040847204285093,55,120,5.655603408813477,3.0590476989746094,73,8
1718,1,9.761471544617576,9.761471544617578,0.9473183257175509,0.9473183257175525,0,0,9.883782386779785,9.883782386779785,1,1
1718,2,8.946710400059509,8.946710400059509,0.9728503142988683,0.9728503142988689,0,0,11.15861988067627,9.883782386779785,2,2
1718,3,8.624411598419698,8.624411598419698,0.9818139822274247,0.981813982227425,0,0,11.700289726257324,9.883782386779785,3,3
1718,4,7.9875212579053185,7.987521257905318,0.9971302514677314,0.9971302514677307,0,0,11.92158031463623,9.883782386779785,4,4
1718,8,7.230898739525008,7.253890368496068,1.0163651159949296,1.0160004141894596,1,1,12.411943435668945,9.883782386779785,7,7
1718,16,7.059087442023963,7.2082540654077505,1.0170294463995015,1.0183216333476244,7,8,13.601333618164062,9.883782386779785,9,8
1718,32,5.768286622499956,6.943653715831883,1.0210501207340523,1.0298065892452954,14,23,14.182547569274902,9.883782386779785,18,9
1718,64,4.139455914298017,6.924189408061475,1.0114148224558281,1.0308974742291614,31,54,15.118487358093262,9.883782386779785,33,10
1718,128,2.3015007953117688,6.909243467408416,0.9998386592829824,1.0317830167820237,64,115,15.765335083007812,9.883782386779785,64,13
1719,1,10.074806833330662,10.074806833330662,0.9312040861716638,0.9312040861716673,0,0,10.279114723205566,10.279114723205566,1,1
1719,2,9.178760595290088,9.17876059529009,0.9539757127015299,0.9539757127015325,0,0,10.778389930725098,10.279114723205566,2,2
1719,3,7.910270456037896,7.910270456037896,0.9896948612325734,0.9896948612325762,0,0,11.805513381958008,10.279114723205566,3,3
1719,4,7.790111276298938,7.790111276298937,0.9941424169676552,0.9941424169676569,0,0,11.93950366973877,10.279114723205566,4,4
1719,8,7.271392252101795,7.33754292297906,1.008033347416536,1.0066992400542056,2,3,12.327916145324707,10.279114723205566,6,5
1719,16,6.368045413212208,6.5821896532411195,1.0371018648786228,1.0343127296718848,5,6,13.441709518432617,10.279114723205566,11,10
1719,32,5.365423270582158,6.5777700073219005,1.0257389752522774,1.0351450929364157,13,20,14.281949996948242,10.279114723205566,19,12
1719,64,4.28003713035992,6.523531160952177,1.0170902894496592,1.0404117825637342,31,49,15.113420486450195,10.279114723205566,33,15
1719,128,2.855856650999745,6.504680487302891,1.0094287085303248,1.0409061458388875,62,111,16.1024169921875,10.279114723205566,66,17
1720,1,12.37320657482845,12.373206574828453,0.9016387808945611,0.9016387808945636,0,0,12.714215278625488,12.714215278625488,1,1
1720,2,10.798358983649907,10.798358983649909,0.9505495239297456,0.950549523929749,0,0,12.783979415893555,12.714215278625488,2,2
1720,3,10.343476623416528,10.343476623416532,0.9680598951375163,0.9680598951375177,0,0,13.184832572937012,12.714215278625488,3,3
1720,4,10.078730009883518,10.07873000988352,0.9769451009914376,0.9769451009914387,0,0,13.670162200927734,12.714215278625488,4,4
1720,8,8.361678048948736,8.442190413567449,1.021469646211687,1.019723108419683,1,1,13.829553604125977,12.714215278625488,7,7
1720,16,7.772473031397883,8.000514956929056,1.0349200107200334,1.0322660444631708,5,5,14.378057479858398,12.714215278625488,11,11
1720,32,7.148551710226637,7.794177083413797,1.0475183247856092,1.0410393503497353,13,17,14.883030891418457,12.714215278625488,19,15
1720,64,5.430883665990843,7.55551933159245,1.0426906979010804,1.052395964374255,28,47,15.261581420898438,12.714215278625488,36,17
1720,128,3.5522908368279222,7.482106276012972,1.0194750070858252,1.0587070782429147,60,108,15.709708213806152,12.714215278625488,68,20
1721,1,6.713245189568278,6.713245189568277,0.9706940823612399,0.9706940823612413,0,0,6.772258281707764,6.772258281707764,1,1
1721,2,5.806872458671726,5.806872458671726,0.985557695017922,0.9855576950179228,0,0,6.777932643890381,6.772258281707764,2,2
1721,3,5.49474517783048,5.49474517783048,0.9918596004742907,0.9918596004742911,0,0,8.031591415405273,6.772258281707764,3,3
1721,4,5.321560359640704,5.321560359640704,0.9969526163448672,0.996952616344868,0,0,8.246944427490234,6.772258281707764,4,4
1721,8,5.137952008402973,5.137952008402973,1.0057152287486482,1.0057152287486484,0,0,9.321091651916504,6.772258281707764,8,8
1721,16,4.528905949671886,4.654224083808599,1.0189919912771266,1.0204104042984747,4,6,10.7130708694458,6.772258281707764,12,10
1721,32,3.584078612398272,4.5562313193477335,1.0204875205325579,1.023916912013492,11,20,11.393905639648438,6.772258281707764,21,12
1721,64,2.6622029168393166,4.515265970176449,1.0147340938555354,1.0251589054193366,28,52,12.224984169006348,6.772258281707764,36,12
1721,128,1.666417896119951,4.391314230080466,1.0063396393442123,1.0325950250741873,59,112,13.035440444946289,6.772258281707764,69,16
1722,1,9.22824533888013,9.228245338880132,0.9491087727860835,0.9491087727860869,0,0,9.353642463684082,9.353642463684082,1,1
1722,2,7.466050071912843,7.466050071912845,0.9817387739629555,0.9817387739629564,0,0,9.602129936218262,9.353642463684082,2,2
1722,3,7.169219659529237,7.1692196595292375,0.9891462718736758,0.9891462718736757,0,0,9.799483299255371,9.353642463684082,3,3
1722,4,6.8909904146466,6.890990414646601,0.995019445005759,0.9950194450057593,0,0,9.803521156311035,9.353642463684082,4,4
1722,8,6.55647258228143,6.573150900101855,1.0009231588881722,1.0004834425929925,2,2,10.061593055725098,9.353642463684082,6,6
1722,16,6.266009267436456,6.3689959597918016,1.007680331075434,1.0079569646649154,4,7,10.414497375488281,9.353642463684082,12,9
1722,32,5.496817480560813,6.207892992687731,1.019036189878062,1.0127298827320017,13,21,10.899826049804688,9.353642463684082,19,11
1722,64,3.867385881631881,5.963527827131105,1.015111783519324,1.0204227046062733,27,50,11.433708190917969,9.353642463684082,37,14
1722,128,1.7809761937828443,5.929172437459731,1.0022321665777978,1.0238492627821798,64,109,12.196518898010254,9.353642463684082,64,19
1723,1,6.928211752750232,6.928211752750231,0.9734168653821209,0.9734168653821225,0,0,6.973577499389648,6.973577499389648,1,1
1723,2,5.198865232016317,5.198865232016317,0.9996854702620066,0.9996854702620066,0,0,7.984837532043457,6.973577499389648,2,2
1723,3,5.120535821188336,5.120535821188335,1.0016771425282016,1.0016771425282016,0,0,7.999744415283203,6.973577499389648,3,3
1723,4,5.001901434008735,5.001901434008736,1.003395893203252,1.0033958932032525,0,0,8.028645515441895,6.973577499389648,4,4
1723,8,4.480585266941633,4.489033373769007,1.009657191215783,1.0095863173615767,2,2,8.388912200927734,6.973577499389648,6,6
1723,16,3.9483872050062536,4.049112068740285,1.016834408077678,1.0159069143053627,6,8,8.857666015625,6.973577499389648,10,8
1723,32,3.5382181409803746,3.9042981360779536,1.0170469696684028,1.0188916873143892,12,18,9.447035789489746,6.973577499389648,20,14
1723,64,2.61353336678452,3.853073479878392,1.009777441001391,1.0206075234338212,29,45,10.368974685668945,6.973577499389648,35,19
1723,128,1.2888755844838746,3.839173477072605,0.9977839981156376,1.0225425492715075,56,108,11.422195434570312,6.973577499389648,72,20
1724,1,5.795637916899277,5.7956379168992775,0.9832709550188269,0.9832709550188283,0,0,5.817636013031006,5.817636013031006,1,1
1724,2,5.153166465466795,5.153166465466795,0.9931509407287336,0.9931509407287339,0,0,6.432176113128662,5.817636013031006,2,2
1724,3,4.751788334161704,4.751788334161704,1.0009290346925601,1.0009290346925601,0,0,7.454087734222412,5.817636013031006,3,3
1724,4,4.738086310817097,4.738086310817097,1.0012066779933777,1.001206677993378,0,0,7.807420253753662,5.817636013031006,4,4
1724,8,4.337911640108486,4.343862662188522,1.0077101582903882,1.007572992836344,1,2,8.169648170471191,5.817636013031006,7,6
1724,16,4.007147069556011,4.144981339870046,1.0126818048428738,1.011199773462853,4,6,8.598960876464844,5.817636013031006,12,10
1724,32,3.353503178158828,3.959126176381668,1.011644044311789,1.0163256387865627,13,20,9.286494255065918,5.817636013031006,19,12
1724,64,2.6713109386713563,3.9251918982327623,1.0097820968611007,1.0195106753345098,26,47,9.982027053833008,5.817636013031006,38,17
1724,128,1.6430898044505484,3.8573373675899045,1.0021585731284701,1.021208226132901,61,107,10.574371337890625,5.817636013031006,67,21
1725,1,10.245151300452786,10.245151300452788,0.94610009486695,0.9461000948669509,0,0,10.367804527282715,10.367804527282715,1,1
1725,2,8.769503743546034,8.769503743546036,0.981775269284669,0.9817752692846689,0,0,11.068705558776855,10.367804527282715,2,2
1725,3,7.513660648304331,7.513660648304329,1.0113372165168242,1.0113372165168237,0,0,11.907975196838379,10.367804527282715,3,3
1725,4,7.02665049995326,7.026650499953259,1.0202736937292507,1.0202736937292514,0,0,12.099837303161621,10.367804527282715,4,4
1725,8,6.384078828548185,6.42893441272607,1.0279727373096854,1.0276235246081824,2,3,12.176003456115723,10.367804527282715,6,5
1725,16,6.158590436047463,6.304836779761547,1.0362630897499088,1.0337915623530005,3,5,12.839773178100586,10.367804527282715,13,11
1725,32,5.523715609099999,6.076592259897826,1.0467307552271452,1.044728648596095,12,18,13.246052742004395,10.367804527282715,20,14
1725,64,4.265944643175626,6.052363851636615,1.0313704446394283,1.0462680321833857,30,49,13.765380859375,10.367804527282715,34,15
1725,128,2.5391267962491364,6.043758394175912,1.0106554724766752,1.0475581231885727,56,109,14.363853454589844,10.367804527282715,72,19
1726,1,10.54612313791322,10.54612313791322,0.9389583709734901,0.9389583709734924,0,0,10.704410552978516,10.704410552978516,1,1
1726,2,9.278006491870089,9.278006491870089,0.9694659093149943,0.9694659093149962,0,0,10.99305534362793,10.704410552978516,2,2
1726,3,8.944964897757986,8.944964897757984,0.978357033998831,0.9783570339988332,0,0,11.59178352355957,10.704410552978516,3,3
1726,4,8.51757175941026,8.51757175941026,0.9934074356012981,0.9934074356012994,0,0,11.609894752502441,10.704410552978516,4,4
1726,8,7.766258368593225,7.768717245635964,1.013920553132692,1.0133981264942444,1,1,11.994192123413086,10.704410552978516,7,7
1726,16,7.31349483478292,7.502042985899012,1.0247135709830746,1.0212439345107667,5,5,12.660865783691406,10.704410552978516,11,11
1726,32,6.26810239249689,7.192321752512965,1.0306792118567025,1.0310739534760573,13,19,13.035833358764648,10.704410552978516,19,13
1726,64,4.669606625199221,6.95677240527563,1.0262859874539088,1.0428296200339582,27,48,13.595873832702637,10.704410552978516,37,16
1726,128,3.1415853712791004,6.743836309503585,1.0035269399184137,1.0519142787015654,65,111,14.351444244384766,10.704410552978516,63,17
1727,1,7.7921952861087425,7.792195286108743,0.9626977188552213,0.9626977188552222,0,0,7.869271755218506,7.869271755218506,1,1
1727,2,6.589446112778083,6.589446112778083,0.9848647748714445,0.984864774871445,0,0,8.512287139892578,7.869271755218506,2,2
1727,3,5.934164165426743,5.934164165426745,0.994552707767129,0.9945527077671281,0,0,8.61113166809082,7.869271755218506,3,3
1727,4,5.673720711780811,5.673720711780811,1.0002680011669374,1.0002680011669371,0,0,8.9599609375,7.869271755218506,4,4
1727,8,5.27969510263219,5.293870023420318,1.0097188254237097,1.0100914752215397,1,1,9.437313079833984,7.869271755218506,7,7
1727,16,4.98115584308359,5.209265767385421,1.0117553909249244,1.0121911335317124,6,8,10.039544105529785,7.869271755218506,10,8
1727,32,3.968007584234831,4.739656542531045,1.0171089567606002,1.0213644663258121,13,21,10.65284538269043,7.869271755218506,19,11
1727,64,3.3602737433906293,4.624288169898304,1.0136309960110452,1.025751974492319,31,51,11.3653564453125,7.869271755218506,33,13
1727,128,1.8302835792011907,4.489377851396171,1.0036628842787363,1.0315862887601752,61,113,12.367778778076172,7.869271755218506,67,15
1728,1,7.588041777753049,7.58804177775305,0.9653631306328319,0.965363130632833,0,0,7.658575534820557,7.658575534820557,1,1
1728,2,6.34131902471492,6.34131902471492,0.9881246147110274,0.9881246147110275,0,0,7.941775321960449,7.658575534820557,2,2
1728,3,5.820680856626515,5.820680856626515,0.9976487611560743,0.9976487611560738,0,0,8.396404266357422,7.658575534820557,3,3
1728,4,5.716553732167705,5.7165537321677045,1.000134848048157,1.0001348480481573,0,0,8.842976570129395,7.658575534820557,4,4
1728,8,5.479970616695506,5.490306915736108,1.0061286355091124,1.0061020245383532,1,2,9.304824829101562,7.658575534820557,7,6
1728,16,4.974076403605786,5.0312342711648315,1.0172092827317443,1.0182807883483618,5,5,9.908102035522461,7.658575534820557,11,11
1728,32,3.920563008777358,4.905816128007474,1.0186236948178524,1.0233601246302362,15,20,10.556608200073242,7.658575534820557,17,12
1728,64,2.940021751168504,4.790982338625682,1.0102824968218664,1.028168399596766,33,48,11.423301696777344,7.658575534820557,31,16
1728,128,1.6509139397120636,4.763667163969745,1.0041650278961043,1.0299486942249902,64,109,12.270552635192871,7.658575534820557,64,19
1729,1,2.0248797369607034,2.0248797369607034,0.9965463676122891,0.9965463676122899,0,0,2.0277180671691895,2.0277180671691895,1,1
1729,2,1.4518145066812245,1.4518145066812247,0.9976081285745857,0.9976081285745858,0,0,2.399102210998535,2.0277180671691895,2,2
1729,3,1.3925262125351001,1.3925262125351001,0.9984050003292914,0.9984050003292927,0,0,2.608424663543701,2.0277180671691895,3,3
1729,4,1.3458054218278503,1.3458054218278503,0.999120358939109,0.9991203589391099,0,0,2.7032787799835205,2.0277180671691895,4,4
1729,8,1.2562069939947842,1.257316612356943,0.9998428987177188,0.9999008866833865,1,1,3.0246434211730957,2.0277180671691895,7,7
1729,16,1.053677885194377,1.1375007915604376,0.9993389274956526,1.0006897769024583,6,7,3.2710418701171875,2.0277180671691895,10,9
1729,32,0.8832423601029585,1.0704324750399459,1.0004326757707935,1.0016723543986739,14,19,3.7690515518188477,2.0277180671691895,18,13
1729,64,0.42048573020881963,1.0554219900429942,0.9995507089548727,1.0019901341647743,33,47,4.234528064727783,2.0277180671691895,31,17
1729,128,0.07312140723136622,1.0496637859714124,0.9992380822486624,1.0022251831338371,59,111,4.99386739730835,2.0277180671691895,69,17
1730,1,8.18418178333763,8.18418178333763,0.9454995450832847,0.9454995450832849,0,0,8.353009223937988,8.353009223937988,1,1
1730,2,7.792515599815667,7.792515599815666,0.9530613900676823,0.9530613900676828,0,0,8.812865257263184,8.353009223937988,2,2
1730,3,7.734746245529929,7.734746245529929,0.9540995696080852,0.954099569608085,0,0,9.015190124511719,8.353009223937988,3,3
1730,4,7.106961513056781,7.1238886957232745,0.9681697858988707,0.9676587465614483,1,1,9.135946273803711,8.353009223937988,3,3
1730,8,6.786179977336954,6.86749381169076,0.97516671491908,0.9758896324399527,2,2,9.502019882202148,8.353009223937988,6,6
1730,16,6.320866830056771,6.680027308987379,0.9804133798858423,0.9817442804086856,8,10,10.127212524414062,8.353009223937988,8,6
1730,32,5.923292339781082,6.644379643293752,0.9809450776395181,0.9841698422132841,14,23,10.416800498962402,8.353009223937988,18,9
1730,64,5.0325086784493,6.496776645321341,0.9792316531233456,0.9904659127438021,28,51,10.783004760742188,8.353009223937988,36,13
1730,128,4.367235421631216,6.489706435172348,0.9808679760591645,0.9910426070579785,65,112,11.19191837310791,8.353009223937988,63,16
1731,1,13.626874807556101,13.626874807556106,0.8916091656010361,0.8916091656010388,0,0,14.018967628479004,14.018967628479004,1,1
1731,2,12.265760654535093,12.265760654535095,0.9365661404939678,0.9365661404939694,0,0,14.115306854248047,14.018967628479004,2,2
1731,3,11.657319288181192,11.657319288181192,0.9556116312940821,0.9556116312940832,0,0,14.323360443115234,14.018967628479004,3,3
1731,4,11.657152848245843,11.657152848245845,0.9556228203483417,0.9556228203483429,0,0,14.339375495910645,14.018967628479004,4,4
1731,8,11.456142875704735,11.463635639197152,0.966468103557792,0.9660019895664319,1,1,14.621594429016113,14.018967628479004,7,7
1731,16,9.935430872538102,10.09716975017964,1.0103416699756196,1.0104620677743186,5,7,14.95559024810791,14.018967628479004,11,9
1731,32,8.711645754405078,9.740197584265264,1.0318138893009248,1.0254745930245373,12,23,15.371185302734375,14.018967628479004,20,9
1731,64,7.0986027979086215,9.339847288573555,1.041207311943143,1.045360417128631,30,52,15.682154655456543,14.018967628479004,34,12
1731,128,5.260279202298721,9.066327384221063,1.0142414100130974,1.053297232196381,63,112,16.05742835998535,14.018967628479004,65,16
1732,1,11.356049494261763,11.356049494261763,0.9325751292793217,0.932575129279324,0,0,11.537424087524414,11.537424087524414,1,1
1732,2,8.768644417713944,8.768644417713944,0.9940439121226078,0.9940439121226086,0,0,11.549375534057617,11.537424087524414,2,2
1732,3,8.239261393114983,8.239261393114981,1.005733272541679,1.0057332725416788,0,0,11.801671028137207,11.537424087524414,3,3
1732,4,8.062384805439558,8.062384805439558,1.0101954414791094,1.01019544147911,0,0,11.885176658630371,11.537424087524414,4,4
1732,8,7.9688871117579465,8.04561104703237,1.0104173635037685,1.011923879519214,2,3,13.685334205627441,11.537424087524414,6,5
1732,16,7.470483609562044,7.625147494475782,1.0265391831647,1.0290327303716553,4,8,14.836649894714355,11.537424087524414,12,8
1732,32,5.948461047204857,6.976584944028148,1.039031378512546,1.0561840951849748,10,18,15.69077205657959,11.537424087524414,22,14
1732,64,4.762239214682131,6.892449658003489,1.0261722950103613,1.060040838059203,26,47,16.60297966003418,11.537424087524414,38,17
1732,128,3.2487751834627026,6.804187124875871,1.0074410205981446,1.0691620495754794,64,111,17.360992431640625,11.537424087524414,64,17
1733,1,9.893262426100929,9.89326242610093,0.9391319501752965,0.9391319501752985,0,0,10.05603313446045,10.05603313446045,1,1
1733,2,8.418584475927986,8.418584475927988,0.9775958086444408,0.9775958086444411,0,0,10.243338584899902,10.05603313446045,2,2
1733,3,8.13685155869045,8.136851558690449,0.9823721790409708,0.9823721790409716,0,0,10.260384559631348,10.05603313446045,3,3
1733,4,7.129519245244893,7.129519245244893,1.0018520739995145,1.0018520739995158,0,0,10.352089881896973,10.05603313446045,4,4
1733,8,6.420933793577725,6.420933793577725,1.0160308756467282,1.0160308756467282,0,0,10.838315963745117,10.05603313446045,8,8
1733,16,5.580485293491161,5.703566090751822,1.033519539302092,1.0309156719879202,5,6,11.236570358276367,10.05603313446045,11,10
1733,32,5.1079843752957315,5.597413775828729,1.0327864203147317,1.0328739600728691,15,19,11.765278816223145,10.05603313446045,17,13
1733,64,4.149802687223391,5.523039613600458,1.0246359223059622,1.0374413860935114,30,44,12.558756828308105,10.05603313446045,34,20
1733,128,2.425567189652127,5.4694657832287,1.004853147835698,1.0405812414694338,63,105,13.278215408325195,10.05603313446045,65,23
1734,1,3.525123355330671,3.5251233553306713,0.9927060950515191,0.9927060950515205,0,0,3.5322437286376953,3.5322437286376953,1,1
1734,2,3.0695944115141045,3.0695944115141045,0.9950604115116297,0.9950604115116304,0,0,3.6397299766540527,3.5322437286376953,2,2
1734,3,2.874086853347547,2.874086853347547,0.9970444736978594,0.9970444736978592,0,0,4.030808925628662,3.5322437286376953,3,3
1734,4,2.4913530026324153,2.4913530026324153,0.9979764359930174,0.9979764359930176,0,0,4.237856388092041,3.5322437286376953,4,4
1734,8,2.2950430347709525,2.491037960859639,0.9977771438921094,0.9980440509105342,2,2,4.778308391571045,3.5322437286376953,6,6
1734,16,1.8581268953809227,2.3619452985815803,1.000981061324997,0.9998844375035274,8,11,5.144602298736572,3.5322437286376953,8,5
1734,32,1.2758293446048916,2.0115351610454777,1.0019578760941228,1.0046758360692118,14,20,5.674038887023926,3.5322437286376953,18,12
1734,64,0.9501030853578835,1.9866995680207093,0.9990106462297924,1.0054839755611964,29,48,6.604201793670654,3.5322437286376953,35,16
1734,128,0.43714788263621535,1.98669956802071,0.9984040507340392,1.0054839755611964,58,112,7.213998317718506,3.5322437286376953,70,16
1735,1,6.332516424754934,6.332516424754935,0.9767872574278692,0.9767872574278703,0,0,6.371431827545166,6.371431827545166,1,1
1735,2,4.726928437432278,4.726928437432278,0.9967008065399887,0.996700806539989,0,0,6.394413948059082,6.371431827545166,2,2
1735,3,4.019792878431155,4.019792878431154,1.003812739697271,1.0038127396972714,0,0,6.532690525054932,6.371431827545166,3,3
1735,4,4.008523446611654,4.008523446611655,1.004032891741611,1.0040328917416108,0,0,6.5992021560668945,6.371431827545166,4,4
1735,8,3.606324957232479,3.6231453016230635,1.012563779997667,1.0121171079652447,1,2,7.203917026519775,6.371431827545166,7,6
1735,16,3.452505993472873,3.5653928610953427,1.014088579469643,1.0145281371990205,5,6,7.361330032348633,6.371431827545166,11,10
1735,32,3.0650727985305593,3.3574060707306668,1.015142375704025,1.0157413122987804,15,19,7.812607288360596,6.371431827545166,17,13
1735,64,2.263799132254263,3.196590429393088,1.0135177443463383,1.0196810176416329,26,50,8.363300323486328,6.371431827545166,38,14
1735,128,1.0994779174430471,3.1711239435574536,1.0012520195300885,1.0198915438919394,59,112,8.92453384399414,6.371431827545166,69,16
1736,1,9.591323674443467,9.59132367444347,0.9420684915149196,0.9420684915149208,0,0,9.748507499694824,9.748507499694824,1,1
1736,2,8.223387883778479,8.223387883778479,0.972778220955567,0.9727782209555678,0,0,10.275277137756348,9.748507499694824,2,2
1736,3,8.029007986663931,8.029007986663933,0.9776502086299335,0.977650208629934,0,0,10.463690757751465,9.748507499694824,3,3
1736,4,7.566014131337004,7.566014131337004,0.9880102913321497,0.9880102913321497,0,0,10.466763496398926,9.748507499694824,4,4
1736,8,7.318519466384998,7.323458486323362,0.9945158572339393,0.9946927919993624,1,2,10.751562118530273,9.748507499694824,7,6
1736,16,6.63616601431381,6.903055418722859,1.0130762227312213,1.009340595617707,3,6,11.36918830871582,9.748507499694824,13,10
1736,32,5.623085599633113,6.5113586830563985,1.0180943538446705,1.0196461374375727,10,22,11.910369873046875,9.748507499694824,22,10
1736,64,4.854482031119547,6.37448298345158,1.006842346706281,1.0241826133118743,26,54,12.371748924255371,9.748507499694824,38,10
1736,128,2.9189633866670412,6.238227482884509,1.0060774074006675,1.030881671513967,64,117,12.893387794494629,9.748507499694824,64,11
1737,1,3.7779336152194434,3.7779336152194434,0.9896811125078198,0.9896811125078206,0,0,3.7914044857025146,3.7914044857025146,1,1
1737,2,2.689004450300962,2.689004450300962,0.997279665238858,0.9972796652388589,0,0,3.8238227367401123,3.7914044857025146,2,2
1737,3,2.347243793071868,2.347243793071868,0.9986186000770565,0.9986186000770574,0,0,3.845142126083374,3.7914044857025146,3,3
1737,4,2.339135657554441,2.339135657554441,0.9986491697124131,0.9986491697124135,0,0,4.242695331573486,3.7914044857025146,4,4
1737,8,2.260125880647196,2.2699832984242057,0.9999361201638088,1.000232284738527,2,3,4.577380180358887,3.7914044857025146,6,5
1737,16,2.174194639907027,2.255883087868257,1.0006979274268892,1.000622560521131,7,8,4.827647686004639,3.7914044857025146,9,8
1737,32,1.4635174763512293,2.220228631164439,1.0009503046229455,1.001558458493355,13,25,5.215455055236816,3.7914044857025146,19,7
1737,64,0.9373258554436521,2.1739187637588513,1.0005471306480116,1.0028181597728156,31,53,5.5701904296875,3.7914044857025146,33,11
1737,128,0.1022076375987483,2.1002713280173935,0.9988504061233583,1.004120469249353,63,115,6.065950393676758,3.7914044857025146,65,13
1738,1,7.795828836232164,7.795828836232163,0.9712043787372845,0.9712043787372872,0,0,7.843588352203369,7.843588352203369,1,1
1738,2,5.1670401456016775,5.1670401456016775,1.009460793107607,1.0094607931076078,0,0,8.147313117980957,7.843588352203369,2,2
1738,3,5.082417535762479,5.082417535762479,1.0110538236697424,1.011053823669743,0,0,8.375065803527832,7.843588352203369,3,3
1738,4,5.082398602908231,5.082398602908233,1.0110497591068341,1.0110497591068355,0,0,8.500798225402832,7.843588352203369,4,4
1738,8,4.671523024809592,4.762159290517216,1.0152891927879806,1.0151936139388664,2,2,9.112882614135742,7.843588352203369,6,6
1738,16,4.203437619271758,4.413367982818156,1.0214828498433586,1.0229387580994262,7,7,9.55700397491455,7.843588352203369,9,9
1738,32,3.637077483171925,4.398777475624232,1.0154589948740012,1.0239893311902646,15,21,10.34642505645752,7.843588352203369,17,11
1738,64,3.073092813432717,4.32185315826742,1.0117922769982481,1.026743191564049,34,49,11.027371406555176,7.843588352203369,30,15
1738,128,1.8079215013056524,4.318312399587246,1.002594699891068,1.0274616257710716,56,113,11.874773025512695,7.843588352203369,72,15
1739,1,10.042755185221885,10.042755185221885,0.9373336298783896,0.9373336298783915,0,0,10.216239929199219,10.216239929199219,1,1
1739,2,7.670788026869044,7.670788026869046,0.9918019772159923,0.9918019772159947,0,0,10.284820556640625,10.216239929199219,2,2
1739,3,7.314706493899426,7.314706493899426,0.9977794422619969,0.9977794422619997,0,0,10.418583869934082,10.216239929199219,3,3
1739,4,6.873231890775732,6.873231890775733,1.0077572265198742,1.007757226519876,0,0,10.44462776184082,10.216239929199219,4,4
1739,8,6.490872766860434,6.603527509556732,1.0110208995329968,1.0102029655060485,2,2,10.841726303100586,10.216239929199219,6,6
1739,16,6.097945787562885,6.4217975462155295,1.0155439099443466,1.013748100590584,5,9,11.344222068786621,10.216239929199219,11,7
1739,32,5.6294474222159,6.2699179471799305,1.0251201898007538,1.0203699677327807,13,21,11.83328628540039,10.216239929199219,19,11
1739,64,4.284715782276527,6.146241106943489,1.0201067449052805,1.0282420937239989,27,50,12.263142585754395,10.216239929199219,37,14
1739,128,2.4315571561278304,5.989057876421259,1.0065175110044666,1.0349077534826683,60,112,12.824795722961426,10.216239929199219,68,16
1740,1,7.220499585618234,7.220499585618236,0.9680395319991434,0.9680395319991447,0,0,7.2827982902526855,7.2827982902526855,1,1
1740,2,6.634624286229964,6.634624286229964,0.9807710762966444,0.9807710762966453,0,0,8.040184020996094,7.2827982902526855,2,2
1740,3,5.868760961321276,5.868760961321276,0.9926469625431629,0.9926469625431633,0,0,8.404329299926758,7.2827982902526855,3,3
1740,4,4.880424644722893,4.880424644722893,1.0062690886654864,1.006269088665487,0,0,8.546442031860352,7.2827982902526855,4,4
1740,8,4.606309446124644,4.6357156529247545,1.010642075724547,1.0106317427962708,2,2,9.066183090209961,7.2827982902526855,6,6
1740,16,4.030558986160794,4.1498052698741486,1.0178477974239162,1.0187565357528043,4,6,9.59793472290039,7.2827982902526855,12,10
1740,32,3.4233699764819194,4.079617176182763,1.015945278693766,1.020713814139128,14,20,10.650971412658691,7.2827982902526855,18,12
1740,64,2.6640837861646323,4.04613378455096,1.0078931887240594,1.022663741197121,32,51,11.360998153686523,7.2827982902526855,32,13
1740,128,1.7442979616707115,4.032074565555903,1.0019219515709827,1.0244256420950386,62,114,12.138082504272461,7.2827982902526855,66,14
1741,1,8.149827631400905,8.149827631400905,0.9608291275109097,0.9608291275109108,0,0,8.235469818115234,8.235469818115234,1,1
1741,2,6.308407682604526,6.308407682604526,0.9894697516296309,0.9894697516296318,0,0,8.467205047607422,8.235469818115234,2,2
1741,3,6.265161014569456,6.265161014569455,0.9900544264055279,0.9900544264055281,0,0,8.522480010986328,8.235469818115234,3,3
1741,4,5.971066250691007,5.971066250691008,0.9925455311231088,0.9925455311231105,0,0,8.635945320129395,8.235469818115234,4,4
1741,8,5.854346681216159,5.854346681216159,0.9960463574805517,0.9960463574805531,0,0,9.14235782623291,8.235469818115234,8,8
1741,16,5.174681520182903,5.455273984181122,1.000346817758221,1.0041555300442817,7,8,9.859875679016113,8.235469818115234,9,8
1741,32,4.1633579766104925,5.162696876886474,1.0082655196127377,1.0129084023755923,13,22,10.33593463897705,8.235469818115234,19,10
1741,64,3.009721795681379,5.10777154904018,1.0050549392333479,1.0147988170028641,32,53,10.700222969055176,8.235469818115234,32,11
1741,128,1.8552867832546298,4.882057726897313,1.002870787078873,1.0211720600462546,58,113,11.318442344665527,8.235469818115234,70,15
1742,1,4.316973129038318,4.316973129038318,0.9866655941116731,0.9866655941116739,0,0,4.335878372192383,4.335878372192383,1,1
1742,2,3.830877932351519,3.8308779323515183,0.9936232956152113,0.993623295615212,0,0,4.949775218963623,4.335878372192383,2,2
1742,3,3.3244647672437715,3.3244647672437715,0.9998618260015771,0.9998618260015777,0,0,5.05409574508667,4.335878372192383,3,3
1742,4,2.9842432158681573,2.9842432158681578,1.004828240382261,1.0048282403822615,0,0,6.036526679992676,4.335878372192383,4,4
1742,8,2.591190285487243,2.6211652765580737,1.0084842306880497,1.00870022406175,2,2,6.613616943359375,4.335878372192383,6,6
1742,16,2.3878341198895097,2.5531174454286822,1.0067902427787319,1.0097157852886867,7,9,7.357609272003174,4.335878372192383,9,7
1742,32,1.9318023001061442,2.530505185455511,1.004404598781978,1.010753592354657,17,24,7.95671272277832,4.335878372192383,15,8
1742,64,1.397833284635214,2.4875125521131207,1.0007092888250733,1.0123341294752677,33,53,8.529175758361816,4.335878372192383,31,11
1742,128,0.742009006865817,2.478229355136614,0.9996051766952971,1.0128736868137806,58,115,9.30318832397461,4.335878372192383,70,13
1743,1,8.553148840487411,8.553148840487406,0.9607130431751272,0.9607130431751288,0,0,8.63460636138916,8.63460636138916,1,1
1743,2,6.821276090614816,6.821276090614817,0.9949285858123141,0.9949285858123156,0,0,8.803849220275879,8.63460636138916,2,2
1743,3,5.568105810279627,5.568105810279626,1.0128309519489938,1.0128309519489949,0,0,8.92469596862793,8.63460636138916,3,3
1743,4,5.493579193559132,5.493579193559135,1.0142570214853026,1.0142570214853035,0,0,9.049656867980957,8.63460636138916,4,4
1743,8,5.014063889073522,5.0140638890735225,1.0225169327529415,1.022516932752941,0,0,9.489394187927246,8.63460636138916,8,8
1743,16,4.284069813855357,4.38054306045523,1.0314966538312504,1.030631054655933,3,5,9.789040565490723,8.63460636138916,13,11
1743,32,4.008997226890054,4.311624163589294,1.0342120413687275,1.032458572632311,12,16,10.1813325881958,8.63460636138916,20,16
1743,64,2.90725274032746,4.2545136594374355,1.0181241557863048,1.03438486743008,26,44,10.721091270446777,8.63460636138916,38,20
1743,128,1.9084417097937616,4.246248214098458,1.0044183871687267,1.0348200034115316,57,105,11.45114517211914,8.63460636138916,71,23
1744,1,10.104837740829304,10.104837740829309,0.9344097092433373,0.9344097092433394,0,0,10.300119400024414,10.300119400024414,1,1
1744,2,9.496988252925162,9.496988252925165,0.9460822798569384,0.94608227985694,0,0,10.611682891845703,10.300119400024414,2,2
1744,3,9.40487832013351,9.404878320133513,0.9485980799120329,0.9485980799120342,0,0,10.958076477050781,10.300119400024414,3,3
1744,4,8.11173400962249,8.111734009622491,0.9814982506561837,0.9814982506561853,0,0,11.038902282714844,10.300119400024414,4,4
1744,8,7.178220397762378,7.2037420324742705,1.0002808921342723,1.0004772164134794,2,2,11.5243558883667,10.300119400024414,6,6
1744,16,6.253801185269188,6.66664008397823,1.0147024490741015,1.0130261624424222,8,10,11.780192375183105,10.300119400024414,8,6
1744,32,5.53279240171511,6.42000045204877,1.0287320929657544,1.0221834741907165,16,23,12.307415008544922,10.300119400024414,16,9
1744,64,4.3016614151963335,6.342651136845175,1.029413344114864,1.027655921251588,33,51,12.70711898803711,10.300119400024414,31,13
1744,128,2.6463824453970637,6.098209696668666,1.0117859780325,1.0357371746276538,60,113,13.094673156738281,10.300119400024414,68,15
1745,1,8.650474478043735,8.650474478043737,0.9594998449633965,0.959499844963397,0,0,8.739235877990723,8.739235877990723,1,1
1745,2,7.666007515050328,7.666007515050327,0.9749208906290348,0.9749208906290343,0,0,8.99284553527832,8.739235877990723,2,2
1745,3,7.277905973935142,7.277905973935142,0.9830998320155304,0.9830998320155304,0,0,9.322341918945312,8.739235877990723,3,3
1745,4,7.258261942524709,7.277905973935142,0.9829257376564258,0.9830998320155304,1,1,9.397790908813477,8.739235877990723,3,3
1745,8,7.064810525108678,7.069478434738498,0.9894943409475672,0.989797828903672,1,1,9.499686241149902,8.739235877990723,7,7
1745,16,5.826607931869017,6.194177753270093,1.014322598812836,1.0092638405684857,4,6,9.700499534606934,8.739235877990723,12,10
1745,32,4.838945039557648,5.642376967745276,1.0165366658150736,1.01704739120808,17,23,10.00570297241211,8.739235877990723,15,9
1745,64,3.8583171159184344,5.51259984141491,1.0090207669802709,1.0210285792044145,27,51,10.322011947631836,8.739235877990723,37,13
1745,128,2.515634191562556,5.424900141730424,1.0015204988468476,1.0228747479648745,61,115,10.649398803710938,8.739235877990723,67,13
1746,1,6.269458883746672,6.269458883746651,0.9803433157135741,0.9803433157135754,0,0,6.297306537628174,6.297306537628174,1,1
1746,2,5.649835616749521,5.649835616749521,0.9921969140000703,0.9921969140000713,0,0,7.231649875640869,6.297306537628174,2,2
1746,3,4.972606362284974,4.972606362284974,1.0011806202635765,1.0011806202635771,0,0,7.7284255027771,6.297306537628174,3,3
1746,4,4.925376641846728,4.925376641846728,1.002396830867095,1.0023968308670954,0,0,7.763121128082275,6.297306537628174,4,4
1746,8,4.111155398981538,4.312542480492203,1.0102009948965258,1.0076905208872855,2,2,8.070669174194336,6.297306537628174,6,6
1746,16,3.9606951807523547,4.15444105848601,1.0129005342547373,1.011759687953948,6,7,8.597447395324707,6.297306537628174,10,9
1746,32,3.339469727646822,4.1157924172964515,1.0134413875314867,1.012943453502276,15,18,9.223026275634766,6.297306537628174,17,14
1746,64,2.1802902029006117,4.093897287832813,1.0064579340674031,1.0145522633464885,29,47,9.899153709411621,6.297306537628174,35,17
1746,128,1.2949718848885714,3.9798318919939804,1.0015295301323373,1.0211263830314403,65,111,10.677316665649414,6.297306537628174,63,17
1747,1,9.624679038974334,9.624679038974334,0.9503269397024017,0.9503269397024026,0,0,9.739261627197266,9.739261627197266,1,1
1747,2,8.149915554921378,8.149915554921378,0.9807121204288319,0.980712120428832,0,0,9.835164070129395,9.739261627197266,2,2
1747,3,6.611606023514062,6.611606023514062,1.0056452672175706,1.0056452672175704,0,0,9.872761726379395,9.739261627197266,3,3
1747,4,5.907183728657982,5.907183728657982,1.012537498972216,1.0125374989722178,0,0,9.929945945739746,9.739261627197266,4,4
1747,8,4.871650135745908,4.919025572070433,1.0288665653737394,1.0278654169713513,1,1,9.998788833618164,9.739261627197266,7,7
1747,16,4.74402042768934,4.8445256938015255,1.0304507279257558,1.0287108267606275,4,6,10.326360702514648,9.739261627197266,12,10
1747,32,4.4267891700170825,4.701242502945261,1.0322095526399182,1.0319973748731504,13,18,10.707825660705566,9.739261627197266,19,14
1747,64,3.5456059247840375,4.698578259690088,1.030528890472077,1.0323935428087863,28,49,11.104324340820312,9.739261627197266,36,15
1747,128,2.3347286805511507,4.584564627786385,1.0144388276874898,1.0380059858108797,62,109,11.645942687988281,9.739261627197266,66,19
1748,1,11.747485581556024,11.747485581556028,0.9060262498361763,0.9060262498361787,0,0,12.075393676757812,12.075393676757812,1,1
1748,2,10.619739254530565,10.619739254530566,0.9423870713102775,0.9423870713102795,0,0,12.860612869262695,12.075393676757812,2,2
1748,3,10.16480826353568,10.164808263535681,0.9596219488927532,0.959621948892754,0,0,12.917163848876953,12.075393676757812,3,3
1748,4,9.937820625318885,9.937820625318887,0.9675774853533247,0.9675774853533264,0,0,13.476116180419922,12.075393676757812,4,4
1748,8,9.22574029202138,9.225981149421637,0.9876676632195588,0.987657391820054,1,1,13.733712196350098,12.075393676757812,7,7
1748,16,8.271750812774862,8.60498884536498,1.0118470865729037,1.0064170730818773,7,7,14.252058029174805,12.075393676757812,9,9
1748,32,7.239671503884916,8.574280829013944,1.0106660734872501,1.0076387970720595,12,23,14.760955810546875,12.075393676757812,20,9
1748,64,5.609137838074926,8.463345396301113,1.01372656275162,1.0138596689045916,29,54,15.35693073272705,12.075393676757812,35,10
1748,128,3.6830707507342826,7.822712615149786,1.0106359309085633,1.0423663201190583,61,113,15.913847923278809,12.075393676757812,67,15
1749,1,10.965216119648408,10.965216119648408,0.9227550343211302,0.9227550343211312,0,0,11.207805633544922,11.207805633544922,1,1
1749,2,9.899314024634231,9.899314024634231,0.9500455842784536,0.9500455842784536,0,0,11.356996536254883,11.207805633544922,2,2
1749,3,9.563268087965982,9.563268087965982,0.956271185319464,0.9562711853194642,0,0,11.484293937683105,11.207805633544922,3,3
1749,4,8.88546704428337,8.88546704428337,0.9743252303766873,0.9743252303766872,0,0,11.528613090515137,11.207805633544922,4,4
1749,8,8.360374459246106,8.37094478602149,0.9882886863915659,0.987895904650376,1,1,11.75531005859375,11.207805633544922,7,7
1749,16,7.37150394363888,7.640955759122031,1.0102801914071105,1.0099352372427393,6,7,12.38874626159668,11.207805633544922,10,9
1749,32,6.3085894661472075,7.520199715901344,1.0168682839456622,1.013891628578929,14,21,12.777548789978027,11.207805633544922,18,11
1749,64,5.118659041415396,7.366044897248689,1.0214074042065986,1.0233764483488277,27,47,13.35218620300293,11.207805633544922,37,17
1749,128,3.2608951974997353,7.150924810841567,1.0061164938330815,1.0347193525691605,63,113,13.92475414276123,11.207805633544922,65,15
1750,1,3.2740350782528886,3.2740350782528886,0.989477510005205,0.9894775100052059,0,0,3.290187358856201,3.290187358856201,1,1
1750,2,3.084944045386649,3.084944045386649,0.9916060319197448,0.9916060319197457,0,0,3.5513248443603516,3.290187358856201,2,2
1750,3,3.071809532104379,3.071809532104379,0.9915775811066196,0.9915775811066201,0,0,3.6739895343780518,3.290187358856201,3,3
1750,4,3.0532928692800043,3.0532928692800043,0.9919986485902172,0.9919986485902178,0,0,3.8031342029571533,3.290187358856201,4,4
1750,8,2.7145819477779853,2.717238921803849,0.9956239831104543,0.995517389739816,1,3,4.1311163902282715,3.290187358856201,7,5
1750,16,2.319241668558423,2.5454535639467544,0.9967497913230963,0.9969699372033805,7,12,4.314385414123535,3.290187358856201,9,4
1750,32,1.703131197362245,2.4388355171032354,0.9982274505685292,0.9977883870153055,14,24,4.686710357666016,3.290187358856201,18,8
1750,64,1.0367757824222237,2.3961060749590946,0.9971220978553578,0.9991045867107697,31,56,5.064064025878906,3.290187358856201,33,8
1750,128,0.28290310554128106,2.370604566770776,0.9976200002489457,0.9999248904900228,60,117,5.394241809844971,3.290187358856201,68,11
1751,1,8.295024500552312,8.29502450055231,0.9593791215636209,0.959379121563622,0,0,8.385049819946289,8.385049819946289,1,1
1751,2,7.3996086725263295,7.3996086725263295,0.9787004266514425,0.9787004266514423,0,0,8.937718391418457,8.385049819946289,2,2
1751,3,5.946313882960153,5.946313882960153,1.000052085411813,1.0000520854118125,0,0,9.074319839477539,8.385049819946289,3,3
1751,4,5.765842711478207,5.765842711478208,1.0036702656839824,1.0036702656839822,0,0,9.278889656066895,8.385049819946289,4,4
1751,8,5.170595974616488,5.1705959746164885,1.0127613647550788,1.0127613647550777,0,0,9.399236679077148,8.385049819946289,8,8
1751,16,4.668351011291642,4.9753599023579556,1.0155110805555971,1.015232777522954,6,8,9.892645835876465,8.385049819946289,10,8
1751,32,3.899905127367306,4.9657050743775395,1.0131255226128126,1.0155198990286922,13,23,10.507607460021973,8.385049819946289,19,9
1751,64,2.5547011733360927,4.89428711980895,1.004528011103303,1.019406477215854,29,52,11.096918106079102,8.385049819946289,35,12
1751,128,1.7128727010801925,4.875109986955798,0.9982250892698712,1.0214031822126564,57,111,11.870466232299805,8.385049819946289,71,17
1752,1,11.999709894367168,11.999709894367168,0.9075973113624866,0.9075973113624882,0,0,12.316804885864258,12.316804885864258,1,1
1752,2,9.484780308493011,9.484780308493011,0.9768652228057411,0.9768652228057422,0,0,12.68470287322998,12.316804885864258,2,2
1752,3,9.18468658773475,9.184686587734753,0.9828001064414666,0.9828001064414682,0,0,12.714080810546875,12.316804885864258,3,3
1752,4,9.030001724419801,9.030001724419803,0.9879348211993366,0.9879348211993377,0,0,13.43453598022461,12.316804885864258,4,4
1752,8,8.480986384980824,8.575768386660123,1.0019044326186393,1.001478064605215,3,3,13.486469268798828,12.316804885864258,5,5
1752,16,8.221043167160113,8.561930925970339,1.0044616976525267,1.0023936289227517,7,9,13.888160705566406,12.316804885864258,9,7
1752,32,7.524232755059385,8.409243193268859,1.0165144335508307,1.0106164663579746,16,24,14.141327857971191,12.316804885864258,16,8
1752,64,6.276856307576234,8.397716271056055,1.0276980123395507,1.0130287265705644,36,48,14.621728897094727,12.316804885864258,28,16
1752,128,3.6010557430864902,8.106439702410704,1.0100489203720708,1.0301478176176246,62,115,15.143620491027832,12.316804885864258,66,13
1753,1,10.240208577672615,10.240208577672613,0.9372201969839574,0.93722019698396,0,0,10.412727355957031,10.412727355957031,1,1
1753,2,9.542032500568386,9.542032500568387,0.9618404665420585,0.9618404665420599,0,0,12.1067476272583,10.412727355957031,2,2
1753,3,8.661086545934847,8.661086545934847,0.9842107601207499,0.9842107601207508,0,0,12.11905574798584,10.412727355957031,3,3
1753,4,8.530682457607611,8.53068245760761,0.9883166972003928,0.9883166972003952,0,0,12.522021293640137,10.412727355957031,4,4
1753,8,7.779533203969652,8.21514471238768,1.0050309594985702,0.9987935841428548,1,1,13.218749046325684,10.412727355957031,7,7
1753,16,7.271930119129845,7.571826694554796,1.0253569971122134,1.0258105261025858,4,5,14.0725736618042,10.412727355957031,12,11
1753,32,5.888892499703881,7.236409000321369,1.0253637403412206,1.0358249750973436,12,20,14.660806655883789,10.412727355957031,20,12
1753,64,4.441022947434704,7.196034553994148,1.0143885877903074,1.0387440950894475,29,47,15.362630844116211,10.412727355957031,35,17
1753,128,2.894855351551504,6.861898266676979,1.0077204142350147,1.0497347025035433,69,116,16.090850830078125,10.412727355957031,59,12
1754,1,7.782260595183712,7.782260595183715,0.965034099402858,0.9650340994028603,0,0,7.853368282318115,7.853368282318115,1,1
1754,2,6.661719830183652,6.661719830183654,0.9870730977062074,0.9870730977062089,0,0,8.72912311553955,7.853368282318115,2,2
1754,3,6.5216231006111025,6.5216231006111025,0.9906574702036847,0.9906574702036852,0,0,8.786772727966309,7.853368282318115,3,3
1754,4,6.341240337446802,6.341240337446802,0.995836768313229,0.9958367683132303,0,0,9.320476531982422,7.853368282318115,4,4
1754,8,5.804489529736056,5.809465996989127,1.0078222512824986,1.00803408452904,1,1,9.933098793029785,7.853368282318115,7,7
1754,16,5.333223620198035,5.406146435064269,1.02068595447996,1.0209295817547157,6,6,10.391526222229004,7.853368282318115,10,10
1754,32,4.329949114565677,5.391555420794727,1.0054434619649615,1.0214929107393746,17,22,10.937446594238281,7.853368282318115,15,10
1754,64,3.2777115863591737,5.359065968102732,1.0060014871486491,1.0227307878923848,33,52,11.401571273803711,7.853368282318115,31,12
1754,128,2.1514238445961835,5.299581368412494,1.0023023586005557,1.0253881257067632,68,117,12.113875389099121,7.853368282318115,60,11
1755,1,7.382901659866903,7.382901659866904,0.9635618005311036,0.9635618005311055,0,0,7.464243412017822,7.464243412017822,1,1
1755,2,6.237457171683168,6.23745717168317,0.9824318345058229,0.9824318345058247,0,0,7.59290075302124,7.464243412017822,2,2
1755,3,6.225782420937462,6.225782420937464,0.9829588014555195,0.9829588014555207,0,0,8.026846885681152,7.464243412017822,3,3
1755,4,5.92067390196428,5.927001119140165,0.9872532590487536,0.9874092375860621,1,1,8.066543579101562,7.464243412017822,3,3
1755,8,4.967825569346544,5.092324349415468,1.004793296801198,1.0037557889554156,1,2,8.246810913085938,7.464243412017822,7,6
1755,16,4.255492537202741,4.905634832321353,1.0129746267014035,1.0080730995137537,3,6,8.608016014099121,7.464243412017822,13,10
1755,32,3.7837777117349676,4.521252996005599,1.017478341359816,1.016176586700778,12,20,9.105610847473145,7.464243412017822,20,12
1755,64,2.7118611920044815,4.301268258222275,1.0112650189159096,1.0211484516433948,27,50,9.537222862243652,7.464243412017822,37,14
1755,128,1.5322552232239224,4.285768338323541,1.0015980206264938,1.0220369115280163,55,112,10.252429962158203,7.464243412017822,73,16
1756,1,7.285430577104191,7.285430577104192,0.9646891508050787,0.9646891508050813,0,0,7.362256050109863,7.362256050109863,1,1
1756,2,5.921136820519089,5.92113682051909,0.9885031847246388,0.9885031847246413,0,0,7.4805097579956055,7.362256050109863,2,2
1756,3,5.920070128252772,5.920070128252773,0.9886696557427425,0.9886696557427451,0,0,8.30496597290039,7.362256050109863,3,3
1756,4,5.608587698393369,5.608779654095692,0.9953017611293898,0.9953566616776647,1,1,8.315347671508789,7.362256050109863,3,3
1756,8,5.27138180284325,5.302234507861941,1.0030911714744544,1.0032875931159158,2,2,8.733604431152344,7.362256050109863,6,6
1756,16,4.1622082037919546,4.750381380561144,1.0157579951888793,1.014793144515497,7,5,9.258851051330566,7.362256050109863,9,11
1756,32,3.665403719291059,4.377464024299771,1.018031900141002,1.0231045122706248,15,17,10.066804885864258,7.362256050109863,17,15
1756,64,2.457526532838194,4.234760618233746,1.009245867136443,1.0283311540321418,28,48,10.801671981811523,7.362256050109863,36,16
1756,128,1.6984435050502222,4.14830297569028,1.0022609162696245,1.0300501536152993,58,111,11.752309799194336,7.362256050109863,70,17
1757,1,9.509114024485276,9.50911402448527,0.9526596878157733,0.9526596878157741,0,0,9.611594200134277,9.611594200134277,1,1
1757,2,7.768908067748709,7.76890806774871,0.9875959744807641,0.987595974480767,0,0,9.832769393920898,9.611594200134277,2,2
1757,3,7.711183022747043,7.7111830227470435,0.9890568703709987,0.9890568703710019,0,0,10.729578971862793,9.611594200134277,3,3
1757,4,7.612497777952062,7.612497777952056,0.9923532995512715,0.9923532995512738,0,0,10.844883918762207,9.611594200134277,4,4
1757,8,6.759431267113471,6.781763056848933,1.0119510583733657,1.0113498009816526,1,1,11.132231712341309,9.611594200134277,7,7
1757,16,5.799854955836761,6.253082373541864,1.0257559665040672,1.0243408398963383,5,8,11.849967002868652,9.611594200134277,11,8
1757,32,4.976901607426634,6.029933134495458,1.0294908060851085,1.0343309795102613,14,23,12.487600326538086,9.611594200134277,18,9
1757,64,3.632512347033369,5.948318825046096,1.0164318625291917,1.037177615447703,34,49,13.22088623046875,9.611594200134277,30,15
1757,128,2.272153608528237,5.938400606999819,1.00526659056904,1.0390333852624587,59,112,13.770968437194824,9.611594200134277,69,16
1758,1,10.377053564794712,10.377053564794714,0.9371730452683164,0.9371730452683189,0,0,10.540608406066895,10.540608406066895,1,1
1758,2,9.231434960493337,9.231434960493338,0.9700381407894856,0.9700381407894877,0,0,11.089777946472168,10.540608406066895,2,2
1758,3,8.997251519942523,8.997251519942509,0.9747666223147371,0.9747666223147393,0,0,11.119244575500488,10.540608406066895,3,3
1758,4,8.605416111219439,8.605416111219439,0.9869862999085826,0.9869862999085843,0,0,11.503216743469238,10.540608406066895,4,4
1758,8,7.776074150402786,7.877770202751577,1.006645346443742,1.0057081664870953,1,1,12.288656234741211,10.540608406066895,7,7
1758,16,7.108437166821548,7.5487540330839105,1.0229146885807792,1.0192114783662887,4,5,12.791993141174316,10.540608406066895,12,11
1758,32,5.74885290158585,6.9091701670410055,1.0456357104171605,1.0394709137352314,10,16,13.832862854003906,10.540608406066895,22,16
1758,64,4.793662600501084,6.824603793256872,1.028267492720662,1.0433554291613467,24,47,14.710676193237305,10.540608406066895,40,17
1758,128,2.7558868519685285,6.805412995275367,1.0075311317584295,1.0476926382809248,55,111,15.711581230163574,10.540608406066895,73,17
1759,1,10.15280378990246,10.152803789902466,0.9459624253426406,0.9459624253426429,0,0,10.281272888183594,10.281272888183594,1,1
1759,2,9.666304754310069,9.666304754310072,0.9585688287292213,0.958568828729223,0,0,11.007486343383789,10.281272888183594,2,2
1759,3,9.475651127454702,9.4756511274547,0.9658092071571208,0.965809207157122,0,0,12.210186004638672,10.281272888183594,3,3
1759,4,9.2163816040175,9.216381604017494,0.9734069345848232,0.9734069345848257,0,0,12.224048614501953,10.281272888183594,4,4
1759,8,7.569941904858571,7.575550629188233,1.0216274342752496,1.0211732050400064,1,1,12.609050750732422,10.281272888183594,7,7
1759,16,7.093699247960244,7.537802980945738,1.0195594378504071,1.0228375983303648,7,7,13.329988479614258,10.281272888183594,9,9
1759,32,6.465797553812348,7.389449088809758,1.0305645321724213,1.0277714885115043,14,22,13.829806327819824,10.281272888183594,18,10
1759,64,4.576367853155668,7.180713604906584,1.0182937869249344,1.0403224472603627,28,52,14.499634742736816,10.281272888183594,36,12
1759,128,2.9024466128938693,7.081789587064745,1.009551331130417,1.0465762691817753,64,112,15.073013305664062,10.281272888183594,64,16
1760,1,8.830441245704646,8.830441245704648,0.9566087740786965,0.9566087740786978,0,0,8.923946380615234,8.923946380615234,1,1
1760,2,7.263671447547756,7.2636714475477575,0.9884303159183532,0.9884303159183532,0,0,8.992327690124512,8.923946380615234,2,2
1760,3,7.095082308118371,7.09508230811837,0.9930509573334374,0.9930509573334377,0,0,9.761533737182617,8.923946380615234,3,3
1760,4,6.708444598210224,6.708444598210223,1.001660199812628,1.0016601998126287,0,0,9.813370704650879,8.923946380615234,4,4
1760,8,6.453137433354425,6.51007813567532,1.0046737065116025,1.0050503201811951,2,1,10.237420082092285,8.923946380615234,6,7
1760,16,6.009789460947597,6.252386130125018,1.0175525234438296,1.0153790780881846,5,6,10.461464881896973,8.923946380615234,11,10
1760,32,4.984092424991207,5.521776764031311,1.0317139481520718,1.0300447306607001,15,20,11.014914512634277,8.923946380615234,17,12
1760,64,3.939904045693071,5.378098901197592,1.023667405168384,1.0358412731059548,29,48,11.494732856750488,8.923946380615234,35,16
1760,128,2.3435989526537204,5.367850271196117,1.0029253353830196,1.0370149915864508,65,109,12.36913013458252,8.923946380615234,63,19
1761,1,10.500187190504713,10.500187190504699,0.9443495403523322,0.9443495403523361,0,0,10.630685806274414,10.630685806274414,1,1
1761,2,8.89106898837973,8.891068988379732,0.9809867117423067,0.9809867117423083,0,0,11.00737190246582,10.630685806274414,2,2
1761,3,8.299403398553999,8.299403398554,0.9935713310246317,0.9935713310246335,0,0,11.139548301696777,10.630685806274414,3,3
1761,4,8.21898330185938,8.21898330185938,0.9956813316498411,0.9956813316498432,0,0,11.223061561584473,10.630685806274414,4,4
1761,8,7.215108579147651,7.215108579147651,1.0182471610267532,1.0182471610267534,0,0,12.119070053100586,10.630685806274414,8,8
1761,16,6.42642716958006,6.570313267373971,1.0330167459104875,1.03600102797998,3,6,12.840731620788574,10.630685806274414,13,10
1761,32,5.468197480358318,6.150945172228914,1.031847265057506,1.0474742899483729,9,16,13.440143585205078,10.630685806274414,23,16
1761,64,4.335594182466591,6.133973928836084,1.023407953624984,1.048554980807217,30,46,14.278775215148926,10.630685806274414,34,18
1761,128,2.5159478786504286,6.07943598861873,1.0045918446572817,1.0520615447798245,65,109,15.116043090820312,10.630685806274414,63,19
1762,1,8.777766398492258,8.777766398492261,0.953323243087656,0.9533232430876583,0,0,8.886486053466797,8.886486053466797,1,1
1762,2,7.673722821081772,7.673722821081774,0.9837635576881144,0.9837635576881156,0,0,10.380343437194824,8.886486053466797,2,2
1762,3,6.732425462794133,6.732425462794133,1.0061665741938377,1.0061665741938377,0,0,11.121932983398438,8.886486053466797,3,3
1762,4,6.617585351693474,6.6175853516934735,1.011852967280278,1.0118529672802785,0,0,11.812887191772461,8.886486053466797,4,4
1762,8,6.392559668204761,6.3989896532152315,1.0180386787670734,1.0189514927657979,2,2,12.57806396484375,8.886486053466797,6,6
1762,16,6.060236728962001,6.3989896532152315,1.0182821984429642,1.0189514927657979,6,10,13.430286407470703,8.886486053466797,10,6
1762,32,5.680800952890265,6.364498407434576,1.0195653267117986,1.0217424508836768,14,23,13.846782684326172,8.886486053466797,18,9
1762,64,4.475106118045114,6.248857864584345,1.010645919565938,1.0300906537000847,31,52,14.71849536895752,8.886486053466797,33,12
1762,128,3.097503170959633,6.217156227637331,1.0064935284344092,1.0334276946100203,59,115,15.793242454528809,8.886486053466797,69,13
1763,1,9.49419896062634,9.494198960626338,0.9248204097786088,0.9248204097786115,0,0,9.753342628479004,9.753342628479004,1,1
1763,2,8.340610293734361,8.340610293734361,0.955019804416843,0.955019804416845,0,0,9.895263671875,9.753342628479004,2,2
1763,3,7.435260991711863,7.435260991711863,0.9770292851635993,0.9770292851636007,0,0,10.308771133422852,9.753342628479004,3,3
1763,4,7.068040710763221,7.068040710763219,0.9853539460899026,0.9853539460899038,0,0,10.353721618652344,9.753342628479004,4,4
1763,8,6.715599984067228,6.725346852251914,0.9953931951030979,0.9950869039029249,3,3,10.98237133026123,9.753342628479004,5,5
1763,16,6.056933146533807,6.257136040598342,1.0116298402292516,1.0082479095165577,6,8,11.570253372192383,9.753342628479004,10,8
1763,32,5.43454875776347,6.062084307746126,1.025751144703276,1.016636571933744,11,17,11.8994722366333,9.753342628479004,21,15
1763,64,4.156365791111897,5.859789630783326,1.0180257740561478,1.0237216135386236,28,50,12.493473052978516,9.753342628479004,36,14
1763,128,2.477467317249371,5.7043962483290995,1.0055271145327058,1.032295043179939,58,110,13.379109382629395,9.753342628479004,70,18
1764,1,7.1792850384073255,7.179285038407328,0.9614811638370174,0.9614811638370195,0,0,7.274886131286621,7.274886131286621,1,1
1764,2,6.3610609876837305,6.361060987683732,0.9779103724525278,0.9779103724525298,0,0,7.8343353271484375,7.274886131286621,2,2
1764,3,6.344562753174742,6.344562753174744,0.978814872078993,0.9788148720789944,0,0,7.903328895568848,7.274886131286621,3,3
1764,4,6.186096277754955,6.186096277754957,0.981536593666518,0.9815365936665199,0,0,7.950934410095215,7.274886131286621,4,4
1764,8,4.808379128702427,4.843562585756814,1.00423009242165,1.004729051176249,2,3,8.255526542663574,7.274886131286621,6,5
1764,16,4.198255306527304,4.6573387451417405,1.0092007874811821,1.0072541612578398,6,10,8.857254981994629,7.274886131286621,10,6
1764,32,3.8021594513457884,4.534356206142806,1.0121080736222652,1.0098048739394798,12,25,9.378226280212402,7.274886131286621,20,7
1764,64,2.241602643720505,4.488846868241784,1.0071139843053285,1.0114648272265674,30,54,9.892398834228516,7.274886131286621,34,10
1764,128,1.1279427676594,4.488846868241784,1.000175563333873,1.0114648272265674,61,118,10.494790077209473,7.274886131286621,67,10
1765,1,10.545985005101052,10.54598500510105,0.9482469493018416,0.9482469493018436,0,0,10.657746315002441,10.657746315002441,1,1
1765,2,9.40381174447429,9.403811744474291,0.9729811237030987,0.9729811237031,0,0,11.102594375610352,10.657746315002441,2,2
1765,3,8.43559834029169,8.43559834029169,0.9914778292516235,0.9914778292516219,0,0,11.129952430725098,10.657746315002441,3,3
1765,4,8.426308662925694,8.43559834029169,0.9916432850857613,0.9914778292516219,1,1,11.169984817504883,10.657746315002441,3,3
1765,8,7.397538453533178,7.524632130559967,1.0093204213339497,1.0081802047579629,2,2,11.574640274047852,10.657746315002441,6,6
1765,16,6.741253197802095,7.041261287270069,1.0213503543504974,1.020043011282338,6,9,12.078885078430176,10.657746315002441,10,7
1765,32,5.46212663939459,6.524965804260193,1.0318978353694808,1.0344749109574218,14,23,12.724693298339844,10.657746315002441,18,9
1765,64,3.953792719835354,6.120914232280661,1.021030411258363,1.0446142352964116,32,51,13.287026405334473,10.657746315002441,32,13
1765,128,2.3689920355340934,6.120913397495425,1.0037492735951388,1.0446191077836544,68,115,13.941841125488281,10.657746315002441,60,13
1766,1,7.890024736347667,7.890024736347667,0.9681985541247916,0.9681985541247932,0,0,7.947482109069824,7.947482109069824,1,1
1766,2,5.271100092912423,5.271100092912422,1.0059942856028132,1.0059942856028163,0,0,8.007842063903809,7.947482109069824,2,2
1766,3,5.055493167828161,5.055493167828161,1.0091106680371984,1.0091106680372006,0,0,8.634961128234863,7.947482109069824,3,3
1766,4,5.037201231386069,5.037201231386069,1.009825766152596,1.0098257661525984,0,0,8.884909629821777,7.947482109069824,4,4
1766,8,4.843294945869326,4.861770445795029,1.013622563824589,1.0136407941588252,1,1,9.026046752929688,7.947482109069824,7,7
1766,16,4.239666898925819,4.300308271324227,1.0258286286820821,1.0246609300859133,4,7,9.604536056518555,7.947482109069824,12,9
1766,32,3.682220614065348,4.294064878111176,1.0177548415515223,1.0254273099928257,13,19,10.792852401733398,7.947482109069824,19,13
1766,64,3.04745332309419,4.27433436257683,1.012010395700575,1.0269652387543986,28,47,11.52835464477539,7.947482109069824,36,17
1766,128,1.7883490795585848,4.176844608762347,1.0001923020731798,1.030619057333574,64,114,12.451637268066406,7.947482109069824,64,14
1767,1,8.100161496361245,8.100161496361245,0.9674580400810298,0.9674580400810301,0,0,8.158775329589844,8.158775329589844,1,1
1767,2,7.04800122521692,7.048001225216921,0.9877018723069647,0.9877018723069646,0,0,8.75903034210205,8.158775329589844,2,2
1767,3,7.028176277032388,7.0281762770323875,0.9879436305000714,0.9879436305000708,0,0,8.801138877868652,8.158775329589844,3,3
1767,4,6.614111922555043,6.619725473838973,0.993990231522661,0.9938829191036473,1,1,8.883695602416992,8.158775329589844,3,3
1767,8,6.518510583064507,6.566977601180191,0.9961111366859444,0.9951658206527847,3,3,9.176615715026855,8.158775329589844,5,5
1767,16,5.292914925652986,5.621264874745485,1.017722745592817,1.0118611415281118,4,9,9.475841522216797,8.158775329589844,12,7
1767,32,4.8632413128222645,5.41376756412051,1.0187836189006378,1.017478181467307,13,18,9.899056434631348,8.158775329589844,19,14
1767,64,3.6712542006633764,4.903129827419471,1.0200519780051198,1.02331575199644,30,49,10.475488662719727,8.158775329589844,34,15
1767,128,2.519810876756535,4.7693813226700525,1.0123448941499515,1.027241103430233,68,112,10.972078323364258,8.158775329589844,60,16
1768,1,8.33610687990521,8.33610687990521,0.9618488979731954,0.9618488979731956,0,0,8.414081573486328,8.414081573486328,1,1
1768,2,6.881575554953478,6.881575554953478,0.9901049092714833,0.9901049092714838,0,0,8.962716102600098,8.414081573486328,2,2
1768,3,6.217789200458626,6.217789200458626,1.0015115781523312,1.0015115781523312,0,0,8.995244026184082,8.414081573486328,3,3
1768,4,5.8645001856681045,5.8645001856681045,1.0076792823649048,1.0076792823649043,0,0,9.308834075927734,8.414081573486328,4,4
1768,8,5.54885011049659,5.548850110496589,1.0128664080265228,1.0128664080265233,0,0,9.560007095336914,8.414081573486328,8,8
1768,16,5.39949127796912,5.405804195327782,1.017236182509712,1.0171632226774294,2,2,9.847562789916992,8.414081573486328,14,14
1768,32,4.473507645103552,4.983202480315504,1.0238911064561789,1.026177707062943,13,17,10.368441581726074,8.414081573486328,19,15
1768,64,2.9875020344677212,4.787739393255832,1.0118224207908206,1.0299339251770805,27,48,10.994038581848145,8.414081573486328,37,16
1768,128,1.7955892479385285,4.709900394316309,1.0023544740496764,1.0309717498122117,61,109,11.513941764831543,8.414081573486328,67,19
1769,1,10.076075328048077,10.076075328048079,0.9388329132095539,0.9388329132095555,0,0,10.243386268615723,10.243386268615723,1,1
1769,2,6.806903017392748,6.806903017392748,1.007026653797051,1.0070266537970527,0,0,10.4561128616333,10.243386268615723,2,2
1769,3,6.734064457803715,6.734064457803715,1.009002583104165,1.0090025831041665,0,0,10.72195816040039,10.243386268615723,3,3
1769,4,6.682115448538542,6.682115448538541,1.0109339710716807,1.010933971071682,0,0,11.346567153930664,10.243386268615723,4,4
1769,8,5.916065535807423,5.9292014595282385,1.0264062158223046,1.026413872514503,2,2,11.627497673034668,10.243386268615723,6,6
1769,16,5.627327924852253,5.913122273891151,1.025615014123812,1.0279695181147985,7,9,12.458640098571777,10.243386268615723,9,7
1769,32,4.640681216332463,5.688885458536445,1.0314468778955106,1.0362986348271808,16,24,13.41114330291748,10.243386268615723,16,8
1769,64,3.153152788351253,5.681812613054277,1.0090748158095648,1.0374234576130554,29,54,14.272808074951172,10.243386268615723,35,10
1769,128,2.3431225577519825,5.642733140396447,1.0071979352358489,1.042219943384968,60,115,15.126035690307617,10.243386268615723,68,13
1770,1,9.202095553165236,9.202095553165234,0.9541204496067036,0.9541204496067067,0,0,9.30062484741211,9.30062484741211,1,1
1770,2,7.706087913564449,7.70608791356445,0.9821148431352799,0.9821148431352809,0,0,9.42406177520752,9.30062484741211,2,2
1770,3,6.812414678579662,6.812414678579663,0.9965555981247015,0.9965555981247023,0,0,9.581768035888672,9.30062484741211,3,3
1770,4,6.788240608410066,6.788240608410066,0.9972194854505626,0.9972194854505628,0,0,9.755938529968262,9.30062484741211,4,4
1770,8,6.050234434896457,6.075644423548733,1.011710371265991,1.0119135875455345,1,1,10.0968599319458,9.30062484741211,7,7
1770,16,5.539712790673505,5.673478586337633,1.0192395129309668,1.021331954158161,6,6,10.817821502685547,9.30062484741211,10,10
1770,32,4.965147954428647,5.526636266232327,1.0195385600954732,1.0265583856727611,13,19,11.42701244354248,9.30062484741211,19,13
1770,64,3.5217553081677893,5.488558103825905,1.00856332190605,1.0292765913157167,31,49,12.215614318847656,9.30062484741211,33,15
1770,128,2.0247263923875254,5.4814439006031215,1.0022305384632673,1.030421829278029,61,110,13.092164039611816,9.30062484741211,67,18
1771,1,15.388332796479064,15.388332796479062,0.8577534119313038,0.8577534119313045,0,0,15.939987182617188,15.939987182617188,1,1
1771,2,14.495590010453315,14.495590010453316,0.8930953847025562,0.8930953847025564,0,0,16.02500343322754,15.939987182617188,2,2
1771,3,11.735205490373117,11.735205490373117,0.9920159863138407,0.9920159863138388,0,0,16.177438735961914,15.939987182617188,3,3
1771,4,11.61817775074877,11.618177750748767,0.9953636841884972,0.9953636841884967,0,0,16.22555160522461,15.939987182617188,4,4
1771,8,11.4304666314558,11.44775139532768,1.0018491110083045,1.0009179117193647,1,2,16.56514549255371,15.939987182617188,7,6
1771,16,9.853206639894795,10.555299417030694,1.033546510517726,1.0282500470068474,3,10,17.11174964904785,15.939987182617188,13,6
1771,32,9.24184062535604,10.279857326532406,1.0387135707881734,1.0389235300755562,12,22,17.546693801879883,15.939987182617188,20,10
1771,64,7.377608270114131,9.695000963775804,1.0556351116502047,1.0619304272714887,34,53,17.947633743286133,15.939987182617188,30,11
1771,128,5.331324520479242,9.54186574264345,1.0428252373335631,1.0718151527120467,60,114,18.397457122802734,15.939987182617188,68,14
1772,1,8.924796383235094,8.924796383235096,0.9547850059835596,0.9547850059835629,0,0,9.024627685546875,9.024627685546875,1,1
1772,2,7.826503683486692,7.826503683486692,0.9772054663016017,0.9772054663016039,0,0,9.033132553100586,9.024627685546875,2,2
1772,3,7.543394514962544,7.543394514962542,0.9847711515529286,0.9847711515529298,0,0,9.632963180541992,9.024627685546875,3,3
1772,4,7.014121310466712,7.014121310466713,0.9958717001072644,0.9958717001072661,0,0,10.02697467803955,9.024627685546875,4,4
1772,8,6.239197826590025,6.288534645255726,1.013476857456318,1.011700018557197,2,3,10.269065856933594,9.024627685546875,6,5
1772,16,6.041779395163259,6.18821318293034,1.0156587284236085,1.014093866569677,5,8,10.758309364318848,9.024627685546875,11,8
1772,32,5.221213211925987,5.837725911024935,1.0227168487108862,1.0254457211918564,15,20,11.368301391601562,9.024627685546875,17,12
1772,64,3.677030519849201,5.797139003730559,1.0093252765696097,1.028973859168754,31,48,11.933732986450195,9.024627685546875,33,16
1772,128,2.139626678836364,5.435923112010669,1.0018543720040145,1.0406537355785852,63,110,12.567366600036621,9.024627685546875,65,18
1773,1,8.742034262706897,8.742034262706897,0.9488652478377105,0.9488652478377141,0,0,8.871070861816406,8.871070861816406,1,1
1773,2,7.362926608599357,7.362926608599358,0.9815866747930695,0.9815866747930725,0,0,10.165411949157715,8.871070861816406,2,2
1773,3,7.282880190320032,7.282880190320033,0.9840349077307463,0.9840349077307485,0,0,10.238000869750977,8.871070861816406,3,3
1773,4,7.227945462975396,7.227945462975396,0.9866138960329903,0.9866138960329922,0,0,10.264700889587402,8.871070861816406,4,4
1773,8,6.665540016163508,6.891806336664234,1.002028004761283,0.996711030743008,1,1,10.903128623962402,8.871070861816406,7,7
1773,16,5.737298724741276,6.246867006298503,1.0160202058312566,1.0115224326363732,4,8,11.267448425292969,8.871070861816406,12,8
1773,32,4.787181541180799,5.822797917711059,1.024279569551845,1.0244959978401824,13,18,11.921518325805664,8.871070861816406,19,14
1773,64,3.8410075711920735,5.731847769121077,1.0100651144848414,1.0293888749326088,32,48,12.625014305114746,8.871070861816406,32,16
1773,128,2.4822761795460098,5.687741121292768,1.0005718460412045,1.0329630641758127,59,112,13.946802139282227,8.871070861816406,69,16
1774,1,11.874088668721644,11.874088668721644,0.9086606499510879,0.9086606499510896,0,0,12.18850326538086,12.18850326538086,1,1
1774,2,9.799969357300672,9.799969357300672,0.9622227492036356,0.9622227492036367,0,0,12.470643997192383,12.18850326538086,2,2
1774,3,9.287181666491602,9.287181666491604,0.9774952566965072,0.977495256696508,0,0,12.505000114440918,12.18850326538086,3,3
1774,4,8.889258710750092,8.889258710750092,0.985858360145571,0.9858583601455712,0,0,12.672208786010742,12.18850326538086,4,4
1774,8,8.553045306061277,8.553045306061279,0.9943624077756895,0.9943624077756957,0,0,13.000884056091309,12.18850326538086,8,8
1774,16,8.065028275514507,8.29015065764319,1.0039379160277246,1.0024394744373422,5,6,13.500908851623535,12.18850326538086,11,10
1774,32,6.766730687206929,8.104103857167466,1.011184936245687,1.010027105000925,13,23,14.04041862487793,12.18850326538086,19,9
1774,64,4.741591118355661,7.699466856270305,1.0144878793280925,1.0280353132604843,33,51,14.50647258758545,12.18850326538086,31,13
1774,128,2.8759445378174795,7.526476462512328,1.007401569052202,1.034219577683605,61,112,15.02513313293457,12.18850326538086,67,16
1775,1,5.386712084790872,5.386712084790873,0.9914295412572612,0.9914295412572629,0,0,5.392829418182373,5.392829418182373,1,1
1775,2,5.32616252530443,5.326162525304431,0.9934225059520598,0.9934225059520612,0,0,6.732982635498047,5.392829418182373,2,2
1775,3,5.052082477192963,5.074349578819257,0.9979434812466901,0.9980179993024965,1,1,7.18615198135376,5.392829418182373,2,2
1775,4,5.051956818647125,5.074349578819257,0.9980004474767628,0.9980179993024965,1,2,7.5433502197265625,5.392829418182373,3,2
1775,8,4.647283038706816,4.664406913720748,1.0081908500968197,1.0080607199719538,1,2,7.766605854034424,5.392829418182373,7,6
1775,16,3.6511748342647734,4.114317845102609,1.016974271775633,1.0171339361661649,7,6,8.633442878723145,5.392829418182373,9,10
1775,32,3.128539987756529,4.070256637225896,1.012772707269506,1.0183354938818967,15,20,9.128220558166504,5.392829418182373,17,12
1775,64,2.178198882598578,3.829298307473692,1.0087041508109504,1.0251207581070851,28,48,9.724066734313965,5.392829418182373,36,16
1775,128,1.2649387023701135,3.825786208982776,1.0031685444165719,1.0256478993096803,65,112,10.463805198669434,5.392829418182373,63,16
1776,1,10.82284090820881,10.822840908208809,0.929619220989852,0.9296192209898544,0,0,11.023082733154297,11.023082733154297,1,1
1776,2,9.183850408144993,9.183850408144993,0.9758285527711203,0.9758285527711211,0,0,11.276459693908691,11.023082733154297,2,2
1776,3,8.319021476973171,8.319021476973171,0.9928931230799241,0.9928931230799252,0,0,11.518671035766602,11.023082733154297,3,3
1776,4,8.073462984606442,8.073462984606442,0.999389123486805,0.9993891234868053,0,0,11.678503036499023,11.023082733154297,4,4
1776,8,7.6990693532169105,7.7390974726714505,1.004757089975779,1.003923741715163,1,1,11.886921882629395,11.023082733154297,7,7
1776,16,6.592612876643492,6.768837123516215,1.031509900640898,1.029165889223529,5,6,12.304110527038574,11.023082733154297,11,10
1776,32,5.62442273444853,6.504251160169961,1.034424011271811,1.037392655757229,12,21,13.09086799621582,11.023082733154297,20,11
1776,64,4.7479896858484105,6.276512802524906,1.03739557727928,1.0428783589112605,25,50,13.857649803161621,11.023082733154297,39,14
1776,128,3.027293801337466,6.264238170584501,1.0089918490566654,1.0447103982670172,58,112,14.663094520568848,11.023082733154297,70,16
1777,1,11.272588088380397,11.272588088380399,0.9154095016394743,0.9154095016394758,0,0,11.544800758361816,11.544800758361816,1,1
1777,2,9.499428192340048,9.499428192340046,0.9612679803471442,0.9612679803471442,0,0,11.707133293151855,11.544800758361816,2,2
1777,3,9.408549163534959,9.408549163534959,0.9649680042959614,0.9649680042959615,0,0,12.214893341064453,11.544800758361816,3,3
1777,4,9.348615138838579,9.348615138838577,0.9667391323408379,0.9667391323408381,0,0,12.265439987182617,11.544800758361816,4,4
1777,8,8.674159124663568,8.783831232948904,0.9841001168867707,0.9844552612274667,2,2,12.534153938293457,11.544800758361816,6,6
1777,16,8.30159125633188,8.58471726684693,0.997121325045951,0.9931940928672127,6,7,13.092270851135254,11.544800758361816,10,9
1777,32,6.723340278586457,7.7270316343048115,1.034979506119382,1.0271343364980272,12,19,13.64310359954834,11.544800758361816,20,13
1777,64,5.084222076547622,7.438102813011116,1.0297264950527856,1.0412938113899874,29,51,14.656720161437988,11.544800758361816,35,13
1777,128,3.2448730175453058,7.418514842303107,1.008051834404373,1.0421070117074138,63,116,15.543190002441406,11.544800758361816,65,12
1778,1,8.455590380960626,8.455590380960627,0.9548221804283931,0.9548221804283946,0,0,8.562812805175781,8.562812805175781,1,1
1778,2,6.443380946899341,6.443380946899341,0.9968940168605092,0.996894016860511,0,0,9.21406364440918,8.562812805175781,2,2
1778,3,6.376482394563194,6.376482394563194,0.9983452158894447,0.998345215889446,0,0,9.79769229888916,8.562812805175781,3,3
1778,4,5.911921405413458,5.913760644257916,1.009069307570925,1.0090052716632953,1,1,9.846925735473633,8.562812805175781,3,3
1778,8,5.461842781353539,5.49954500100453,1.0175090807122371,1.016842154641647,2,2,10.145398139953613,8.562812805175781,6,6
1778,16,4.738112819895229,5.096851884851804,1.027387626316313,1.0252466989396885,5,7,10.320295333862305,8.562812805175781,11,9
1778,32,4.196235699198053,4.835193158096169,1.0338120464300171,1.0308428500914932,14,20,10.929802894592285,8.562812805175781,18,12
1778,64,3.030673759866515,4.764867007203481,1.0173220066057689,1.0328903831608438,25,47,11.425650596618652,8.562812805175781,39,17
1778,128,1.883128715858517,4.751350822891737,1.0038620590215301,1.0344329746914394,64,109,11.894879341125488,8.562812805175781,64,19
1779,1,9.733809933284057,9.733809933284059,0.9470407229501965,0.947040722950198,0,0,9.863606452941895,9.863606452941895,1,1
1779,2,8.701831845146334,8.701831845146334,0.9670082954575618,0.9670082954575628,0,0,9.863921165466309,9.863606452941895,2,2
1779,3,8.51566594491296,8.51566594491296,0.9718662668266131,0.9718662668266134,0,0,10.086669921875,9.863606452941895,3,3
1779,4,7.561428339475225,7.561428339475224,0.9954099126146063,0.9954099126146064,0,0,10.16696834564209,9.863606452941895,4,4
1779,8,6.514528853842772,6.535895896582177,1.0159511525277911,1.0165192398415788,2,2,10.897256851196289,9.863606452941895,6,6
1779,16,6.123460885006608,6.311475081080286,1.0229911660346427,1.0223468205068236,4,8,11.294331550598145,9.863606452941895,12,8
1779,32,5.245327390923754,6.142210534232772,1.024448563733894,1.0282823151465104,16,21,11.938074111938477,9.863606452941895,16,11
1779,64,4.046305429759729,6.010243750234967,1.0125887756141807,1.0338019305064592,29,53,12.571944236755371,9.863606452941895,35,11
1779,128,2.717298308928953,6.00835648365297,1.0008272681075703,1.0338395689563313,66,117,13.343907356262207,9.863606452941895,62,11
1780,1,8.641895850266215,8.641895850266216,0.9564328259220327,0.9564328259220349,0,0,8.737105369567871,8.737105369567871,1,1
1780,2,7.762839813747277,7.762839813747277,0.9766289813277927,0.9766289813277942,0,0,9.216561317443848,8.737105369567871,2,2
1780,3,7.018624933074825,7.0186249330748245,0.9928772061589553,0.9928772061589554,0,0,9.454802513122559,8.737105369567871,3,3
1780,4,7.008874482295081,7.00887448229508,0.9932268735846866,0.9932268735846872,0,0,9.746055603027344,8.737105369567871,4,4
1780,8,5.987972019467246,6.159779491704159,1.0129787359017084,1.0085489685229034,2,2,10.426239013671875,8.737105369567871,6,6
1780,16,5.7342086235072545,6.047834585516728,1.0139890309338357,1.012501670649852,8,8,10.834081649780273,8.737105369567871,8,8
1780,32,4.838879410426885,5.760382074658546,1.0221266242143254,1.0227625422679922,16,22,11.598075866699219,8.737105369567871,16,10
1780,64,3.6709515265520447,5.746274509956164,1.0133601401039674,1.0241297525843822,32,51,12.304936408996582,8.737105369567871,32,13
1780,128,2.5777571057022213,5.643391988537214,1.0012461332273799,1.0300871797470705,61,112,13.11405086517334,8.737105369567871,67,16
1781,1,7.68911469919572,7.689114699195721,0.9741953200138064,0.9741953200138076,0,0,7.727628707885742,7.727628707885742,1,1
1781,2,6.450103847430497,6.450103847430497,0.9930983947120374,0.9930983947120383,0,0,8.402265548706055,7.727628707885742,2,2
1781,3,6.050575869847123,6.050575869847122,0.9980216128068606,0.9980216128068609,0,0,8.616389274597168,7.727628707885742,3,3
1781,4,6.031968827361075,6.031968827361076,0.9987268071283097,0.9987268071283102,0,0,8.798460006713867,7.727628707885742,4,4
1781,8,5.312548040904067,5.312548040904066,1.009921854855734,1.009921854855735,0,0,9.140054702758789,7.727628707885742,8,8
1781,16,4.84814689049389,4.992676514313622,1.0165840590101474,1.0152351326032698,7,7,9.605669021606445,7.727628707885742,9,9
1781,32,4.23498358827697,4.539554843948671,1.0215584941376112,1.025758637773162,13,19,10.210288047790527,7.727628707885742,19,13
1781,64,2.919884051165604,4.5069603135298895,1.010913218134158,1.0270875830351267,30,48,10.910239219665527,7.727628707885742,34,16
1781,128,1.822644582653586,4.500914941055748,1.0006111552372374,1.0280644046467942,66,110,11.763862609863281,7.727628707885742,62,18
1782,1,4.246900452319898,4.246900452319893,0.9884802203949016,0.9884802203949039,0,0,4.26184606552124,4.26184606552124,1,1
1782,2,2.5138649100307626,2.513864910030763,1.0019399050008997,1.0019399050009008,0,0,4.431292533874512,4.26184606552124,2,2
1782,3,1.8834144930506884,1.883414493050688,1.005625782867236,1.0056257828672377,0,0,4.432587146759033,4.26184606552124,3,3
1782,4,1.8494292167266593,1.8494292167266588,1.005983647148211,1.0059836471482115,0,0,4.49387264251709,4.26184606552124,4,4
1782,8,1.7271776134183214,1.7318745686218768,1.0077797851601178,1.007722161372255,1,1,4.732057094573975,4.26184606552124,7,7
1782,16,1.531025882147466,1.627742268780785,1.0076089526066654,1.0083835333239388,4,8,5.077265739440918,4.26184606552124,12,8
1782,32,1.2102646167892916,1.5722623393301112,1.0059224010559633,1.0090940827953476,14,21,5.372049808502197,4.26184606552124,18,11
1782,64,0.7765936162002466,1.555907239590344,1.0026706756510375,1.0095696985979592,28,52,5.885806083679199,4.26184606552124,36,12
1782,128,0.1681766047589382,1.5536179208483614,1.000026427842771,1.009714868416507,68,117,6.571285724639893,4.26184606552124,60,11
1783,1,7.288907745332868,7.28890774533287,0.9692100161216537,0.9692100161216547,0,0,7.347253322601318,7.347253322601318,1,1
1783,2,5.193812603388582,5.193812603388581,1.001988471877754,1.0019884718777543,0,0,7.574830055236816,7.347253322601318,2,2
1783,3,4.857672725685537,4.8576727256855365,1.00387400864758,1.0038740086475801,0,0,7.714487552642822,7.347253322601318,3,3
1783,4,4.471257995387537,4.471257995387537,1.0073013942175162,1.0073013942175175,0,0,7.7918596267700195,7.347253322601318,4,4
1783,8,4.000865855888435,4.002513730043888,1.015728913481417,1.016165387785117,1,1,8.64045524597168,7.347253322601318,7,7
1783,16,3.768118334758887,3.9718227398233337,1.0166467236935581,1.0175011893524446,4,5,9.592836380004883,7.347253322601318,12,11
1783,32,3.135001525093997,3.90444919258452,1.0115994973474483,1.0200419420396718,14,22,10.359999656677246,7.347253322601318,18,10
1783,64,2.351995831798725,3.816842194600653,1.0115139875648596,1.0248449806913447,27,50,11.335738182067871,7.347253322601318,37,14
1783,128,1.4516569239134174,3.787591893181247,1.0023313624824748,1.0264687729973476,65,113,12.30605411529541,7.347253322601318,63,15
1784,1,8.300201538087236,8.300201538087242,0.9632238389907244,0.9632238389907273,0,0,8.370499610900879,8.370499610900879,1,1
1784,2,6.307116628645902,6.307116628645903,0.9949897945638072,0.994989794563809,0,0,8.531014442443848,8.370499610900879,2,2
1784,3,5.919320629809023,5.919320629809023,0.9993427397538364,0.9993427397538364,0,0,8.606498718261719,8.370499610900879,3,3
1784,4,4.9967400056667275,4.99674000566673,1.013867982228708,1.0138679822287053,0,0,8.94450569152832,8.370499610900879,4,4
1784,8,4.851975024553632,4.934214816270755,1.017039277649374,1.0159648717558647,1,1,9.510467529296875,8.370499610900879,7,7
1784,16,4.330966179310094,4.881535681390216,1.0178195664042655,1.0171874682188498,6,9,10.464200973510742,8.370499610900879,10,7
1784,32,3.7688077722450437,4.864357275782699,1.0097729224212533,1.0182199583105642,17,24,11.13415241241455,8.370499610900879,15,8
1784,64,2.262624537804616,4.834564189627718,0.9989668631266997,1.02091687666078,29,55,11.94883918762207,8.370499610900879,35,9
1784,128,1.3779582039810492,4.7630994219084135,1.0004026620704125,1.0259078966194035,63,117,12.638500213623047,8.370499610900879,65,11
1785,1,8.337412609366943,8.337412609366943,0.9591627358579243,0.9591627358579261,0,0,8.425517082214355,8.425517082214355,1,1
1785,2,6.617136073255077,6.617136073255077,0.9948883112021945,0.994888311202196,0,0,9.263162612915039,8.425517082214355,2,2
1785,3,6.4688938101237845,6.468893810123784,0.9976942088284105,0.9976942088284109,0,0,9.35227108001709,8.425517082214355,3,3
1785,4,6.442188561901113,6.442188561901113,0.9985472036946916,0.998547203694692,0,0,9.487396240234375,8.425517082214355,4,4
1785,8,6.086155810056879,6.086155810056879,1.0072496518610619,1.0072496518610619,0,0,9.901460647583008,8.425517082214355,8,8
1785,16,5.287946333811183,5.439170231761898,1.0212643039164675,1.0205257612608463,5,8,10.504693984985352,8.425517082214355,11,8
1785,32,4.838274505236574,5.437576900574517,1.0175102712608473,1.0207058942701983,12,23,10.850472450256348,8.425517082214355,20,9
1785,64,3.6215544549766285,5.292624681952889,1.0133686521319727,1.026553871600818,22,53,11.525832176208496,8.425517082214355,42,11
1785,128,2.184108149316057,5.27827490836674,1.0052878328776964,1.0282726451875366,59,114,12.088753700256348,8.425517082214355,69,14
1786,1,10.349148732889246,10.34914873288924,0.9354792904574155,0.9354792904574186,0,0,10.524049758911133,10.524049758911133,1,1
1786,2,9.937807301112905,9.937807301112905,0.9493962113128845,0.9493962113128861,0,0,11.541525840759277,10.524049758911133,2,2
1786,3,8.837049506372356,8.837049506372356,0.9869726346624769,0.9869726346624772,0,0,12.019564628601074,10.524049758911133,3,3
1786,4,8.791648662475978,8.791648662475978,0.9881327532004687,0.9881327532004693,0,0,12.066067695617676,10.524049758911133,4,4
1786,8,7.88052939540927,7.972141435639112,1.0148606394317343,1.010231292607025,2,2,13.35004711151123,10.524049758911133,6,6
1786,16,6.969922712344809,7.4566413920965955,1.0352267521963887,1.0356806403470737,5,6,14.139389991760254,10.524049758911133,11,10
1786,32,6.1179336348869855,7.358884664976534,1.0332808002810323,1.0412373828889936,15,19,14.870758056640625,10.524049758911133,17,13
1786,64,4.5988421534393105,7.35262526978984,1.0210194630830816,1.0429462618056085,23,50,15.670230865478516,10.524049758911133,41,14
1786,128,2.809848829524877,7.352568461748245,1.0067188998715486,1.0430799182603865,61,114,16.61162567138672,10.524049758911133,67,14
1787,1,7.193784128859339,7.193784128859339,0.9594695573116723,0.9594695573116727,0,0,7.297528266906738,7.297528266906738,1,1
1787,2,5.491300651168788,5.491300651168788,0.9848930118788883,0.9848930118788886,0,0,7.425292015075684,7.297528266906738,2,2
1787,3,5.370604951893589,5.370604951893589,0.9876418640841366,0.9876418640841362,0,0,7.867276668548584,7.297528266906738,3,3
1787,4,5.251410807202798,5.251410807202798,0.9892514386108701,0.9892514386108702,0,0,8.097404479980469,7.297528266906738,4,4
1787,8,4.955947947491702,4.962541181417615,0.9955035525887412,0.9956283896495537,1,1,8.470466613769531,7.297528266906738,7,7
1787,16,4.385819990551038,4.5645189530704116,1.0040444266120807,1.0045712137835736,6,6,8.888895988464355,7.297528266906738,10,10
1787,32,3.23664900856302,4.294244171212162,1.0025856983504065,1.008933517053728,16,21,9.780843734741211,7.297528266906738,16,11
1787,64,2.3566716362041515,4.187064510942121,1.0034963663451406,1.0134309027944877,33,54,10.296599388122559,7.297528266906738,31,10
1787,128,1.3862386421013488,4.162815496300656,1.002052247558409,1.0152029423203914,60,115,11.11040210723877,7.297528266906738,68,13
1788,1,8.928846139910746,8.928846139910746,0.9466935198648241,0.9466935198648248,0,0,9.072064399719238,9.072064399719238,1,1
1788,2,8.15730768705227,8.15730768705227,0.9741627954736563,0.9741627954736571,0,0,10.0640287399292,9.072064399719238,2,2
1788,3,7.809202152554582,7.809202152554582,0.984361671666248,0.9843616716662487,0,0,10.177780151367188,9.072064399719238,3,3
1788,4,7.400009775798857,7.400009775798856,0.9914301706421723,0.9914301706421722,0,0,10.204598426818848,9.072064399719238,4,4
1788,8,6.390770970570586,6.407519406409827,1.0126073211389366,1.0126852692724355,2,3,10.566617012023926,9.072064399719238,6,5
1788,16,5.804202602448087,6.006898115712241,1.0269427502191513,1.0237641014980092,4,7,10.887720108032227,9.072064399719238,12,9
1788,32,5.104367639412083,5.92210272853424,1.024071722605515,1.0270259429316368,11,22,11.465909004211426,9.072064399719238,21,10
1788,64,4.22700015182942,5.792314813864877,1.0233970827296377,1.0301566277332397,29,52,11.999512672424316,9.072064399719238,35,12
1788,128,2.098047854582592,5.654874248491145,1.0041373347324178,1.0339338280846881,63,113,12.73501205444336,9.072064399719238,65,15
1789,1,3.0986170005618767,3.098617000561877,0.9938550920784668,0.9938550920784673,0,0,3.1044883728027344,3.1044883728027344,1,1
1789,2,2.579768235820658,2.579768235820658,0.9993533052839474,0.9993533052839475,0,0,3.4822635650634766,3.1044883728027344,2,2
1789,3,2.324843718505806,2.3248437185058064,1.002593329228908,1.0025933292289078,0,0,3.910883903503418,3.1044883728027344,3,3
1789,4,2.110087526276004,2.1100875262760037,1.0035013325203546,1.0035013325203552,0,0,3.941760540008545,3.1044883728027344,4,4
1789,8,2.0090609924236555,2.104751780155968,1.0033727718898071,1.0036963344137835,3,3,4.202448844909668,3.1044883728027344,5,5
1789,16,1.6876284908247274,1.9708067486562295,1.0052764000253678,1.004734119327042,7,8,4.4732513427734375,3.1044883728027344,9,8
1789,32,1.365567673205958,1.9615512221052296,1.0018591309978506,1.0048314244832268,17,23,4.8768534660339355,3.1044883728027344,15,9
1789,64,0.6145389468080846,1.9269155137925473,1.000135603641756,1.0054185555261674,34,55,5.340474605560303,3.1044883728027344,30,9
1789,128,0.07495552711474343,1.9224375411230719,1.0000177298381154,1.0057401257255385,63,116,5.817401885986328,3.1044883728027344,65,12
1790,1,11.207230092583288,11.207230092583291,0.9328345470328506,0.9328345470328524,0,0,11.380090713500977,11.380090713500977,1,1
1790,2,10.030364070143793,10.030364070143793,0.9693074451263562,0.9693074451263572,0,0,12.064231872558594,11.380090713500977,2,2
1790,3,9.545136595513593,9.545136595513592,0.9813340284393547,0.981334028439355,0,0,12.419909477233887,11.380090713500977,3,3
1790,4,9.439113000362731,9.439113000362731,0.9857903674224877,0.9857903674224885,0,0,12.775261878967285,11.380090713500977,4,4
1790,8,8.92568649097864,8.937031782793044,1.0015000065244197,1.001434531523368,1,1,13.274449348449707,11.380090713500977,7,7
1790,16,8.052409773096157,8.337760685519712,1.0300600583218376,1.0217738476784515,5,6,13.98186206817627,11.380090713500977,11,10
1790,32,6.96035749918665,8.082106795131393,1.0154301190065294,1.0298065677656718,14,20,15.0438871383667,11.380090713500977,18,12
1790,64,5.347801499195567,8.038424010412001,1.0133384391118494,1.0343767943415978,29,47,15.772740364074707,11.380090713500977,35,17
1790,128,3.391916819410534,7.820307583893127,1.0064058328360033,1.0434257261422195,61,118,16.488981246948242,11.380090713500977,67,10
1791,1,12.174485396124279,12.174485396124282,0.9036429905643145,0.9036429905643167,0,0,12.506449699401855,12.506449699401855,1,1
1791,2,11.487616376629191,11.487616376629193,0.9243696835747248,0.9243696835747256,0,0,12.54684829711914,12.506449699401855,2,2
1791,3,10.592418284280761,10.59241828428076,0.9494636715382792,0.9494636715382785,0,0,12.649553298950195,12.506449699401855,3,3
1791,4,10.508664926149157,10.508664926149155,0.9519040261379068,0.9519040261379063,0,0,12.716968536376953,12.506449699401855,4,4
1791,8,9.032073755220715,9.440767058850845,0.9893835257823378,0.9795895550673426,1,2,12.892515182495117,12.506449699401855,7,6
1791,16,8.011840947833145,9.207341289835735,1.0037323870562287,0.9862084615281732,5,9,13.290694236755371,12.506449699401855,11,7
1791,32,7.094292659044206,9.001660268980405,1.0183272098604474,0.993629023186708,14,21,13.530115127563477,12.506449699401855,18,11
1791,64,5.65043241885274,8.732866862724832,1.0263427330468018,1.0051392246915891,28,50,13.922054290771484,12.506449699401855,36,14
1791,128,3.6459619881732594,7.7927069949686665,1.009066623114281,1.0335158658988144,71,112,14.358248710632324,12.506449699401855,57,16
1792,1,9.687556454781246,9.687556454781246,0.9376262461240221,0.9376262461240242,0,0,9.865935325622559,9.865935325622559,1,1
1792,2,8.524893601900837,8.524893601900839,0.9691699107577857,0.9691699107577867,0,0,10.50743579864502,9.865935325622559,2,2
1792,3,7.958536671940753,7.958536671940753,0.9818022220076827,0.9818022220076844,0,0,10.64848518371582,9.865935325622559,3,3
1792,4,7.659665422265941,7.659665422265941,0.9887696390484587,0.9887696390484595,0,0,10.696870803833008,9.865935325622559,4,4
1792,8,6.1338481705329215,6.138911531024214,1.0189661132944992,1.0188875077425392,2,2,11.351211547851562,9.865935325622559,6,6
1792,16,5.631737927174162,5.976083747248633,1.0258156519580623,1.0241695671247757,4,8,12.202341079711914,9.865935325622559,12,8
1792,32,4.809565832141144,5.669128962644028,1.026210369579446,1.033851339519526,11,22,12.910969734191895,9.865935325622559,21,10
1792,64,3.220147053682818,5.649800722817934,1.013246901244016,1.035798340829305,28,52,13.682676315307617,9.865935325622559,36,12
1792,128,2.055588083320837,5.6378813119706335,1.0031263663000671,1.0367804244125145,58,114,14.409109115600586,9.865935325622559,70,14
1793,1,7.911571504554403,7.911571504554405,0.964117384002415,0.9641173840024169,0,0,7.9863481521606445,7.9863481521606445,1,1
1793,2,5.80249420904487,5.80249420904487,0.996340226108597,0.9963402261085965,0,0,8.195157051086426,7.9863481521606445,2,2
1793,3,5.727162319650706,5.727162319650706,0.9990177424568195,0.99901774245682,0,0,8.876815795898438,7.9863481521606445,3,3
1793,4,5.725213451018893,5.725213451018892,0.9991913753761504,0.9991913753761503,0,0,8.992286682128906,7.9863481521606445,4,4
1793,8,5.462545585901919,5.470363914934809,1.0053426885735082,1.0056202140967567,3,3,9.168643951416016,7.9863481521606445,5,5
1793,16,4.928172921025507,5.381638841317398,1.009936514477127,1.0075376289140445,6,8,9.414098739624023,7.9863481521606445,10,8
1793,32,3.998160017960118,5.023140933969723,1.010306658984931,1.014466830679203,14,25,10.0504789352417,7.9863481521606445,18,7
1793,64,2.7411525160313204,4.971132890678676,1.0031669167030226,1.0173494319367606,31,51,10.553299903869629,7.9863481521606445,33,13
1793,128,1.3768939683979071,4.900077630065697,0.9994220879361189,1.0200049166293406,62,115,11.239660263061523,7.9863481521606445,66,13
1794,1,5.785950890282088,5.785950890282089,0.9853929356148824,0.9853929356148828,0,0,5.802958965301514,5.802958965301514,1,1
1794,2,4.843965671998709,4.843965671998709,0.9968008167250448,0.9968008167250446,0,0,6.51187801361084,5.802958965301514,2,2
1794,3,4.566866378664025,4.566866378664025,1.0012195298649855,1.001219529864986,0,0,6.670144557952881,5.802958965301514,3,3
1794,4,4.1350848942235805,4.1350848942235805,1.0084303587681618,1.0084303587681624,0,0,6.692955493927002,5.802958965301514,4,4
1794,8,3.642899081130685,3.697999135356266,1.0156509091621413,1.0145469253980006,1,1,7.582287788391113,5.802958965301514,7,7
1794,16,3.0917597759240096,3.67377591649724,1.0088994223183991,1.0153637692385293,7,9,8.448772430419922,5.802958965301514,9,7
1794,32,2.799867438344391,3.6594030575642114,1.007071000486017,1.0163841313721043,14,23,8.979720115661621,5.802958965301514,18,9
1794,64,1.7938093194694724,3.637375210865955,0.9985735019107801,1.0174402079741227,29,55,9.793798446655273,5.802958965301514,35,9
1794,128,1.0565974751998264,3.5753921537686972,0.9985540068267145,1.0202446306085862,63,118,10.622285842895508,5.802958965301514,65,10
1795,1,7.735113660892293,7.735113660892293,0.961959131909063,0.9619591319090647,0,0,7.818459987640381,7.818459987640381,1,1
1795,2,6.116456660478416,6.116456660478417,0.9885384166248268,0.9885384166248271,0,0,8.259258270263672,7.818459987640381,2,2
1795,3,5.543026690723587,5.543026690723588,0.9977808143066424,0.9977808143066442,0,0,9.232807159423828,7.818459987640381,3,3
1795,4,5.506894222404266,5.5068942224042665,0.9994649502612964,0.9994649502612978,0,0,9.796360969543457,7.818459987640381,4,4
1795,8,4.955657233540664,4.955657233540663,1.0140730622638745,1.0140730622638747,0,0,10.688471794128418,7.818459987640381,8,8
1795,16,4.261054428865166,4.800838056553657,1.0136280141841216,1.0208531349499455,5,7,11.620499610900879,7.818459987640381,11,9
1795,32,3.697120461493626,4.720558074051404,1.0161767111355517,1.0241956403999506,13,20,12.326434135437012,7.818459987640381,19,12
1795,64,2.6155777654095345,4.714271612105749,1.0107775486492518,1.025639791563349,31,49,13.196130752563477,7.818459987640381,33,15
1795,128,1.769434798189966,4.712812220630354,1.0033827302636147,1.0260041284150088,58,111,14.296412467956543,7.818459987640381,70,17
1796,1,9.089710655685641,9.089710655685645,0.9520144847040227,0.9520144847040239,0,0,9.205032348632812,9.205032348632812,1,1
1796,2,8.431333046786657,8.431333046786659,0.9692062492473053,0.9692062492473063,0,0,10.113898277282715,9.205032348632812,2,2
1796,3,7.128047380613474,7.128047380613474,0.9961341466061497,0.9961341466061505,0,0,10.576762199401855,9.205032348632812,3,3
1796,4,6.928932014084891,6.92893201408489,0.9996435560725314,0.9996435560725314,0,0,10.583233833312988,9.205032348632812,4,4
1796,8,6.665116352248871,6.676162772526482,1.0089587947057799,1.0086735469942907,1,1,11.331759452819824,9.205032348632812,7,7
1796,16,6.1061693336147735,6.336363068884018,1.0179873966718387,1.020511895636668,3,6,11.895634651184082,9.205032348632812,13,10
1796,32,5.254392923321125,6.158108387438553,1.0203853722778533,1.0250636190565414,14,22,12.290827751159668,9.205032348632812,18,10
1796,64,4.355634597693828,6.151575465320345,1.0127599282430593,1.025927037832098,30,53,12.918593406677246,9.205032348632812,34,11
1796,128,2.365855811871498,5.934806471700633,1.0016424644722997,1.0353244810691455,69,115,13.63303279876709,9.205032348632812,59,13
1797,1,6.38503235309006,6.385032353090062,0.974683783878547,0.9746837838785486,0,0,6.4301276206970215,6.4301276206970215,1,1
1797,2,5.764250293648018,5.764250293648019,0.9838107745415057,0.983810774541507,0,0,6.90802526473999,6.4301276206970215,2,2
1797,3,5.7170268570072045,5.717026857007206,0.9852627969275571,0.9852627969275589,0,0,7.631031036376953,6.4301276206970215,3,3
1797,4,5.241538873031886,5.241538873031885,0.99561722891499,0.9956172289149916,0,0,7.967113494873047,6.4301276206970215,4,4
1797,8,5.068340895134733,5.068388498639204,0.9996187370813565,0.9996416674591784,2,2,8.276628494262695,6.4301276206970215,6,6
1797,16,4.448517088615256,4.571652108385177,1.0134707704862211,1.012690734168578,6,7,8.695444107055664,6.4301276206970215,10,9
1797,32,3.1855365431469354,4.14115665460819,1.0125873418520506,1.0184133349482025,15,21,9.327620506286621,6.4301276206970215,17,11
1797,64,2.2427850281815886,4.073467806323115,1.0063520992833785,1.0216744860812619,30,48,9.838236808776855,6.4301276206970215,34,16
1797,128,1.4034200008147464,3.991635395977686,1.0047865130722822,1.02443245120662,63,112,10.407958030700684,6.4301276206970215,65,16
1798,1,3.0603631984737727,3.0603631984737723,0.9949344254940565,0.9949344254940576,0,0,3.0643441677093506,3.0643441677093506,1,1
1798,2,2.2349620658096643,2.2349620658096647,0.9997322367667636,0.9997322367667643,0,0,3.147853374481201,3.0643441677093506,2,2
1798,3,2.0594660816746253,2.059466081674625,1.001055268845322,1.0010552688453225,0,0,3.4055745601654053,3.0643441677093506,3,3
1798,4,1.9868291486193295,2.059466081674625,1.0005947203161631,1.0010552688453225,1,1,3.833904266357422,3.0643441677093506,3,3
1798,8,1.746334030140233,1.7932166538628143,1.002053684205391,1.002647371296162,2,2,3.945993185043335,3.0643441677093506,6,6
1798,16,1.400824092353296,1.7148793321642624,1.001370438647818,1.0034160584288585,5,6,4.498631477355957,3.0643441677093506,11,10
1798,32,1.1160293426056498,1.6029527345583494,1.0017093042653658,1.0051518839244258,13,23,4.9221367835998535,3.0643441677093506,19,9
1798,64,0.8519567917401603,1.599890986371095,1.001038761629765,1.0054078379321703,32,50,5.6774210929870605,3.0643441677093506,32,14
1798,128,0.22168033515059563,1.593089475411277,0.9996957385906793,1.005610229416742,68,117,6.472211837768555,3.0643441677093506,60,11
1799,1,7.639850806559949,7.639850806559949,0.9686494222970983,0.9686494222970984,0,0,7.69651985168457,7.69651985168457,1,1
1799,2,7.208649399398285,7.208649399398285,0.9788463807086973,0.978846380708698,0,0,9.519293785095215,7.69651985168457,2,2
1799,3,7.1776113523828755,7.1776113523828755,0.9808307786732372,0.9808307786732373,0,0,10.090314865112305,7.69651985168457,3,3
1799,4,6.894250729005604,6.894250729005605,0.9885544794927446,0.988554479492744,0,0,10.200663566589355,7.69651985168457,4,4
1799,8,6.366720945637085,6.367359056979941,0.9984234990000322,0.9984558345544636,1,1,10.671795845031738,7.69651985168457,7,7
1799,16,5.788430460726511,5.8363748600165195,1.0140041478867718,1.0151715138168,6,7,11.115972518920898,7.69651985168457,10,9
1799,32,4.847780978350113,5.496339821025119,1.0168781945609808,1.0213628114828626,13,21,11.656538963317871,7.69651985168457,19,11
1799,64,3.711469448460646,5.377224799846144,1.014133010171422,1.0272127676566,32,49,12.332408905029297,7.69651985168457,32,15
1799,128,2.0706723395696263,5.356492277717723,1.00176056448632,1.029679116134301,66,109,13.023212432861328,7.69651985168457,62,19
1800,1,9.588800018594238,9.588800018594235,0.9543564603946147,0.9543564603946164,0,0,9.684208869934082,9.684208869934082,1,1
1800,2,8.268611403352118,8.268611403352118,0.9862147681150948,0.9862147681150963,0,0,10.499237060546875,9.684208869934082,2,2
1800,3,7.837380316965579,7.8373803169655805,0.9950667213811165,0.9950667213811173,0,0,10.658275604248047,9.684208869934082,3,3
1800,4,7.552792025487641,7.552792025487641,1.000388507304458,1.0003885073044592,0,0,10.816423416137695,9.684208869934082,4,4
1800,8,7.195289442349033,7.196317490197504,1.0113926152463197,1.0114956615922361,1,1,11.456764221191406,9.684208869934082,7,7
1800,16,6.285943821877899,6.64296566964215,1.023007855892291,1.0242233684819713,5,8,12.051482200622559,9.684208869934082,11,8
1800,32,5.188463676096342,6.318735092026912,1.0290576692868385,1.033663094272581,14,20,12.34859848022461,9.684208869934082,18,12
1800,64,3.9294320056475502,6.254301838547882,1.0182683131458645,1.0380411010713488,34,48,13.043129920959473,9.684208869934082,30,16
1800,128,2.2242638032696913,6.184188482816088,1.0030327707827467,1.0423105584506842,65,112,13.592233657836914,9.684208869934082,63,16
1801,1,15.133394710567638,15.13339471056764,0.8587396784678881,0.8587396784678898,0,0,15.707772254943848,15.707772254943848,1,1
1801,2,13.197324430391296,13.197324430391298,0.9324160817047726,0.9324160817047733,0,0,15.742581367492676,15.707772254943848,2,2
1801,3,11.65742529737495,11.657425297374948,0.9782966558911631,0.9782966558911623,0,0,15.792912483215332,15.707772254943848,3,3
1801,4,11.288182039129405,11.288182039129405,0.9925039220195815,0.9925039220195802,0,0,15.872690200805664,15.707772254943848,4,4
1801,8,10.497285583044825,10.519951392538525,1.0226221693405675,1.0209301668646797,2,1,16.3538818359375,15.707772254943848,6,7
1801,16,10.028952213609871,10.10491417688109,1.037604930732837,1.0339759468049272,5,7,16.65903663635254,15.707772254943848,11,9
1801,32,8.948914438059347,9.297154347869023,1.0759802446120248,1.0637093365590837,15,21,17.27076530456543,15.707772254943848,17,11
1801,64,7.011006314777007,9.222525688287881,1.0508936940731122,1.0684508632662668,27,52,17.855924606323242,15.707772254943848,37,12
1801,128,4.583690909042426,8.854845959273407,1.0338902169275277,1.0882255655600988,64,113,18.4329891204834,15.707772254943848,64,15
1802,1,5.908856273063204,5.908856273063203,0.9805948769094026,0.980594876909404,0,0,5.937768459320068,5.937768459320068,1,1
1802,2,4.6176585662016825,4.617658566201682,0.9954546399634052,0.9954546399634061,0,0,6.610716342926025,5.937768459320068,2,2
1802,3,4.2032992728047835,4.2032992728047835,0.9997968288098604,0.9997968288098613,0,0,6.91715669631958,5.937768459320068,3,3
1802,4,4.139645547221372,4.139645547221372,1.0014502841362405,1.0014502841362403,0,0,7.5838823318481445,5.937768459320068,4,4
1802,8,3.803655470591271,3.8036554705912704,1.0073626894072663,1.0073626894072665,0,0,7.880246162414551,5.937768459320068,8,8
1802,16,3.2543784897516286,3.573423637271175,1.0112729859331073,1.0103947526214045,5,7,8.283487319946289,5.937768459320068,11,9
1802,32,2.609188719482214,3.3514045585181513,1.0102824211437234,1.0140658299138479,16,21,8.601188659667969,5.937768459320068,16,11
1802,64,1.663222763335689,3.196131171738123,1.001746353672533,1.0164524233616596,33,49,9.083412170410156,5.937768459320068,31,15
1802,128,0.9957115179216718,3.1815843965361115,0.999606106323871,1.0170859683607596,66,111,9.69027328491211,5.937768459320068,62,17
1803,1,11.820067183290687,11.820067183290666,0.9177217879996193,0.9177217879996209,0,0,12.073766708374023,12.073766708374023,1,1
1803,2,9.758332903080204,9.758332903080206,0.9675252664882884,0.9675252664882898,0,0,12.162789344787598,12.073766708374023,2,2
1803,3,9.231732063977926,9.231732063977928,0.9825758539490698,0.982575853949071,0,0,12.54167366027832,12.073766708374023,3,3
1803,4,9.042752712597874,9.042752712597876,0.9867520383796858,0.9867520383796873,0,0,12.69243049621582,12.073766708374023,4,4
1803,8,8.558462640882498,8.5584626408825,1.0011814205616725,1.001181420561673,0,0,13.11103343963623,12.073766708374023,8,8
1803,16,7.871536491560629,8.033895672639595,1.0145771361502998,1.012894566595408,4,5,13.578700065612793,12.073766708374023,12,11
1803,32,6.701020809590725,7.819142064511766,1.018605625423819,1.0192049814688344,12,20,13.948006629943848,12.073766708374023,20,12
1803,64,5.578330731924974,7.716458830260199,1.0269532624663535,1.0247987489029542,29,46,14.726881980895996,12.073766708374023,35,18
1803,128,3.884407673458079,7.495220553016228,1.0184993838514065,1.0347918176668927,63,114,15.32707691192627,12.073766708374023,65,14
1804,1,6.827614743164941,6.8276147431649425,0.9718408971666923,0.9718408971666939,0,0,6.878889560699463,6.878889560699463,1,1
1804,2,5.690269545210658,5.690269545210657,0.9895633228700438,0.9895633228700451,0,0,7.576909065246582,6.878889560699463,2,2
1804,3,5.568931203055832,5.568931203055834,0.992579975851053,0.9925799758510544,0,0,7.905585289001465,6.878889560699463,3,3
1804,4,5.5631218124328585,5.563121812432859,0.9927466682605708,0.9927466682605726,0,0,8.228395462036133,6.878889560699463,4,4
1804,8,5.069026160615075,5.155477063738608,1.0014836142261299,1.001652385274691,3,3,8.710015296936035,6.878889560699463,5,5
1804,16,4.755241856660676,5.050451832952514,1.0048552560807362,1.0041172483992125,6,9,9.238204956054688,6.878889560699463,10,7
1804,32,3.891665077235616,4.594412778534713,1.0136795168265222,1.0152946446085327,13,23,9.768731117248535,6.878889560699463,19,9
1804,64,2.793276839539347,4.486099272317601,1.0091235967331227,1.0193782577785404,29,51,10.415568351745605,6.878889560699463,35,13
1804,128,1.3404333640536865,4.400862440954864,1.001729209084658,1.0216070352020625,62,114,11.278800964355469,6.878889560699463,66,14
1805,1,13.135862425488462,13.135862425488462,0.8851401952349934,0.885140195234994,0,0,13.58095645904541,13.58095645904541,1,1
1805,2,12.35216700041245,12.352167000412447,0.9158321840468946,0.9158321840468948,0,0,14.255547523498535,13.58095645904541,2,2
1805,3,10.895901482828581,10.895901482828581,0.9632910233807924,0.9632910233807914,0,0,14.333792686462402,13.58095645904541,3,3
1805,4,10.109016428402489,10.109016428402487,0.9925336125040306,0.9925336125040289,0,0,14.89931869506836,13.58095645904541,4,4
1805,8,9.608445208109131,9.60844520810913,1.0106061068329264,1.0106061068329244,1,1,15.386092185974121,13.58095645904541,7,7
1805,16,9.02740798615139,9.417028226705666,1.0173001060538072,1.019905873211575,4,8,16.153833389282227,13.58095645904541,12,8
1805,32,7.88526441445037,9.026852132422993,1.0492418817100164,1.0424023791117565,14,21,16.60267448425293,13.58095645904541,18,11
1805,64,6.2607635560328285,9.026489718362443,1.0293899521342307,1.0427281007864042,29,53,17.309324264526367,13.58095645904541,35,11
1805,128,4.002246753279446,8.81329248188182,1.004433906594343,1.0556984280309796,69,114,18.02753448486328,13.58095645904541,59,14
1806,1,9.481026048438968,9.481026048438972,0.9494375240462428,0.9494375240462448,0,0,9.59933090209961,9.59933090209961,1,1
1806,2,7.229532201496143,7.229532201496143,0.9913586576304734,0.9913586576304747,0,0,9.599872589111328,9.59933090209961,2,2
1806,3,7.190139646292392,7.190139646292391,0.992124492609656,0.9921244926096571,0,0,10.151803970336914,9.59933090209961,3,3
1806,4,7.16477599834361,7.164775998343612,0.9933381285343326,0.9933381285343337,0,0,10.633318901062012,9.59933090209961,4,4
1806,8,6.9891969245697405,6.991543383833107,0.9995064708825769,0.9995369075383546,1,1,11.066611289978027,9.59933090209961,7,7
1806,16,6.046227230429296,6.418589878333976,1.0099447433819033,1.0127019838174984,7,6,11.477787971496582,9.59933090209961,9,10
1806,32,5.034671229142628,6.127826138363755,1.0191962485685466,1.0207284768604181,13,21,12.044143676757812,9.59933090209961,19,11
1806,64,3.8629396018017603,5.905502284143668,1.0136504117226413,1.02928212822332,30,54,12.77567195892334,9.59933090209961,34,10
1806,128,2.3621994470106698,5.86645539342779,1.0039325270241162,1.033108187218808,62,115,13.642048835754395,9.59933090209961,66,13
1807,1,11.576673539423533,11.576673539423535,0.9233672588716756,0.9233672588716765,0,0,11.79468822479248,11.79468822479248,1,1
1807,2,10.16212644637373,10.16212644637373,0.9690827160882822,0.9690827160882833,0,0,12.67094898223877,11.79468822479248,2,2
1807,3,9.314289335459582,9.314289335459582,0.9867383766401514,0.986738376640151,0,0,12.707301139831543,11.79468822479248,3,3
1807,4,9.105326710505453,9.105326710505453,0.9917081527470102,0.9917081527470102,0,0,12.94050407409668,11.79468822479248,4,4
1807,8,8.737590570932513,8.763879797115592,1.0009953516367802,1.001332966123981,2,2,13.273499488830566,11.79468822479248,6,6
1807,16,7.8528616255799415,8.051727798023293,1.0226053348954107,1.0210288502272662,4,3,13.538899421691895,11.79468822479248,12,13
1807,32,7.107078524837504,7.646201876456059,1.0358952484793629,1.0307288950403202,14,16,13.810701370239258,11.79468822479248,18,16
1807,64,5.48513010711219,7.408180688266997,1.0302363874805076,1.035195633166718,27,43,14.137721061706543,11.79468822479248,37,21
1807,128,3.3002471122692056,7.348655771699449,1.0171066337287977,1.0375184463648646,59,106,14.4834566116333,11.79468822479248,69,22
1808,1,9.396131206310631,9.39613120631061,0.9479404229150102,0.9479404229150117,0,0,9.52444839477539,9.52444839477539,1,1
1808,2,7.8903137446526665,7.890313744652665,0.9769176424853241,0.9769176424853243,0,0,9.600083351135254,9.52444839477539,2,2
1808,3,7.834897280563905,7.834897280563907,0.9782009635417648,0.9782009635417656,0,0,10.064565658569336,9.52444839477539,3,3
1808,4,7.602545385414167,7.602545385414168,0.984635465353431,0.9846354653534316,0,0,10.559722900390625,9.52444839477539,4,4
1808,8,6.767913722823356,6.901209446373745,1.0041688671721762,1.0025931975944233,2,1,11.115159034729004,9.52444839477539,6,7
1808,16,6.404837238729039,6.863245591050078,1.0045747705250359,1.0034320318234768,6,8,11.42467975616455,9.52444839477539,10,8
1808,32,5.7128134331512594,6.818240539896103,1.0027330408780886,1.0071096526374976,14,22,12.009839057922363,9.52444839477539,18,10
1808,64,3.876114519040429,6.311663798073682,1.0136212584999034,1.0239070914399115,30,51,12.554045677185059,9.52444839477539,34,13
1808,128,2.0034550695168596,5.939200491571886,1.0051616150972207,1.0318172448614766,58,114,13.192343711853027,9.52444839477539,70,14
1809,1,7.552864763106356,7.552864763106358,0.9678005121669807,0.9678005121669826,0,0,7.612713813781738,7.612713813781738,1,1
1809,2,6.478770727509899,6.478770727509899,0.9852683260758898,0.9852683260758905,0,0,8.30400276184082,7.612713813781738,2,2
1809,3,6.461699331199325,6.461699331199325,0.9856219364557176,0.9856219364557185,0,0,8.756568908691406,7.612713813781738,3,3
1809,4,6.103384993261271,6.103384993261271,0.9943973288011345,0.9943973288011358,0,0,9.048654556274414,7.612713813781738,4,4
1809,8,6.030816523611053,6.074165154224591,0.9954395818327498,0.9960487588386513,3,3,9.627029418945312,7.612713813781738,5,5
1809,16,5.107029156394919,5.475555850765727,1.0140517478365323,1.010541749917522,9,10,10.061014175415039,7.612713813781738,7,6
1809,32,3.9162692674641706,5.3767885618117175,1.0147815527838429,1.0153577740524813,12,23,10.482069969177246,7.612713813781738,20,9
1809,64,2.87603195575595,5.021383428688808,1.0110118113630988,1.0260837742548337,26,48,11.233184814453125,7.612713813781738,38,16
1809,128,2.0746117835876827,4.924123690158367,1.0047156357144114,1.0340515923313136,63,109,12.119311332702637,7.612713813781738,65,19
1810,1,11.256537947739567,11.256537947739567,0.9230545448943185,0.9230545448943208,0,0,11.487080574035645,11.487080574035645,1,1
1810,2,9.955159430621025,9.955159430621025,0.9615618264035151,0.9615618264035162,0,0,11.69399642944336,11.487080574035645,2,2
1810,3,8.297788174916182,8.297788174916182,0.9952785437842466,0.9952785437842459,0,0,11.727943420410156,11.487080574035645,3,3
1810,4,7.719450910084424,7.719450910084424,1.0083078610255929,1.008307861025592,0,0,11.81264591217041,11.487080574035645,4,4
1810,8,6.997190833228011,7.02650282348217,1.0228237211871383,1.023059559331322,2,2,12.750308990478516,11.487080574035645,6,6
1810,16,6.640163649963739,6.856825409766164,1.0307973572232667,1.0285259795883048,7,8,13.226292610168457,11.487080574035645,9,8
1810,32,5.766742335556973,6.7473733945492285,1.03238449814043,1.0338418398339075,14,20,13.667967796325684,11.487080574035645,18,12
1810,64,4.437883341059991,6.725354860296548,1.029875789679395,1.0356637203241668,29,51,14.161103248596191,11.487080574035645,35,13
1810,128,2.9206255302505646,6.590715914495671,1.0113855376125742,1.0448108575606838,61,114,14.808732032775879,11.487080574035645,67,14
1811,1,10.17564271177969,10.175642711779691,0.9347772099812112,0.9347772099812127,0,0,10.358198165893555,10.358198165893555,1,1
1811,2,8.994472998204898,8.994472998204898,0.9686330320980463,0.9686330320980467,0,0,10.369555473327637,10.358198165893555,2,2
1811,3,8.151208136009078,8.151208136009085,0.9891839231471088,0.9891839231471067,0,0,10.955842018127441,10.358198165893555,3,3
1811,4,7.943797048209218,7.943797048209218,0.9932578338557336,0.9932578338557321,0,0,10.971721649169922,10.358198165893555,4,4
1811,8,7.378940383273031,7.401271085777311,1.0083727898504888,1.0085537313213668,1,2,11.591732025146484,10.358198165893555,7,6
1811,16,6.412444813742564,7.127666727528923,1.0251182227567859,1.0156783160275227,5,7,11.817412376403809,10.358198165893555,11,9
1811,32,5.557226586228145,6.511072141851167,1.0396296844817796,1.0307439061849482,9,18,12.237457275390625,10.358198165893555,23,14
1811,64,4.490675181122174,5.836900843781028,1.0368273736299491,1.0471392755624558,27,49,12.603438377380371,10.358198165893555,37,15
1811,128,2.755394274541641,5.782336310949625,1.0166175820714172,1.0505486727723121,63,110,13.287714958190918,10.358198165893555,65,18
1812,1,3.0131536274527955,3.013153627452795,0.9935993206779571,0.9935993206779581,0,0,3.019657611846924,3.019657611846924,1,1
1812,2,2.656378769459314,2.656378769459314,0.9959144430377661,0.9959144430377669,0,0,3.146665573120117,3.019657611846924,2,2
1812,3,2.4469704627969047,2.4469704627969042,0.997288412267697,0.997288412267697,0,0,3.182518720626831,3.019657611846924,3,3
1812,4,2.3131397032068315,2.313139703206832,0.997918325921998,0.9979183259219977,0,0,3.192704200744629,3.019657611846924,4,4
1812,8,1.8259399310159303,1.83712769987268,0.9989865026141368,0.9991091788237108,3,3,3.410008668899536,3.019657611846924,5,5
1812,16,1.519076161841182,1.6856788591834169,1.0015008817823694,1.0013709851204884,6,6,3.71187686920166,3.019657611846924,10,10
1812,32,1.1100622686483161,1.3783085065382825,1.0028714571440922,1.0037946538005078,14,19,4.145114898681641,3.019657611846924,18,13
1812,64,0.6136792548981049,1.3535259398953878,1.0007091056719686,1.004456628693234,34,47,4.653823375701904,3.019657611846924,30,17
1812,128,0.1110975193934418,1.2942311457629352,0.9991176126378971,1.004835823640315,66,113,5.156686305999756,3.019657611846924,62,15
1813,1,11.329395691864828,11.329395691864834,0.9157153778293398,0.9157153778293438,0,0,11.600083351135254,11.600083351135254,1,1
1813,2,9.791322056500823,9.791322056500821,0.9643270485058031,0.964327048505806,0,0,13.266824722290039,11.600083351135254,2,2
1813,3,9.154468040560793,9.154468040560795,0.987004748379388,0.9870047483793902,0,0,13.972827911376953,11.600083351135254,3,3
1813,4,9.106386524203232,9.10638652420323,0.990287119460157,0.9902871194601598,0,0,14.223701477050781,11.600083351135254,4,4
1813,8,8.959019751625643,8.977042390940655,0.997416602779361,0.9970364408037939,1,2,14.85366153717041,11.600083351135254,7,6
1813,16,7.800814364766235,8.103618297106852,1.0364664468419469,1.034103417716244,6,8,15.291912078857422,11.600083351135254,10,8
1813,32,6.892744789521422,7.906105548207135,1.0444667543953048,1.0430530410498882,13,22,15.72036361694336,11.600083351135254,19,10
1813,64,5.2536547640702835,7.826752787510503,1.0347777890549619,1.0497603928788082,30,51,16.573055267333984,11.600083351135254,34,13
1813,128,3.777725736419355,7.82611966703489,1.013276671718302,1.050390442494392,64,113,17.36722755432129,11.600083351135254,64,15
1814,1,13.826215241304373,13.826215241304377,0.8779101308001257,0.8779101308001281,0,0,14.28466510772705,14.28466510772705,1,1
1814,2,12.283151538551412,12.283151538551413,0.9358442394718994,0.9358442394719,0,0,14.70179271697998,14.28466510772705,2,2
1814,3,11.981658438206892,11.981658438206892,0.9504187643380047,0.9504187643380047,0,0,15.131916999816895,14.28466510772705,3,3
1814,4,11.978206042851692,11.981658438206892,0.950377458001228,0.9504187643380047,1,1,15.329553604125977,14.28466510772705,3,3
1814,8,11.082314668839306,11.292366907309544,0.9772970646670623,0.9738715234386705,2,2,15.474848747253418,14.28466510772705,6,6
1814,16,9.49651134914855,9.82724525493093,1.0309001129544582,1.0261044061655218,4,4,15.929729461669922,14.28466510772705,12,12
1814,32,8.422550991951054,9.156374239648677,1.054594325370127,1.0500765695519172,9,17,16.505496978759766,14.28466510772705,23,15
1814,64,6.693071035434716,8.884436959742088,1.056037139001412,1.061969197868687,28,48,17.125282287597656,14.28466510772705,36,16
1814,128,4.153038595647522,8.882348963537934,1.024879180514859,1.06253088755909,58,111,17.59642219543457,14.28466510772705,70,17
1815,1,6.559444013886162,6.5594440138861625,0.9782353576398085,0.9782353576398093,0,0,6.592291831970215,6.592291831970215,1,1
1815,2,5.732406120335841,5.732406120335841,0.9906219245413765,0.9906219245413769,0,0,7.382557392120361,6.592291831970215,2,2
1815,3,5.3126330064366005,5.3126330064366005,0.9963959088656636,0.9963959088656638,0,0,7.488149642944336,6.592291831970215,3,3
1815,4,5.27955795604574,5.3126330064366,0.9962654945309721,0.9963959088656638,1,1,7.6017351150512695,6.592291831970215,3,3
1815,8,4.198211210718409,4.340111563087479,1.0083689095601456,1.0076170682740269,3,4,8.064109802246094,6.592291831970215,5,4
1815,16,3.7379354583020485,4.3079801565511096,1.0089713824595792,1.0091748167545183,7,9,8.727617263793945,6.592291831970215,9,7
1815,32,3.125496984285301,3.875467460198176,1.0105765812494536,1.0143717408341923,13,23,9.096033096313477,6.592291831970215,19,9
1815,64,2.481730683050755,3.8612220036015303,1.0055273839809444,1.0157413456664728,31,54,9.452945709228516,6.592291831970215,33,10
1815,128,1.1462275880648132,3.8230483502494077,0.9993058285179517,1.0169116797083713,66,119,10.038650512695312,6.592291831970215,62,9
1816,1,9.227138547990442,9.227138547990444,0.9520351531392173,0.9520351531392192,0,0,9.33664608001709,9.33664608001709,1,1
1816,2,6.877369464758108,6.877369464758107,0.9971652003764042,0.997165200376404,0,0,9.560661315917969,9.33664608001709,2,2
1816,3,6.501261598392732,6.501261598392731,1.0054059155822868,1.0054059155822865,0,0,10.108967781066895,9.33664608001709,3,3
1816,4,6.455314373331333,6.4553143733313325,1.006694483158398,1.006694483158398,0,0,10.519091606140137,9.33664608001709,4,4
1816,8,5.991369773237658,6.0152232922866045,1.0154713381665383,1.0158804788980518,1,1,11.111544609069824,9.33664608001709,7,7
1816,16,5.735503834503124,5.949658637609228,1.0187274520567253,1.0190008673912174,5,7,12.236471176147461,9.33664608001709,11,9
1816,32,5.267633148208546,5.918475392194885,1.0138204477369157,1.0214573681965056,10,21,12.897887229919434,9.33664608001709,22,11
1816,64,3.909996592887112,5.805222681234797,1.0099935652738767,1.0302980169903628,30,49,13.611342430114746,9.33664608001709,34,15
1816,128,2.1982816159671614,5.605491606581288,1.0059887964251562,1.0395846752585738,63,111,14.529213905334473,9.33664608001709,65,17
1817,1,5.151685154511225,5.151685154511225,0.9794341587278657,0.979434158727868,0,0,5.189047813415527,5.189047813415527,1,1
1817,2,4.1006829319567455,4.1006829319567455,0.9913995143007251,0.991399514300727,0,0,5.79908561706543,5.189047813415527,2,2
1817,3,3.4073616762261696,3.4073616762261696,0.9990855682135831,0.9990855682135844,0,0,5.888791561126709,5.189047813415527,3,3
1817,4,3.3713506001718194,3.371350600171819,0.9993717769977106,0.9993717769977118,0,0,6.208919525146484,5.189047813415527,4,4
1817,8,3.121687441386988,3.152608329134537,1.0028463057982684,1.0030977609449716,1,1,6.371600151062012,5.189047813415527,7,7
1817,16,2.7117861629660767,2.7963895599358124,1.007382159881199,1.0078259890525165,5,7,6.682478904724121,5.189047813415527,11,9
1817,32,2.408195912272214,2.664709587272911,1.0052043002417257,1.0098800306306632,15,19,7.4343485832214355,5.189047813415527,17,13
1817,64,1.7813536272489134,2.57971622918993,1.001758181224683,1.0116573004331681,30,47,8.074379920959473,5.189047813415527,34,17
1817,128,0.9231495553186753,2.5777647309804435,0.997663930920113,1.011838168019907,64,109,8.713642120361328,5.189047813415527,64,19
1818,1,9.207620791721572,9.207620791721576,0.9538232414385514,0.953823241438554,0,0,9.30760383605957,9.30760383605957,1,1
1818,2,8.084409702032836,8.084409702032838,0.9783605307130101,0.9783605307130112,0,0,9.4319486618042,9.30760383605957,2,2
1818,3,6.8139163200727575,6.8139163200727575,1.0025870810733233,1.0025870810733246,0,0,9.889588356018066,9.30760383605957,3,3
1818,4,6.640051682785767,6.640051682785766,1.0051564617175295,1.0051564617175301,0,0,9.908329963684082,9.30760383605957,4,4
1818,8,6.210859545085467,6.210859545085465,1.0150327884627977,1.0150327884627983,0,0,10.511695861816406,9.30760383605957,8,8
1818,16,5.164202838641746,5.696069104045203,1.0280943309057409,1.0261195981117395,5,8,11.040268898010254,9.30760383605957,11,8
1818,32,4.589572897841021,5.347072748149293,1.0312329963852958,1.0362590818244937,14,21,11.826583862304688,9.30760383605957,18,11
1818,64,3.375540918426512,5.324314047575822,1.0143528878048649,1.03815643160863,29,49,12.704522132873535,9.30760383605957,35,15
1818,128,1.9691462992923658,5.176035289381894,1.0040162526460095,1.0462232966094875,63,110,13.655708312988281,9.30760383605957,65,18
1819,1,9.978947881706286,9.97894788170629,0.9442386796632994,0.9442386796633008,0,0,10.117409706115723,10.117409706115723,1,1
1819,2,8.54972968816449,8.54972968816449,0.9806660172508743,0.9806660172508748,0,0,11.363055229187012,10.117409706115723,2,2
1819,3,8.039347296994464,8.039347296994464,0.991942069821411,0.9919420698214119,0,0,11.432757377624512,10.117409706115723,3,3
1819,4,8.017264747225802,8.017264747225802,0.9929762582329716,0.9929762582329716,0,0,11.446572303771973,10.117409706115723,4,4
1819,8,7.4067127246377105,7.476225309236989,1.0059406836278209,1.0055549591146615,2,2,11.782103538513184,10.117409706115723,6,6
1819,16,6.594230510063098,6.870509659070237,1.02554228443737,1.024997968861406,6,6,12.2567720413208,10.117409706115723,10,10
1819,32,5.735323716028714,6.684721344717528,1.0300594905600218,1.0312224639383956,13,20,12.857379913330078,10.117409706115723,19,12
1819,64,4.466327286458205,6.60934633703772,1.0220948525729334,1.0353759526025652,31,48,13.406494140625,10.117409706115723,33,16
1819,128,2.802290590202946,6.536279191776633,1.015431483379829,1.0398245127987245,60,109,13.874876022338867,10.117409706115723,68,19
1820,1,7.004929960519411,7.0049299605194095,0.9751723435635858,0.975172343563587,0,0,7.043920993804932,7.043920993804932,1,1
1820,2,5.775974693467731,5.775974693467731,0.9981422575873786,0.9981422575873793,0,0,8.013213157653809,7.043920993804932,2,2
1820,3,5.431353500751744,5.431353500751744,1.0035486851163575,1.0035486851163582,0,0,8.230853080749512,7.043920993804932,3,3
1820,4,5.309805275979812,5.431353500751744,1.0043614819582674,1.0035486851163582,1,1,8.237521171569824,7.043920993804932,3,3
1820,8,5.024518722904138,5.257784470016632,1.0064430289292132,1.0059519772851906,3,3,8.727892875671387,7.043920993804932,5,5
1820,16,4.790925716990707,5.181964481061049,1.0077184351982051,1.0086338968091058,6,11,9.471656799316406,7.043920993804932,10,5
1820,32,3.9057282583940465,5.022757964496416,1.0130508264411529,1.014668147229957,14,24,10.007838249206543,7.043920993804932,18,8
1820,64,2.739517910825516,4.875912370082332,1.0073178482405776,1.0221248850611993,28,52,10.547933578491211,7.043920993804932,36,12
1820,128,1.2992917984475403,4.711988461319797,0.9999632676228605,1.0257119343430368,60,114,11.231928825378418,7.043920993804932,68,14
1821,1,7.260015013500494,7.260015013500496,0.9694747575856378,0.9694747575856412,0,0,7.316442966461182,7.316442966461182,1,1
1821,2,6.764007940112514,6.764007940112515,0.9805827442541859,0.9805827442541881,0,0,7.854966640472412,7.316442966461182,2,2
1821,3,6.547926680481197,6.547926680481197,0.9857642559363369,0.9857642559363389,0,0,8.121567726135254,7.316442966461182,3,3
1821,4,6.093774077332085,6.0942588542476654,0.9947232753057794,0.9947038141260471,1,1,8.46513557434082,7.316442966461182,3,3
1821,8,5.470067036652477,5.49323267944746,1.0085912644536514,1.0085804878871918,2,1,10.097062110900879,7.316442966461182,6,7
1821,16,4.629757041822584,5.241573126333536,1.0163527835439772,1.0182828543359488,7,7,10.751961708068848,7.316442966461182,9,9
1821,32,4.3527575069965305,5.241573126333536,1.0079994237731822,1.0182828543359488,17,23,11.5505952835083,7.316442966461182,15,9
1821,64,3.055998480698257,5.212579933140532,1.0031726151793783,1.021834488428325,33,53,12.391348838806152,7.316442966461182,31,11
1821,128,1.7633332008768356,5.151047538488862,0.9998925194547936,1.0260583320748156,65,115,13.329983711242676,7.316442966461182,63,13
1822,1,10.98820503730362,10.988205037303622,0.9268929326811541,0.9268929326811558,0,0,11.206918716430664,11.206918716430664,1,1
1822,2,8.001357296014616,8.001357296014616,0.9979795044963129,0.9979795044963129,0,0,11.58609676361084,11.206918716430664,2,2
1822,3,7.888205027981598,7.888205027981597,1.0003831906686687,1.0003831906686693,0,0,11.789627075195312,11.206918716430664,3,3
1822,4,7.8102968289211585,7.810296828921159,1.0032180541181892,1.003218054118189,0,0,11.896766662597656,11.206918716430664,4,4
1822,8,7.137251485561276,7.137251485561276,1.0209585263379375,1.020958526337937,0,0,12.724652290344238,11.206918716430664,8,8
1822,16,6.7379246530915005,7.066545481076445,1.0205219888018318,1.0231040089553087,6,6,13.422436714172363,11.206918716430664,10,10
1822,32,6.150222903580234,6.759773183903017,1.025824157634118,1.0322769412350181,16,22,14.185100555419922,11.206918716430664,16,10
1822,64,4.531988623074533,6.715581079892493,1.023049464002638,1.0353148615018564,29,53,14.754874229431152,11.206918716430664,35,11
1822,128,2.971246886596881,6.657388207696762,1.0082843205009009,1.0394161576424876,64,116,15.584177017211914,11.206918716430664,64,12
1823,1,6.6666441745249605,6.666644174524962,0.9761515456901962,0.9761515456901969,0,0,6.7059478759765625,6.7059478759765625,1,1
1823,2,5.602989033769169,5.602989033769169,0.9935610176712084,0.9935610176712083,0,0,7.341696739196777,6.7059478759765625,2,2
1823,3,5.440270872926196,5.440270872926196,0.995525541087936,0.995525541087936,0,0,7.749351978302002,6.7059478759765625,3,3
1823,4,4.986670363734912,4.986670363734912,1.0018943005252587,1.0018943005252592,0,0,7.763385772705078,6.7059478759765625,4,4
1823,8,4.719293488547989,4.740670400961917,1.0041345051986397,1.004138080251277,1,1,7.951351165771484,6.7059478759765625,7,7
1823,16,4.234815124759521,4.353854162018637,1.0089022006798989,1.0094450277880105,6,7,8.557332992553711,6.7059478759765625,10,9
1823,32,3.4442053913212733,4.280770464075511,1.0061909694898472,1.0106085291216214,17,21,9.083113670349121,6.7059478759765625,15,11
1823,64,2.292839321181242,4.05627219229934,1.005259542351964,1.017226246057371,26,49,9.765721321105957,6.7059478759765625,38,15
1823,128,0.983726017691117,4.034117156434012,1.0009527720946716,1.0186334512075612,63,112,10.394902229309082,6.7059478759765625,65,16
1824,1,3.104581889590483,3.104581889590484,0.9962003484650648,0.9962003484650657,0,0,3.106800079345703,3.106800079345703,1,1
1824,2,2.7023435929811845,2.702343592981185,0.9987066054211736,0.9987066054211744,0,0,3.376276969909668,3.106800079345703,2,2
1824,3,2.247016469093297,2.247016469093297,1.0015006764716405,1.0015006764716416,0,0,3.4074347019195557,3.106800079345703,3,3
1824,4,2.242215060740888,2.242215060740888,1.0016119658906666,1.0016119658906681,0,0,3.500093698501587,3.106800079345703,4,4
1824,8,2.1630343411207096,2.170123756036912,1.0017981826396272,1.001824286273022,1,1,3.746419668197632,3.106800079345703,7,7
1824,16,1.886239267559727,2.0997881125725613,1.0008292020089375,1.002367901117457,3,5,3.938286542892456,3.106800079345703,13,11
1824,32,1.4254205066340377,1.9885121218034527,1.0025530665224163,1.0034718373769769,12,22,4.140074253082275,3.106800079345703,20,10
1824,64,0.5129348703163471,1.9293528477866095,1.0001556046183302,1.0042165051752012,31,49,4.477213382720947,3.106800079345703,33,15
1824,128,0.047608295002716336,1.9002151917683465,0.9998299118467999,1.0050803911804664,65,109,4.92037296295166,3.106800079345703,63,19
1825,1,8.90650119524763,8.90650119524763,0.9567122255031383,0.9567122255031419,0,0,9.00097942352295,9.00097942352295,1,1
1825,2,7.9381728785346155,7.938172878534617,0.9861676024704595,0.9861676024704626,0,0,10.796874046325684,9.00097942352295,2,2
1825,3,7.543334662098847,7.543334662098847,0.9987984548516041,0.9987984548516065,0,0,11.3317289352417,9.00097942352295,3,3
1825,4,7.024114810209783,7.024114810209782,1.0159881835263176,1.015988183526319,0,0,11.80999755859375,9.00097942352295,4,4
1825,8,6.589637471987558,6.945194077044738,1.0096368622953713,1.0174502540165866,3,3,13.206578254699707,9.00097942352295,5,5
1825,16,6.275662537002555,6.81960056616359,1.0156033733427294,1.024795985039165,6,9,13.909001350402832,9.00097942352295,10,7
1825,32,5.672229639308474,6.705969934464593,1.0174719096286342,1.0303351520478552,14,23,14.424962997436523,9.00097942352295,18,9
1825,64,4.530104729479228,6.6747647264437635,1.0096633813558007,1.0332538717807649,28,52,15.12826156616211,9.00097942352295,36,12
1825,128,2.836344628086542,6.561511531921478,1.0068167410156557,1.041537358909705,54,113,15.925796508789062,9.00097942352295,74,15
1826,1,10.80095822539927,10.800958225399272,0.9424694514364889,0.9424694514364894,0,0,10.939064025878906,10.939064025878906,1,1
1826,2,9.35189902847784,9.35189902847784,0.9784284146925623,0.9784284146925621,0,0,12.017635345458984,10.939064025878906,2,2
1826,3,8.50896857776351,8.50896857776351,1.003296905891905,1.0032969058919055,0,0,12.643050193786621,10.939064025878906,3,3
1826,4,8.337454792599914,8.337454792599914,1.0077467648048772,1.0077467648048777,0,0,12.6836576461792,10.939064025878906,4,4
1826,8,7.746017370273323,7.753566810524867,1.0284722068111487,1.02838471172393,1,1,13.245003700256348,10.939064025878906,7,7
1826,16,6.674513884250597,7.218808109653753,1.0471477920417056,1.046610299824742,4,6,13.999959945678711,10.939064025878906,12,10
1826,32,6.099779719555902,6.963979648573955,1.0520798689289725,1.0564491534399387,12,19,14.306316375732422,10.939064025878906,20,13
1826,64,5.103891206099769,6.850462533510967,1.0450721030102883,1.0609154282041093,33,45,14.984356880187988,10.939064025878906,31,19
1826,128,2.994040953700423,6.848978658640732,1.0169638226846827,1.061246120109897,58,108,15.538057327270508,10.939064025878906,70,20
1827,1,10.469007373629461,10.469007373629463,0.9295464598012426,0.9295464598012428,0,0,10.677833557128906,10.677833557128906,1,1
1827,2,8.889335019261793,8.889335019261793,0.9678722572968599,0.9678722572968597,0,0,10.791571617126465,10.677833557128906,2,2
1827,3,8.647048446003113,8.647048446003113,0.9735460667036164,0.9735460667036151,0,0,10.827210426330566,10.677833557128906,3,3
1827,4,8.639849025389147,8.639849025389147,0.9740514381324809,0.9740514381324801,0,0,11.072440147399902,10.677833557128906,4,4
1827,8,7.896276972121929,7.898735862124122,0.9968314023433902,0.9968460230062226,1,1,11.92205810546875,10.677833557128906,7,7
1827,16,7.251671093287095,7.408313005751389,1.010908842280203,1.012503630022902,5,6,12.866333961486816,10.677833557128906,11,10
1827,32,6.091858937519911,7.234967148160401,0.9972889309901997,1.018274523798214,16,20,13.56764030456543,10.677833557128906,16,12
1827,64,4.344147003502792,7.059903603152261,0.9975978740646889,1.029646182106944,31,47,14.173696517944336,10.677833557128906,33,17
1827,128,2.926219171310847,6.98051574080547,0.9999760298349649,1.0344636297549559,60,106,14.913561820983887,10.677833557128906,68,22
1828,1,9.65406444820608,9.65406444820608,0.9333057055800639,0.9333057055800659,0,0,9.86175537109375,9.86175537109375,1,1
1828,2,8.157735940005649,8.157735940005649,0.9704897392164695,0.9704897392164709,0,0,10.127838134765625,9.86175537109375,2,2
1828,3,7.386054672406781,7.3860546724067815,0.9865673407117155,0.9865673407117155,0,0,10.180325508117676,9.86175537109375,3,3
1828,4,6.891813815425541,6.891813815425541,0.9956459217647308,0.9956459217647305,0,0,10.47113037109375,9.86175537109375,4,4
1828,8,6.829289240573975,6.833610308542002,0.9972116417502715,0.9974125436804584,1,1,10.851630210876465,9.86175537109375,7,7
1828,16,6.624790867111998,6.831302917866867,0.9961646507855851,0.9974603461371647,7,7,11.597944259643555,9.86175537109375,9,9
1828,32,6.1677953162483865,6.685973252350198,0.9971346638330483,1.0011363482503093,15,24,12.245501518249512,9.86175537109375,17,8
1828,64,5.186568661647666,6.639620324115926,0.9933842268564836,1.0052759795777813,34,56,13.191142082214355,9.86175537109375,30,8
1828,128,3.897072856731083,6.614362669483038,0.9871197520096171,1.0089602307474137,65,116,14.000779151916504,9.86175537109375,63,12
1829,1,6.753271862801106,6.753271862801107,0.9762143353516121,0.9762143353516144,0,0,6.791210651397705,6.791210651397705,1,1
1829,2,5.816545320006138,5.816545320006137,0.9878589689666009,0.9878589689666006,0,0,6.98424768447876,6.791210651397705,2,2
1829,3,5.527051618808784,5.527051618808785,0.9915672019086172,0.9915672019086175,0,0,7.156062126159668,6.791210651397705,3,3
1829,4,5.515391178434362,5.527051618808785,0.9916204310841062,0.9915672019086175,1,1,7.372683525085449,6.791210651397705,3,3
1829,8,4.792981129757262,4.818986088926672,1.003421302666549,1.002748931268133,3,3,7.6434736251831055,6.791210651397705,5,5
1829,16,3.8142360819003267,4.040652801244911,1.0165341240023282,1.0143177112359043,6,5,8.350215911865234,6.791210651397705,10,11
1829,32,2.980739778536761,3.8698641758143846,1.0111552605628695,1.0176970784213721,14,20,8.90964126586914,6.791210651397705,18,12
1829,64,2.485086310246202,3.8386979285376275,1.006016934327482,1.0184724371389453,34,51,9.516499519348145,6.791210651397705,30,13
1829,128,1.219231868858231,3.81602264511249,0.9981405481176652,1.020041243777191,69,111,10.289674758911133,6.791210651397705,59,17
1830,1,11.60599046117368,11.605990461173684,0.9067888252216566,0.9067888252216582,0,0,11.938901901245117,11.938901901245117,1,1
1830,2,9.094426684192435,9.094426684192435,0.9775432174522602,0.9775432174522599,0,0,11.976797103881836,11.938901901245117,2,2
1830,3,8.309163524549179,8.309163524549179,0.9955409895150205,0.9955409895150211,0,0,12.08389949798584,11.938901901245117,3,3
1830,4,7.507706404389604,7.507706404389605,1.0144561197473922,1.0144561197473918,0,0,12.293964385986328,11.938901901245117,4,4
1830,8,7.031322090791197,7.031322090791196,1.025048501407681,1.025048501407682,0,0,12.664592742919922,11.938901901245117,8,8
1830,16,6.447432725543947,6.50446421280113,1.042124556680268,1.0422584077282346,3,3,13.629143714904785,11.938901901245117,13,13
1830,32,5.830152365968931,6.32805501753307,1.0508480147117965,1.0501628841469401,12,18,14.295995712280273,11.938901901245117,20,14
1830,64,4.236557746022324,6.277762542392939,1.0303024837337462,1.0526314757545143,30,47,15.229645729064941,11.938901901245117,34,17
1830,128,2.398476651778306,6.1717507673899,1.0084861856543903,1.0625646445454608,60,108,16.093807220458984,11.938901901245117,68,20
1831,1,8.413349958177646,8.413349958177648,0.9539315715076304,0.9539315715076323,0,0,8.523846626281738,8.523846626281738,1,1
1831,2,6.8687705425087815,6.868770542508782,0.9860153624436732,0.9860153624436736,0,0,8.737587928771973,8.523846626281738,2,2
1831,3,6.548976099033478,6.548976099033478,0.9921100516535526,0.992110051653553,0,0,9.569526672363281,8.523846626281738,3,3
1831,4,6.490505422214911,6.490505422214911,0.9949367580412747,0.9949367580412751,0,0,10.275310516357422,8.523846626281738,4,4
1831,8,6.044031002976532,6.0969843716693255,1.0040494175207062,1.0053982240015005,2,2,10.584824562072754,8.523846626281738,6,6
1831,16,5.84513425370044,5.970803172923676,1.0090740089801973,1.010582884107211,5,5,11.122512817382812,8.523846626281738,11,11
1831,32,4.999453272919979,5.803961058757191,1.0112481112459601,1.0180282727150032,14,18,11.854470252990723,8.523846626281738,18,14
1831,64,3.50874911002418,5.649639816206219,1.0036096632467288,1.027509786125109,29,45,12.648996353149414,8.523846626281738,35,19
1831,128,2.308927287508304,5.556098795494082,0.9988482759240156,1.0324100511933152,62,110,13.575998306274414,8.523846626281738,66,18
1832,1,7.144616589303863,7.144616589303862,0.9801172691115365,0.9801172691115385,0,0,7.16973876953125,7.16973876953125,1,1
1832,2,6.396535033651788,6.396535033651789,0.9935156864005371,0.9935156864005383,0,0,7.588862419128418,7.16973876953125,2,2
1832,3,5.419813544835753,5.419813544835753,1.0021073328358672,1.0021073328358678,0,0,7.664978504180908,7.16973876953125,3,3
1832,4,4.726869437866279,4.726869437866278,1.0104583505107705,1.0104583505107707,0,0,7.746120452880859,7.16973876953125,4,4
1832,8,4.603946017026536,4.610545006855345,1.0124500395379767,1.0130132432052703,2,2,8.512288093566895,7.16973876953125,6,6
1832,16,4.4701176022927385,4.605320501965919,1.0133092413268878,1.0134157408972555,5,8,9.088691711425781,7.16973876953125,11,8
1832,32,3.9797263584324174,4.462299113553169,1.017330012211311,1.020052070961647,12,22,9.679126739501953,7.16973876953125,20,10
1832,64,2.943224155775388,4.411483394434049,1.002706535013596,1.021790786518599,28,51,10.59834098815918,7.16973876953125,36,13
1832,128,1.59564852304873,4.382678146762141,1.0012468914009256,1.0246111595289016,60,114,11.323217391967773,7.16973876953125,68,14
1833,1,8.321520453786754,8.321520453786752,0.961914058043142,0.961914058043144,0,0,8.396185874938965,8.396185874938965,1,1
1833,2,6.9405701980489285,6.940570198048929,0.9887036473122383,0.9887036473122396,0,0,9.094691276550293,8.396185874938965,2,2
1833,3,6.222019948548222,6.222019948548222,1.000855405900769,1.0008554059007706,0,0,9.180349349975586,8.396185874938965,3,3
1833,4,6.103256466555109,6.10325646655511,1.0033778802289495,1.0033778802289501,0,0,9.188814163208008,8.396185874938965,4,4
1833,8,5.836726486619922,5.855866652376502,1.006411758532061,1.0065000623574556,1,1,9.72437572479248,8.396185874938965,7,7
1833,16,5.497631095830097,5.605126838777716,1.0124856897506747,1.0129997765173477,6,6,10.14866828918457,8.396185874938965,10,10
1833,32,5.017470464560085,5.419133660966206,1.0190701968299305,1.018888147475475,11,18,10.520069122314453,8.396185874938965,21,14
1833,64,3.790421017567964,5.358069293801102,1.0134915031617786,1.0215442182430834,27,46,11.167587280273438,8.396185874938965,37,18
1833,128,2.4966452784591224,5.315102093430618,1.0039691593892042,1.0259237972152027,63,107,11.7813720703125,8.396185874938965,65,21
1834,1,7.8139410323396215,7.8139410323396215,0.964679089967063,0.9646790899670646,0,0,7.884978294372559,7.884978294372559,1,1
1834,2,6.653399829152523,6.653399829152523,0.9821160433933671,0.9821160433933673,0,0,8.452669143676758,7.884978294372559,2,2
1834,3,6.479384195676917,6.479384195676917,0.9867999808707167,0.9867999808707169,0,0,9.237953186035156,7.884978294372559,3,3
1834,4,6.308993095663314,6.308993095663313,0.9899464976710977,0.9899464976710972,0,0,9.306618690490723,7.884978294372559,4,4
1834,8,5.337903282162156,5.40643739039942,1.0075219103171322,1.007113743552713,2,2,10.190855026245117,7.884978294372559,6,6
1834,16,4.985205216068859,5.290515634342971,1.010569782925546,1.008916706092216,5,9,10.635415077209473,7.884978294372559,11,7
1834,32,4.5283795956604935,5.262555674039503,1.0122268228159659,1.0096156163445997,14,24,11.039246559143066,7.884978294372559,18,8
1834,64,3.558539250165405,5.226116523693633,1.0056496925389333,1.0111631374664398,30,54,11.453537940979004,7.884978294372559,34,10
1834,128,2.084494569464005,5.023197087722537,1.0016233373045864,1.0206244116278524,62,116,12.19347858428955,7.884978294372559,66,12
1835,1,8.839905660531125,8.839905660531125,0.9479749479352954,0.947974947935297,0,0,8.97714900970459,8.97714900970459,1,1
1835,2,7.8205792251941455,7.820579225194148,0.9692818613458508,0.9692818613458516,0,0,9.545772552490234,8.97714900970459,2,2
1835,3,7.175637854518244,7.1756378545182455,0.9848432087798411,0.9848432087798427,0,0,9.744256019592285,8.97714900970459,3,3
1835,4,6.890630353975537,6.890630353975538,0.9916606284755983,0.991660628475599,0,0,9.820623397827148,8.97714900970459,4,4
1835,8,6.456846881810279,6.462704526075079,1.00033835919911,1.000919554519474,2,2,10.255193710327148,8.97714900970459,6,6
1835,16,6.0514133586449805,6.186907168456461,1.0099633751786319,1.0124066258065518,7,7,10.979870796203613,8.97714900970459,9,9
1835,32,4.2939013515467375,5.933772269629105,1.0120315978787389,1.0224105287187992,11,19,11.555854797363281,8.97714900970459,21,13
1835,64,3.4886210907946893,5.83478219563105,1.0107428676689616,1.0261190533150704,30,51,11.955107688903809,8.97714900970459,34,13
1835,128,1.9658056058867621,5.738956746332922,1.002138357105767,1.0285465962677158,64,114,12.673713684082031,8.97714900970459,64,14
1836,1,6.977077971562577,6.9770779715625775,0.9742561963995011,0.9742561963995022,0,0,7.020157337188721,7.020157337188721,1,1
1836,2,6.054782359560459,6.054782359560459,0.9886959053363871,0.988695905336388,0,0,7.461209774017334,7.020157337188721,2,2
1836,3,5.798830927428346,5.798830927428345,0.9937860992564332,0.9937860992564341,0,0,7.925849437713623,7.020157337188721,3,3
1836,4,5.737951803541201,5.737951803541201,0.9956728456780146,0.9956728456780152,0,0,8.017313957214355,7.020157337188721,4,4
1836,8,4.731835333007125,4.79905266259041,1.0094791511139978,1.0096371519109124,1,1,8.167237281799316,7.020157337188721,7,7
1836,16,4.495471029151143,4.580060811309639,1.0144413802887358,1.0150454342240574,4,6,8.902077674865723,7.020157337188721,12,10
1836,32,3.9727931123333184,4.441291072915789,1.016070914720375,1.0215528927833137,12,15,9.61779499053955,7.020157337188721,20,17
1836,64,2.7082548597128286,4.386067507496932,1.0038366298748183,1.0235102875503042,30,46,10.145184516906738,7.020157337188721,34,18
1836,128,1.8063616354825853,4.295098386138053,1.0022827034764892,1.0268872225789039,65,111,10.876642227172852,7.020157337188721,63,17
1837,1,6.659004734460783,6.659004734460782,0.977316804274656,0.9773168042746563,0,0,6.6934123039245605,6.6934123039245605,1,1
1837,2,5.880059990963873,5.880059990963873,0.9865265260405076,0.9865265260405087,0,0,6.8504743576049805,6.6934123039245605,2,2
1837,3,5.265596976381842,5.265596976381842,0.9979275255938967,0.9979275255938982,0,0,7.501617431640625,6.6934123039245605,3,3
1837,4,5.236230639127375,5.265596976381842,0.9973212279790442,0.9979275255938982,1,1,7.778357028961182,6.6934123039245605,3,3
1837,8,4.184956832328472,4.357579656164139,1.0122177511499333,1.0126265472497524,2,2,8.55871868133545,6.6934123039245605,6,6
1837,16,3.660615163438951,4.1426847100012365,1.013538421459597,1.0157048959342532,7,8,9.269071578979492,6.6934123039245605,9,8
1837,32,3.210646367365451,4.068437611599092,1.0141255565671345,1.0185945604569053,15,20,9.835719108581543,6.6934123039245605,17,12
1837,64,2.227252111370996,3.952937303189772,1.0059595473612446,1.0205350457532347,29,49,10.43110179901123,6.6934123039245605,35,15
1837,128,1.2505579270275815,3.823015288269358,1.0000625695815564,1.0255382060745597,69,112,11.209521293640137,6.6934123039245605,59,16
1838,1,9.68315144765348,9.683151447653481,0.9464011569034821,0.9464011569034836,0,0,9.817896842956543,9.817896842956543,1,1
1838,2,7.832387276310903,7.832387276310904,0.9800249734004897,0.9800249734004919,0,0,10.173285484313965,9.817896842956543,2,2
1838,3,7.756793666463339,7.756793666463339,0.982317347399859,0.9823173473998602,0,0,10.324260711669922,9.817896842956543,3,3
1838,4,7.360493040978611,7.360649198160851,0.9906280552198092,0.9906511976786733,1,1,10.339179992675781,9.817896842956543,3,3
1838,8,6.471638358704271,6.506504814473745,1.007342383727297,1.0071276371629811,2,2,10.718770980834961,9.817896842956543,6,6
1838,16,5.797310452774716,6.4232754670314,1.0111577027672078,1.0094958359853874,4,8,11.449772834777832,9.817896842956543,12,8
1838,32,4.690870615593393,6.1876279897303235,1.019610117251315,1.0187516856345997,16,19,11.709188461303711,9.817896842956543,16,13
1838,64,3.173110310923573,5.865833448666803,1.0054517483015202,1.0292534560507438,29,51,12.419149398803711,9.817896842956543,35,13
1838,128,1.578408682430013,5.746348336726753,0.9992998727852953,1.031356235509639,57,110,13.063859939575195,9.817896842956543,71,18
1839,1,6.650980655970186,6.650980655970188,0.9735262215199689,0.9735262215199707,0,0,6.699647903442383,6.699647903442383,1,1
1839,2,5.067519451646465,5.067519451646465,0.9934440420439326,0.9934440420439332,0,0,6.9016618728637695,6.699647903442383,2,2
1839,3,4.42050200472937,4.42050200472937,0.9999421001962335,0.9999421001962334,0,0,6.993398666381836,6.699647903442383,3,3
1839,4,4.192766700463335,4.192766700463335,1.0046536727017477,1.004653672701748,0,0,7.086174488067627,6.699647903442383,4,4
1839,8,3.948912423257508,3.9879152296221694,1.0082158050724535,1.0086452909663661,1,1,7.689094066619873,6.699647903442383,7,7
1839,16,3.597791644150104,3.810244437505636,1.0101374539302272,1.012044552159042,3,6,8.19854736328125,6.699647903442383,13,10
1839,32,2.9176769639752087,3.6842887742137265,1.0095639685965387,1.0160352907263839,14,20,8.72847843170166,6.699647903442383,18,12
1839,64,1.9561958402976238,3.6388425190581835,1.004907752229288,1.0174238475711033,29,47,9.30953598022461,6.699647903442383,35,17
1839,128,1.033220174422392,3.510567295454795,0.9995211048371662,1.0215859661658766,65,112,10.084288597106934,6.699647903442383,63,16
1840,1,5.743103558741058,5.743103558741058,0.9794895714478696,0.9794895714478701,0,0,5.776017665863037,5.776017665863037,1,1
1840,2,4.469205837316283,4.469205837316282,0.9962915990802088,0.9962915990802085,0,0,5.8673200607299805,5.776017665863037,2,2
1840,3,4.250232119664927,4.250232119664927,0.9985196043627553,0.9985196043627542,0,0,6.243030548095703,5.776017665863037,3,3
1840,4,4.201374895272602,4.201374895272603,0.9990188305941152,0.9990188305941146,0,0,6.364780902862549,5.776017665863037,4,4
1840,8,3.804176844047301,3.804216270941812,1.0043785095680247,1.0043993361734123,1,1,7.189098358154297,5.776017665863037,7,7
1840,16,3.2597939143227865,3.5879670196427305,1.0080666176781379,1.0094982742736502,5,8,7.7362565994262695,5.776017665863037,11,8
1840,32,2.8306992914585947,3.4030484820083915,1.0076433951524615,1.0134216339892803,15,18,8.534635543823242,5.776017665863037,17,14
1840,64,1.8705732106650843,3.2544892700421304,0.9998833065808865,1.0158675758741182,31,52,9.397113800048828,5.776017665863037,33,12
1840,128,1.1849984226726438,3.2544892700421304,0.9960154766962939,1.0158675758741182,62,116,10.432802200317383,5.776017665863037,66,12
1841,1,10.610231311679053,10.610231311679051,0.933921028962246,0.933921028962248,0,0,10.790892601013184,10.790892601013184,1,1
1841,2,9.013315376777195,9.013315376777195,0.9777393894541211,0.977739389454122,0,0,11.704574584960938,10.790892601013184,2,2
1841,3,8.989132707165027,8.989132707165027,0.978788931059482,0.9787889310594824,0,0,11.93043041229248,10.790892601013184,3,3
1841,4,8.63592425703998,8.63592425703998,0.9867608345507228,0.9867608345507245,0,0,12.117975234985352,10.790892601013184,4,4
1841,8,8.427027715340955,8.54974196802497,0.9916695852032824,0.9904875727551294,2,3,12.62148666381836,10.790892601013184,6,5
1841,16,7.8716607766668,8.179293123472345,1.006347312802085,1.004659448949712,5,8,12.86535358428955,10.790892601013184,11,8
1841,32,6.54804977232787,8.00597207195289,1.0243428172023346,1.0129256945083702,12,21,13.499801635742188,10.790892601013184,20,11
1841,64,4.765518581935581,7.155183840204511,1.0268756403984083,1.0421761873756465,25,51,14.290480613708496,10.790892601013184,39,13
1841,128,2.6934416344074035,6.9921124768771215,1.006554675614095,1.0500665122638368,58,110,15.0602388381958,10.790892601013184,70,18
1842,1,7.530987108221666,7.530987108221669,0.962855609887627,0.9628556098876292,0,0,7.610021591186523,7.610021591186523,1,1
1842,2,6.178101497112273,6.178101497112273,0.9869794704905294,0.9869794704905313,0,0,7.951992034912109,7.610021591186523,2,2
1842,3,5.676871925451886,5.676871925451886,0.9957471504940911,0.9957471504940927,0,0,8.250449180603027,7.610021591186523,3,3
1842,4,5.43007918817588,5.430079188175879,1.0000791534432119,1.000079153443212,0,0,8.434490203857422,7.610021591186523,4,4
1842,8,5.426822262339223,5.430079188175879,0.9999969511861021,1.000079153443212,3,4,9.244644165039062,7.610021591186523,5,4
1842,16,4.675999208291895,4.829204915588331,1.0150386458618803,1.0150109866572623,6,8,9.965096473693848,7.610021591186523,10,8
1842,32,3.8490286260007305,4.681470240254827,1.0129220809893456,1.0216702506196085,12,20,10.938444137573242,7.610021591186523,20,12
1842,64,3.3520065409674613,4.624156013627664,1.0122385471048656,1.0265055283865019,32,51,11.824063301086426,7.610021591186523,32,13
1842,128,1.9193683363399707,4.582631310250023,1.001664723218689,1.0285710491192699,64,110,12.807146072387695,7.610021591186523,64,18
1843,1,5.631336387976874,5.631336387976876,0.9781593655034899,0.9781593655034916,0,0,5.67003059387207,5.67003059387207,1,1
1843,2,4.407777482616242,4.407777482616242,0.9937740889416944,0.9937740889416957,0,0,6.300561904907227,5.67003059387207,2,2
1843,3,4.274785399186501,4.274785399186502,0.9966843699119379,0.996684369911939,0,0,6.470682621002197,5.67003059387207,3,3
1843,4,4.159675458648072,4.159675458648072,0.9989524628183679,0.9989524628183685,0,0,6.721374988555908,5.67003059387207,4,4
1843,8,3.760494739259322,3.7604947392593218,1.0047680858322465,1.0047680858322476,0,0,7.213526248931885,5.67003059387207,8,8
1843,16,3.410814401510174,3.4625790083058687,1.0085938219478399,1.010356568679651,4,6,7.720843315124512,5.67003059387207,12,10
1843,32,2.971639196777729,3.4225389798650703,1.0095982557601646,1.0119096693762963,12,19,8.471652030944824,5.67003059387207,20,13
1843,64,2.024437183569405,3.2016330286511385,1.006200501970087,1.0174646271783399,28,51,9.048595428466797,5.67003059387207,36,13
1843,128,1.0505955250318966,3.1928121539112087,1.0004937875278088,1.0183714688674137,64,115,9.723274230957031,5.67003059387207,64,13
1844,1,10.555219692103623,10.555219692103627,0.9305349487093911,0.9305349487093927,0,0,10.758593559265137,10.758593559265137,1,1
1844,2,8.344157465629804,8.344157465629808,0.9860651840179946,0.9860651840179959,0,0,11.00421142578125,10.758593559265137,2,2
1844,3,7.716359194777771,7.716359194777771,1.0005144894787676,1.0005144894787694,0,0,11.043282508850098,10.758593559265137,3,3
1844,4,7.471113295917466,7.4711132959174655,1.0058558420967618,1.0058558420967627,0,0,11.712769508361816,10.758593559265137,4,4
1844,8,7.289885981299181,7.297043360457095,1.0085067643162917,1.0086722878554228,1,1,12.174348831176758,10.758593559265137,7,7
1844,16,6.514192612893525,6.84733557732584,1.0264646450681578,1.0236031241085324,5,7,12.483428001403809,10.758593559265137,11,9
1844,32,6.145919940535687,6.692753149869348,1.032617228338359,1.028997306077698,14,17,12.913400650024414,10.758593559265137,18,15
1844,64,4.946680536811233,6.552428793939101,1.0182468363511583,1.0341056639333768,30,48,13.584893226623535,10.758593559265137,34,16
1844,128,3.2518399951705215,6.482775940286819,1.00721632376615,1.039032779602145,63,110,14.215274810791016,10.758593559265137,65,18
1845,1,2.4383481339867092,2.4383481339867092,0.9927157321705556,0.9927157321705561,0,0,2.448801279067993,2.448801279067993,1,1
1845,2,2.02813046013356,2.0281304601335597,0.9956369476468854,0.9956369476468858,0,0,2.6840713024139404,2.448801279067993,2,2
1845,3,1.643803181539661,1.6438031815396608,0.9974438861599448,0.9974438861599448,0,0,2.7529308795928955,2.448801279067993,3,3
1845,4,1.6115653820905573,1.6115653820905573,0.9970864420933094,0.9970864420933094,0,0,2.7897531986236572,2.448801279067993,4,4
1845,8,1.5334081869863774,1.5714316077280774,0.9969916600525404,0.9972690710517036,1,2,3.065540313720703,2.448801279067993,7,6
1845,16,1.3158666847654934,1.4988274685435687,0.9987955710859899,0.9986991550903133,6,6,3.3203136920928955,2.448801279067993,10,10
1845,32,1.0941726200349378,1.4457842312453928,0.9984940940208226,0.9989589081178558,17,21,3.6265740394592285,2.448801279067993,15,11
1845,64,0.5931644195293548,1.2803363533190415,0.9983741027972862,1.0011718810307293,30,51,4.069561958312988,2.448801279067993,34,13
1845,128,0.2930641438289834,1.2603603602502151,0.9983702194244297,1.0014906538508612,67,117,4.551329612731934,2.448801279067993,61,11
1846,1,7.391432818604347,7.391432818604349,0.9620335274991376,0.9620335274991392,0,0,7.480676651000977,7.480676651000977,1,1
1846,2,6.236424256407479,6.23642425640748,0.9821575365064585,0.9821575365064585,0,0,7.63286828994751,7.480676651000977,2,2
1846,3,5.738851287606294,5.738851287606293,0.9906657073775051,0.9906657073775048,0,0,7.7854413986206055,7.480676651000977,3,3
1846,4,5.717021648489313,5.717021648489313,0.9912963437266192,0.9912963437266186,0,0,7.912096977233887,7.480676651000977,4,4
1846,8,5.214022469257319,5.230500642513602,0.9995197171160306,0.9994259204643516,2,2,7.9386773109436035,7.480676651000977,6,6
1846,16,4.614105989461466,4.857424384254604,1.007209374387291,1.003397980906707,5,8,8.153582572937012,7.480676651000977,11,8
1846,32,3.5420519265402137,4.6882813305363245,1.0121215450873349,1.0083834645686474,12,20,8.810883522033691,7.480676651000977,20,12
1846,64,2.2764953206158873,4.540753405474667,1.0043570075108774,1.0129573795715414,33,50,9.49556827545166,7.480676651000977,31,14
1846,128,1.409555724605906,4.456858363708463,0.9996617878466045,1.0163143508067505,67,109,10.070401191711426,7.480676651000977,61,19
1847,1,6.49528964232268,6.495289642322681,0.9775156514729794,0.9775156514729807,0,0,6.530752182006836,6.530752182006836,1,1
1847,2,5.17824170211799,5.17824170211799,0.9963683473548154,0.9963683473548162,0,0,6.8461151123046875,6.530752182006836,2,2
1847,3,4.6234267612472815,4.623426761247281,1.0037458693759098,1.0037458693759105,0,0,6.87626838684082,6.530752182006836,3,3
1847,4,4.143298661934023,4.143298661934023,1.0077753931060245,1.0077753931060247,0,0,6.938000202178955,6.530752182006836,4,4
1847,8,3.385247985989266,3.395185167968098,1.017893412401232,1.0175926678804794,2,2,7.828514575958252,6.530752182006836,6,6
1847,16,3.0664392519664094,3.1871191939980053,1.0222178287061954,1.022761131677925,3,3,8.361411094665527,6.530752182006836,13,13
1847,32,2.313085821184735,3.0768490044695156,1.012608757799468,1.024801791231103,12,19,8.831900596618652,6.530752182006836,20,13
1847,64,1.7600031825289213,3.0702071223747263,1.0061074592516654,1.025332191809773,27,49,9.542516708374023,6.530752182006836,37,15
1847,128,1.094753435320426,3.024617723508046,1.0000151034349218,1.0262393307362299,66,113,10.33119010925293,6.530752182006836,62,15
1848,1,11.810050954017287,11.810050954017287,0.9290468748562483,0.9290468748562486,0,0,11.996485710144043,11.996485710144043,1,1
1848,2,10.32115883051464,10.32115883051464,0.9664525283771264,0.9664525283771263,0,0,12.329522132873535,11.996485710144043,2,2
1848,3,9.076510708883296,9.076510708883294,0.9906314835442694,0.9906314835442667,0,0,12.354630470275879,11.996485710144043,3,3
1848,4,8.794541330112747,8.794541330112747,0.9979549801442573,0.997954980144254,0,0,12.447688102722168,11.996485710144043,4,4
1848,8,7.9431256884567345,7.943125688456736,1.0232202668698334,1.0232202668698307,0,0,12.712541580200195,11.996485710144043,8,8
1848,16,7.004459360448886,7.26813984813065,1.0356140235658764,1.0327340042706519,7,9,13.026446342468262,11.996485710144043,9,7
1848,32,6.108278192603189,7.118899295325415,1.042609220929049,1.0358091877727449,14,22,13.30579662322998,11.996485710144043,18,10
1848,64,4.964515269611526,6.858985102882995,1.040192192377778,1.045582070297427,28,50,13.778925895690918,11.996485710144043,36,14
1848,128,3.254038163829217,6.690032790073464,1.0268266845489316,1.0519417795088264,61,112,14.286592483520508,11.996485710144043,67,16
1849,1,8.706111968903004,8.706111968902999,0.9570800812488792,0.957080081248882,0,0,8.799919128417969,8.799919128417969,1,1
1849,2,7.548123582793195,7.548123582793195,0.9824352566214726,0.982435256621474,0,0,9.945061683654785,8.799919128417969,2,2
1849,3,7.091508851946724,7.091508851946724,0.9918929720190433,0.9918929720190438,0,0,10.173843383789062,8.799919128417969,3,3
1849,4,6.734596176001569,6.734596176001569,0.9977757779000686,0.9977757779000693,0,0,10.392263412475586,8.799919128417969,4,4
1849,8,6.079889867011823,6.19610180717297,1.012873149099631,1.010610936769499,2,2,10.594046592712402,8.799919128417969,6,6
1849,16,5.483029258057457,5.765460242715205,1.0205514419416115,1.0197148562324045,5,7,11.313431739807129,8.799919128417969,11,9
1849,32,4.8070939092420435,5.6052811817813115,1.0257607843198973,1.0253602990347854,15,20,11.900857925415039,8.799919128417969,17,12
1849,64,4.0562622108666,5.604336606839534,1.0198503841199473,1.02557203801464,27,50,12.49397087097168,8.799919128417969,37,14
1849,128,2.3730187491303973,5.44964614442334,1.0030371666669795,1.0360692879573823,54,113,13.324507713317871,8.799919128417969,74,15
1850,1,10.657076125063892,10.657076125063893,0.9286463211338004,0.9286463211338013,0,0,10.869821548461914,10.869821548461914,1,1
1850,2,9.201139742822992,9.201139742822992,0.963094056744858,0.9630940567448588,0,0,10.873895645141602,10.869821548461914,2,2
1850,3,8.484766485124512,8.484766485124512,0.977253778753333,0.9772537787533331,0,0,11.014698028564453,10.869821548461914,3,3
1850,4,8.371845589519198,8.3718455895192,0.9799624138915721,0.9799624138915719,0,0,11.020804405212402,10.869821548461914,4,4
1850,8,7.906995372781976,7.910786526404526,0.9903260184034827,0.9899843361755696,1,2,11.176481246948242,10.869821548461914,7,6
1850,16,7.013560728244737,7.251394563304664,1.0075498374379108,1.0024431198806283,5,6,11.651228904724121,10.869821548461914,11,10
1850,32,6.0689322401210175,7.117911857527404,1.0249553971726715,1.0075780022816279,14,22,12.019556999206543,10.869821548461914,18,10
1850,64,4.68266582837217,6.8274734328603355,1.0144578619713553,1.0201753376330636,31,51,12.725297927856445,10.869821548461914,33,13
1850,128,2.909324097092221,6.719339024169247,1.00147415512067,1.0239430967618879,65,113,13.215611457824707,10.869821548461914,63,15
1851,1,8.413560266575821,8.413560266575823,0.9537161295306171,0.9537161295306188,0,0,8.524452209472656,8.524452209472656,1,1
1851,2,7.660851299294288,7.660851299294289,0.973171967841279,0.9731719678412797,0,0,9.296335220336914,8.524452209472656,2,2
1851,3,7.475218820736679,7.475218820736679,0.9755073725876129,0.9755073725876124,0,0,9.71933364868164,8.524452209472656,3,3
1851,4,7.469527140923508,7.469527140923507,0.9759602037252808,0.9759602037252808,0,0,9.751119613647461,8.524452209472656,4,4
1851,8,6.8866768299439,6.951476662805449,0.9911130754004676,0.9908023036438666,3,2,10.322101593017578,8.524452209472656,5,6
1851,16,5.810455926480324,6.632950052644877,1.0014923683577042,1.001066612119269,5,8,10.879369735717773,8.524452209472656,11,8
1851,32,4.948574914992717,6.411029140074615,1.013942873123531,1.0074243120524522,14,21,11.20139217376709,8.524452209472656,18,11
1851,64,3.679767067631664,6.116534462204139,1.0175522893704558,1.0190107387673237,29,47,11.978859901428223,8.524452209472656,35,17
1851,128,2.26201484782164,5.711574480617564,1.006618326058636,1.0381691222894762,62,110,12.712515830993652,8.524452209472656,66,18
1852,1,6.53149084893018,6.531490848930167,0.9748043352294015,0.9748043352294027,0,0,6.5759406089782715,6.5759406089782715,1,1
1852,2,5.782624274827756,5.782624274827756,0.9894332100044292,0.9894332100044304,0,0,7.660158157348633,6.5759406089782715,2,2
1852,3,5.726649382137831,5.72664938213783,0.9922822987777113,0.9922822987777121,0,0,8.152746200561523,6.5759406089782715,3,3
1852,4,5.502579056614929,5.50302918596095,0.99601815075819,0.9961557699576319,1,1,8.174078941345215,6.5759406089782715,3,3
1852,8,5.3042576417605325,5.328556682975234,1.0019998216682704,1.002609403681439,2,2,9.062917709350586,6.5759406089782715,6,6
1852,16,4.880377877397275,5.192191582262142,1.00277927247027,1.0053639175701985,6,7,9.6235990524292,6.5759406089782715,10,9
1852,32,3.70680159724251,5.133543606687988,1.0027742169383003,1.0089275413292569,14,21,10.362637519836426,6.5759406089782715,18,11
1852,64,2.3804916042483155,5.050263797886087,1.0021644303336994,1.012476104790903,27,52,11.020828247070312,6.5759406089782715,37,12
1852,128,1.5361563993609002,5.026606205579056,0.9984373121280657,1.015032165921187,62,115,11.871784210205078,6.5759406089782715,66,13
1853,1,11.203120085844935,11.203120085844937,0.9461914122917269,0.9461914122917301,0,0,11.315059661865234,11.315059661865234,1,1
1853,2,9.61223066453152,9.612230664531511,0.9850129241114295,0.9850129241114312,0,0,11.752405166625977,11.315059661865234,2,2
1853,3,8.470681244805562,8.470681244805562,1.004262303274459,1.0042623032744595,0,0,12.033055305480957,11.315059661865234,3,3
1853,4,7.986646683918188,7.986646683918188,1.0131820483743659,1.013182048374366,0,0,12.246222496032715,11.315059661865234,4,4
1853,8,7.486232378619571,7.491467034103627,1.027357598838028,1.027694447116677,1,1,12.593710899353027,11.315059661865234,7,7
1853,16,7.044804398314405,7.3086525140400544,1.0302682024297498,1.036230897035704,6,5,13.555023193359375,11.315059661865234,10,11
1853,32,6.212372713817429,7.026367693797222,1.040873236851147,1.0517445442465596,16,18,14.447920799255371,11.315059661865234,16,14
1853,64,4.547564531024581,6.978701365411083,1.029584881382704,1.0565646831819968,36,45,15.123851776123047,11.315059661865234,28,19
1853,128,2.804786140900551,6.962406619828132,1.01313746876643,1.058003930064288,62,108,15.942995071411133,11.315059661865234,66,20
1854,1,7.342882801800938,7.34288280180094,0.9664567145894104,0.9664567145894112,0,0,7.4127516746521,7.4127516746521,1,1
1854,2,5.925979743094051,5.925979743094051,0.9882132662349316,0.9882132662349317,0,0,7.418231964111328,7.4127516746521,2,2
1854,3,5.810541212537538,5.810541212537538,0.9900646246085112,0.9900646246085116,0,0,7.738116264343262,7.4127516746521,3,3
1854,4,5.7829912036665565,5.7829912036665565,0.9905229712294055,0.9905229712294054,0,0,7.7696943283081055,7.4127516746521,4,4
1854,8,5.32479150006796,5.342906264802666,0.9994709949232745,0.9991487913325462,2,2,8.165574073791504,7.4127516746521,6,6
1854,16,4.772164805706405,4.933129523784426,1.0100981758794607,1.0103075185919956,6,6,8.892178535461426,7.4127516746521,10,10
1854,32,4.060217424386183,4.652514558049178,1.0121485171365856,1.017615458807743,15,19,9.629613876342773,7.4127516746521,17,13
1854,64,2.853114394863086,4.635057290404909,1.0018563285707127,1.0185835828999577,28,47,10.258214950561523,7.4127516746521,36,17
1854,128,1.4822079915520576,4.616514104947971,0.9987627140986933,1.0206466405316508,59,107,11.231535911560059,7.4127516746521,69,21
1855,1,10.298263104410736,10.298263104410736,0.9376169757842348,0.9376169757842365,0,0,10.461329460144043,10.461329460144043,1,1
1855,2,8.520720955772259,8.520720955772259,0.9756079773907831,0.9756079773907841,0,0,10.66085147857666,10.461329460144043,2,2
1855,3,8.005684918819208,8.005684918819208,0.9850832634534233,0.9850832634534248,0,0,10.823773384094238,10.461329460144043,3,3
1855,4,7.921212335429455,7.921212335429453,0.9876992796449862,0.9876992796449864,0,0,10.834637641906738,10.461329460144043,4,4
1855,8,7.516641779520133,7.563260512455013,0.9945952252778035,0.9940722097776892,2,2,11.371877670288086,10.461329460144043,6,6
1855,16,6.970538247500485,7.463094166424759,1.0032134476473287,0.9981984209075156,4,4,11.79149341583252,10.461329460144043,12,12
1855,32,5.813008824380418,6.589093768177003,1.0228925067474828,1.0208715916398934,14,23,12.264355659484863,10.461329460144043,18,9
1855,64,4.697254753733867,6.333381351179659,1.0196394948771696,1.0273578160005876,34,49,12.938246726989746,10.461329460144043,30,15
1855,128,2.8058044727573748,6.315460949799992,1.0038645041925407,1.0283352705030882,62,112,13.78189468383789,10.461329460144043,66,16
1856,1,10.482126644809522,10.482126644809524,0.9356598275549788,0.9356598275549818,0,0,10.650896072387695,10.650896072387695,1,1
1856,2,7.932805454984382,7.932805454984384,0.9939213304321641,0.9939213304321657,0,0,10.748061180114746,10.650896072387695,2,2
1856,3,7.27653769800642,7.276537698006425,1.0119335135565235,1.011933513556524,0,0,11.920794486999512,10.650896072387695,3,3
1856,4,7.179846087093417,7.179846087093416,1.0166072259189365,1.0166072259189374,0,0,12.117349624633789,10.650896072387695,4,4
1856,8,6.8589679358900275,6.886535080440206,1.021694728866809,1.022720777722082,2,2,12.45544147491455,10.650896072387695,6,6
1856,16,6.353801096469663,6.541844675414805,1.033419139831383,1.0337375484985647,4,6,12.91762638092041,10.650896072387695,12,10
1856,32,5.662640447014055,6.459151893447429,1.032622122196441,1.041297672262821,11,20,13.842384338378906,10.650896072387695,21,12
1856,64,4.366438306959725,6.33092851184131,1.020971673996745,1.049191505692883,32,46,14.716534614562988,10.650896072387695,32,18
1856,128,2.835115082208172,6.25208143112433,1.0093537441372749,1.058115786470461,60,107,15.637670516967773,10.650896072387695,68,21
1857,1,4.749152743824052,4.749152743824051,0.9866158274547133,0.9866158274547143,0,0,4.767190456390381,4.767190456390381,1,1
1857,2,4.3981596311092686,4.398159631109269,0.992956023369075,0.992956023369076,0,0,4.909755229949951,4.767190456390381,2,2
1857,3,4.158700072610003,4.158700072610004,0.99481227068725,0.9948122706872502,0,0,4.962814807891846,4.767190456390381,3,3
1857,4,3.7432826106888393,3.7432826106888397,0.9984629689249851,0.9984629689249856,0,0,5.133835792541504,4.767190456390381,4,4
1857,8,3.2604402798383507,3.361649215510228,1.0020354588960527,1.0019852104790359,3,2,5.216457366943359,4.767190456390381,5,6
1857,16,2.7954016651769975,3.3493571173391827,1.0038204146422316,1.0021070748334342,7,8,5.383684158325195,4.767190456390381,9,8
1857,32,2.187618050146548,3.2074028593301187,1.0042301831459017,1.0040401320097962,13,25,5.7300920486450195,4.767190456390381,19,7
1857,64,1.1066085620625865,3.1802257452342704,1.0001007548535703,1.0047449901538426,28,54,6.132888317108154,4.767190456390381,36,10
1857,128,0.18317654318578772,2.9845406470047315,0.999441645592657,1.0085242171810287,63,114,6.624415874481201,4.767190456390381,65,14
1858,1,11.441945811042176,11.441945811042169,0.9192196488970135,0.9192196488970175,0,0,11.691454887390137,11.691454887390137,1,1
1858,2,10.001212653809642,10.001212653809644,0.9595015541802896,0.9595015541802911,0,0,11.746030807495117,11.691454887390137,2,2
1858,3,9.777508243606615,9.777508243606613,0.9663167797519272,0.9663167797519283,0,0,12.364531517028809,11.691454887390137,3,3
1858,4,9.541178349667156,9.541178349667156,0.9767171728751107,0.9767171728751115,0,0,12.713788032531738,11.691454887390137,4,4
1858,8,9.30501822453351,9.305018224533514,0.9850438467480802,0.9850438467480803,0,0,13.830912590026855,11.691454887390137,8,8
1858,16,8.62853707115994,9.121866453995157,0.9994091975136917,1.0001317146831712,4,4,14.498658180236816,11.691454887390137,12,12
1858,32,6.3190645170702355,8.52622753806007,1.0081125030027775,1.0214459639129785,10,21,15.232800483703613,11.691454887390137,22,11
1858,64,5.266955031779695,8.461867292158141,1.0048964304834378,1.026394731232264,30,52,15.864842414855957,11.691454887390137,34,12
1858,128,3.6154112358992143,8.461867292158141,0.998487708870622,1.026394731232264,64,116,16.570951461791992,11.691454887390137,64,12
1859,1,9.652301394959167,9.65230139495917,0.9503974769600612,0.9503974769600627,0,0,9.766650199890137,9.766650199890137,1,1
1859,2,8.544631907583518,8.544631907583517,0.9734778149424492,0.9734778149424481,0,0,9.973445892333984,9.766650199890137,2,2
1859,3,7.3473860344151865,7.347386034415187,0.9998925348918191,0.999892534891817,0,0,10.115639686584473,9.766650199890137,3,3
1859,4,6.808993022090508,6.808993022090509,1.007761991098483,1.0077619910984812,0,0,10.117652893066406,9.766650199890137,4,4
1859,8,6.638651873219186,6.715456495349046,1.0102070207760891,1.009771706121437,1,1,10.330338478088379,9.766650199890137,7,7
1859,16,5.778534798358461,5.892844129036489,1.0314656811758292,1.0302115679770667,3,6,10.948173522949219,9.766650199890137,13,10
1859,32,4.596733459099289,5.719307054706086,1.0266795863789728,1.032691456052849,12,19,11.659523963928223,9.766650199890137,20,13
1859,64,3.2698825715771602,5.6778618085671635,1.0122092487242267,1.0343873594394695,32,49,12.477499008178711,9.766650199890137,32,15
1859,128,1.8025448321231883,5.6332392663881885,1.0035597810590047,1.0374712465990958,57,110,13.155085563659668,9.766650199890137,71,18
1860,1,10.96828237297581,10.968282372975812,0.9282237897900885,0.9282237897900912,0,0,11.17857551574707,11.17857551574707,1,1
1860,2,9.3371800581253,9.3371800581253,0.969841157240889,0.9698411572408914,0,0,11.968735694885254,11.17857551574707,2,2
1860,3,8.134954032558399,8.1349540325584,1.0021051911586776,1.0021051911586798,0,0,11.970046043395996,11.17857551574707,3,3
1860,4,7.779848388792912,7.779848388792911,1.0112120455564972,1.0112120455564988,0,0,12.429710388183594,11.17857551574707,4,4
1860,8,7.2488933686680275,7.249280972358759,1.0254816225047185,1.0254011567144912,1,1,12.633148193359375,11.17857551574707,7,7
1860,16,6.284914611277917,6.92815084929373,1.0388748385749333,1.0357073130174004,3,6,13.10908317565918,11.17857551574707,13,10
1860,32,5.110080365796711,6.8451598682177,1.0501652234206742,1.0407965238534291,12,19,13.650110244750977,11.17857551574707,20,13
1860,64,4.363396912574188,6.341539569550158,1.0360258689105886,1.0525796672050383,31,48,14.345048904418945,11.17857551574707,33,16
1860,128,2.8841863350172523,6.246698511402383,1.013253602249478,1.056637114960652,59,114,14.947458267211914,11.17857551574707,69,14
1861,1,8.774836934255061,8.774836934255053,0.9636276637627346,0.9636276637627361,0,0,8.843220710754395,8.843220710754395,1,1
1861,2,7.377123387179515,7.377123387179517,0.9932057695028872,0.9932057695028889,0,0,9.199299812316895,8.843220710754395,2,2
1861,3,7.071675043330186,7.071675043330185,0.9986546854545996,0.9986546854546005,0,0,9.5391206741333,8.843220710754395,3,3
1861,4,6.804198146332169,6.80419814633217,1.002502716603514,1.002502716603514,0,0,9.695758819580078,8.843220710754395,4,4
1861,8,6.071970189003258,6.152118929790105,1.015407107522455,1.0161655737614324,2,2,10.346461296081543,8.843220710754395,6,6
1861,16,5.520126600950777,5.981491683027047,1.0167678283880972,1.0189904374924357,6,9,10.931018829345703,8.843220710754395,10,7
1861,32,4.61896674391842,5.847977380329417,1.0133375796114086,1.0257386054847353,12,20,11.64269733428955,8.843220710754395,20,12
1861,64,3.383238634970999,5.469774091854885,1.016002590299171,1.0407492280898456,30,49,12.286199569702148,8.843220710754395,34,15
1861,128,2.276508097517089,5.417822484862594,1.0087363222341903,1.0427068820034096,63,113,12.972044944763184,8.843220710754395,65,15
1862,1,9.22264649567655,9.22264649567655,0.9528715759162311,0.9528715759162324,0,0,9.331902503967285,9.331902503967285,1,1
1862,2,8.259518076878212,8.259518076878214,0.9735537218141104,0.9735537218141108,0,0,9.334447860717773,9.331902503967285,2,2
1862,3,7.625966175316168,7.625966175316167,0.9827068749370637,0.9827068749370635,0,0,9.43699836730957,9.331902503967285,3,3
1862,4,7.233617564568289,7.233617564568288,0.9908832806589667,0.990883280658966,0,0,9.539417266845703,9.331902503967285,4,4
1862,8,6.428758885676153,6.474497416662897,1.0021104719600338,1.0010625580617547,3,4,9.78148078918457,9.331902503967285,5,4
1862,16,5.978022216650745,6.363137287145271,1.0065255313944133,1.0036994533982881,7,10,9.945326805114746,9.331902503967285,9,6
1862,32,5.0801208498774075,5.99343030823759,1.0153203649087836,1.0131682317805,14,21,10.421381950378418,9.331902503967285,18,11
1862,64,3.098668166808671,5.9140762770131685,1.0067120341091989,1.0146916872766694,33,49,10.835899353027344,9.331902503967285,31,15
1862,128,1.3968725837689184,5.797040473901904,1.000879279144627,1.0202034970399119,58,110,11.275739669799805,9.331902503967285,70,18
1863,1,8.621055024805319,8.621055024805317,0.9596051923795835,0.9596051923795839,0,0,8.7079496383667,8.7079496383667,1,1
1863,2,6.524954585411335,6.524954585411335,0.9966334537083114,0.9966334537083114,0,0,8.778071403503418,8.7079496383667,2,2
1863,3,6.517736586920389,6.517736586920389,0.9969670952985664,0.9969670952985661,0,0,8.94138240814209,8.7079496383667,3,3
1863,4,6.508842314123432,6.508842314123432,0.9971869361784974,0.9971869361784973,0,0,8.959626197814941,8.7079496383667,4,4
1863,8,5.34574050861856,5.646152315327232,1.01640601227558,1.0124487283738794,2,2,9.172981262207031,8.7079496383667,6,6
1863,16,4.811670790270359,5.167984333395598,1.0245634395360002,1.0205182779650117,5,7,9.471280097961426,8.7079496383667,11,9
1863,32,4.3369253967500985,5.014019779485113,1.0234523092677335,1.025299597260577,14,20,10.139717102050781,8.7079496383667,18,12
1863,64,3.295515772920622,4.997963407590832,1.0143784618487781,1.0271691522932873,27,50,10.862558364868164,8.7079496383667,37,14
1863,128,1.7333514792677658,4.952260112996235,1.0028387008963342,1.0308036314438072,64,109,11.728527069091797,8.7079496383667,64,19
1864,1,5.904804006749971,5.9048040067499725,0.9774047298209347,0.9774047298209363,0,0,5.944337368011475,5.944337368011475,1,1
1864,2,5.14221356786247,5.14221356786247,0.9888889518099035,0.9888889518099044,0,0,6.648120880126953,5.944337368011475,2,2
1864,3,4.517493035553899,4.517493035553899,1.0017033598294773,1.001703359829478,0,0,7.208610534667969,5.944337368011475,3,3
1864,4,4.516656952032581,4.516656952032581,1.0017291364418945,1.001729136441895,0,0,7.320754528045654,5.944337368011475,4,4
1864,8,4.234451020288229,4.297378386567518,1.005432443273488,1.0063413879146492,3,3,7.850465297698975,5.944337368011475,5,5
1864,16,3.8789353527235515,4.184267645813509,1.0085351293829263,1.0096554817112453,5,7,8.553474426269531,5.944337368011475,11,9
1864,32,3.4160800969317933,3.9744323600176057,1.009934332565341,1.0175404726027137,13,17,9.188785552978516,5.944337368011475,19,15
1864,64,2.508012914424466,3.936491794044606,1.0060448672117959,1.0199637093457432,32,48,9.70128345489502,5.944337368011475,32,16
1864,128,1.2121547875450942,3.8688161297083523,1.0012998760754115,1.0200245720095884,65,112,10.365092277526855,5.944337368011475,63,16
1865,1,9.273249712479908,9.273249712479913,0.9504784648968794,0.9504784648968824,0,0,9.388909339904785,9.388909339904785,1,1
1865,2,8.015833600150765,8.015833600150767,0.9772945989493652,0.9772945989493682,0,0,9.431341171264648,9.388909339904785,2,2
1865,3,7.262040929125398,7.262040929125397,0.9978086060931283,0.9978086060931297,0,0,10.345479965209961,9.388909339904785,3,3
1865,4,7.1516168720604085,7.262040929125397,0.996140378118751,0.9978086060931297,1,1,10.936552047729492,9.388909339904785,3,3
1865,8,6.068491344271322,6.276717839147936,1.0202573637022838,1.020902775785265,2,3,11.3140230178833,9.388909339904785,6,5
1865,16,4.961316281373468,5.695325481832507,1.0225936255385517,1.0285885698167445,4,9,11.959550857543945,9.388909339904785,12,7
1865,32,4.510343407506118,5.369294327246464,1.0279589558783095,1.0402109323712994,13,22,12.61916446685791,9.388909339904785,19,10
1865,64,3.8088469908465483,5.369187159074509,1.0126603034064523,1.0403864787608141,34,53,13.288126945495605,9.388909339904785,30,11
1865,128,2.5833446204455863,5.367736179280679,1.0041640931592728,1.0408694940409577,64,115,14.180550575256348,9.388909339904785,64,13
1866,1,9.369337067401517,9.369337067401522,0.9425628581214112,0.9425628581214146,0,0,9.52606201171875,9.52606201171875,1,1
1866,2,7.870191969531798,7.870191969531798,0.9881233624060624,0.988123362406065,0,0,11.693493843078613,9.52606201171875,2,2
1866,3,7.493327431361316,7.493327431361316,0.9959979191487632,0.9959979191487651,0,0,11.808481216430664,9.52606201171875,3,3
1866,4,7.476669131444248,7.476669131444248,0.9978590599174237,0.997859059917426,0,0,12.111034393310547,9.52606201171875,4,4
1866,8,7.036963875255709,7.05221641319058,1.0143309661146884,1.0158831376106234,1,1,12.911620140075684,9.52606201171875,7,7
1866,16,6.60663881741699,6.749444784848843,1.0261975212826504,1.0277233932190715,3,4,13.433460235595703,9.52606201171875,13,12
1866,32,5.492755979342145,6.4479096538431095,1.0356696304278779,1.0413561302093197,13,16,13.988655090332031,9.52606201171875,19,16
1866,64,4.452344529144154,6.365800981263716,1.029261319198792,1.0444281102281139,29,46,14.479485511779785,9.52606201171875,35,18
1866,128,2.9124358789370697,6.337380884588452,1.010917947147011,1.0466239330228455,58,109,15.046765327453613,9.52606201171875,70,19
1867,1,8.498422156498581,8.49842215649856,0.9616653371311193,0.9616653371311199,0,0,8.574273109436035,8.574273109436035,1,1
1867,2,7.4760720547184425,7.4760720547184425,0.9821240668926942,0.982124066892694,0,0,8.980666160583496,8.574273109436035,2,2
1867,3,7.273117006161804,7.273117006161804,0.9857557662045112,0.9857557662045109,0,0,9.28671932220459,8.574273109436035,3,3
1867,4,6.446216012780627,6.446216012780627,1.0011276242672975,1.0011276242672973,0,0,9.322052955627441,8.574273109436035,4,4
1867,8,5.917813662684633,5.932667207505919,1.0111807491584628,1.01120953667887,1,1,9.830510139465332,8.574273109436035,7,7
1867,16,5.197983094434675,5.4127367484571165,1.0237891762688196,1.0231344330326606,4,5,10.458712577819824,8.574273109436035,12,11
1867,32,4.364047705216958,5.050698932238757,1.0276298712200764,1.0304116281981481,11,15,11.041937828063965,8.574273109436035,21,17
1867,64,2.9763941451489906,4.978540921227921,1.0146202160434494,1.0332633468641754,31,47,11.909599304199219,8.574273109436035,33,17
1867,128,1.6872717379672921,4.978504015894679,1.0011127649519875,1.033333903950472,66,110,12.563645362854004,8.574273109436035,62,18
1868,1,9.947224642314637,9.947224642314639,0.9327436986191244,0.9327436986191264,0,0,10.147590637207031,10.147590637207031,1,1
1868,2,8.317394469516113,8.317394469516111,0.9794649808159159,0.9794649808159165,0,0,10.531899452209473,10.147590637207031,2,2
1868,3,7.475355542138866,7.475355542138866,0.9969678815026561,0.9969678815026569,0,0,10.79090690612793,10.147590637207031,3,3
1868,4,7.239631336014407,7.239631336014407,1.0054390471017216,1.0054390471017218,0,0,11.772295951843262,10.147590637207031,4,4
1868,8,7.0311227690986575,7.053028387805556,1.0122196014125417,1.0128206048953372,2,2,13.2413330078125,10.147590637207031,6,6
1868,16,6.464728898886974,6.683962695628317,1.0249066681547696,1.0269102423894223,6,8,13.837620735168457,10.147590637207031,10,8
1868,32,4.9104736599805685,6.643308525969113,1.0182226105955876,1.0294990825941583,14,23,14.554189682006836,10.147590637207031,18,9
1868,64,4.041812673354017,6.507237652892713,1.0083853873420217,1.0331416116002248,26,54,15.346755027770996,10.147590637207031,38,10
1868,128,3.0233686669338287,6.505627267878037,1.001806707841856,1.03389693383168,66,117,16.12710189819336,10.147590637207031,62,11
1869,1,7.021842263411623,7.021842263411623,0.9721355016335886,0.97213550163359,0,0,7.071530818939209,7.071530818939209,1,1
1869,2,5.705292469145951,5.705292469145951,0.9932568422463233,0.9932568422463242,0,0,7.328125953674316,7.071530818939209,2,2
1869,3,5.419356593990166,5.419356593990166,0.9967092525038086,0.9967092525038097,0,0,7.433446407318115,7.071530818939209,3,3
1869,4,5.389772177410563,5.389772177410564,0.9972910514586295,0.9972910514586312,0,0,7.469150543212891,7.071530818939209,4,4
1869,8,4.79518247118362,4.795207795201586,1.0047878408643065,1.0047815146772,1,1,7.951847076416016,7.071530818939209,7,7
1869,16,4.358230729180998,4.515626668564945,1.009569357874501,1.011674478462737,6,7,8.612776756286621,7.071530818939209,10,9
1869,32,3.7275691942789098,4.11925726630931,1.0168570946042987,1.020678049816159,14,19,9.219667434692383,7.071530818939209,18,13
1869,64,2.2820647524217224,3.9835881793829078,1.0072817916122876,1.0237726192855012,26,50,10.049398422241211,7.071530818939209,38,14
1869,128,1.0518807027164345,3.8567450671186765,1.0010941162778275,1.0278574103936238,65,113,10.787551879882812,7.071530818939209,63,15
1870,1,7.197300238837948,7.197300238837949,0.9659002395054225,0.9659002395054241,0,0,7.270536422729492,7.270536422729492,1,1
1870,2,6.237969763407022,6.237969763407021,0.9835512347729434,0.9835512347729438,0,0,7.7527923583984375,7.270536422729492,2,2
1870,3,5.7522564995668795,5.752256499566875,0.9891509555146938,0.9891509555146942,0,0,7.856031894683838,7.270536422729492,3,3
1870,4,5.638283759756763,5.638283759756763,0.9917382844514422,0.9917382844514429,0,0,7.943221569061279,7.270536422729492,4,4
1870,8,4.441686165503533,4.483464224317932,1.0059371415393978,1.005354921204364,2,2,8.1653470993042,7.270536422729492,6,6
1870,16,4.0658747642303865,4.2122902106643805,1.0121538658342373,1.011660262428778,4,7,8.840784072875977,7.270536422729492,12,9
1870,32,3.607465195846927,4.106744517730131,1.0148320437997493,1.015474619389562,12,21,9.372295379638672,7.270536422729492,20,11
1870,64,2.734037606223808,4.053849338321898,1.0074300122950195,1.018115010490448,24,50,9.860564231872559,7.270536422729492,40,14
1870,128,1.5740952133352824,4.0271349453714755,1.00065576821735,1.0188646517103612,66,110,10.676412582397461,7.270536422729492,62,18
1871,1,8.359058830787562,8.359058830787564,0.9686406010829446,0.9686406010829465,0,0,8.411311149597168,8.411311149597168,1,1
1871,2,7.701100626584243,7.701100626584231,0.9799212060699731,0.9799212060699742,0,0,8.883867263793945,8.411311149597168,2,2
1871,3,6.929425170678773,6.929425170678773,0.9961793963730458,0.9961793963730463,0,0,9.229452133178711,8.411311149597168,3,3
1871,4,5.824690117567253,5.824690117567254,1.012462467761539,1.0124624677615388,0,0,9.280430793762207,8.411311149597168,4,4
1871,8,5.432590779232665,5.467701980394891,1.018499244863957,1.0191395444972602,1,1,9.590660095214844,8.411311149597168,7,7
1871,16,4.907143455616504,4.992775968304371,1.0284270362254357,1.0289877003957695,5,5,10.048748016357422,8.411311149597168,11,11
1871,32,4.177168823129498,4.828453007151496,1.030718654192757,1.0338750606007694,11,13,10.778438568115234,8.411311149597168,21,19
1871,64,3.3528467547550203,4.748366122636892,1.0143911990684757,1.0359596189426332,28,43,11.466741561889648,8.411311149597168,36,21
1871,128,1.9018762660068522,4.692495541911432,1.0023792429050806,1.0401158099214118,61,103,12.141871452331543,8.411311149597168,67,25
1872,1,7.168592151745084,7.1685921517450835,0.9729576553561964,0.972957655356196,0,0,7.215090274810791,7.215090274810791,1,1
1872,2,5.950793762542985,5.950793762542985,0.9881414519434799,0.98814145194348,0,0,7.284066677093506,7.215090274810791,2,2
1872,3,5.280811900147801,5.280811900147801,0.9959259819814597,0.9959259819814585,0,0,7.327215671539307,7.215090274810791,3,3
1872,4,5.232147359504495,5.232147359504495,0.9965049690360348,0.9965049690360335,0,0,7.360078811645508,7.215090274810791,4,4
1872,8,4.7933120224325885,4.8060983024376975,1.0024844399032418,1.0023900477220329,1,1,7.73200798034668,7.215090274810791,7,7
1872,16,4.423480393124069,4.670592501279449,1.006410182450268,1.0057720244392572,4,5,8.232168197631836,7.215090274810791,12,11
1872,32,3.53168411831347,4.448270667989577,1.0098842658491356,1.012247554693881,14,21,8.79652214050293,7.215090274810791,18,11
1872,64,2.3414381793962242,4.421302356008322,1.0074143191421534,1.0146253369055596,33,49,9.44724178314209,7.215090274810791,31,15
1872,128,1.1238530958734643,4.393629421104444,1.000521483789389,1.0162528898827943,61,110,10.05652141571045,7.215090274810791,67,18
1873,1,7.859141706802439,7.859141706802442,0.9557488403348363,0.9557488403348374,0,0,7.978053569793701,7.978053569793701,1,1
1873,2,7.600544586773717,7.600544586773717,0.9606881625758532,0.9606881625758532,0,0,8.091732025146484,7.978053569793701,2,2
1873,3,7.523206423410805,7.523206423410804,0.9620040761054269,0.9620040761054269,0,0,8.267306327819824,7.978053569793701,3,3
1873,4,7.292216205792956,7.292216205792955,0.966549324304961,0.966549324304961,0,0,8.468413352966309,7.978053569793701,4,4
1873,8,6.932852383951685,7.281996164486958,0.9699491181656057,0.9669415126311256,1,3,8.571305274963379,7.978053569793701,7,5
1873,16,6.422760944896493,7.1901670850217645,0.9750075976847503,0.9694642356350279,6,12,8.813987731933594,7.978053569793701,10,4
1873,32,5.944132819859931,7.18869181504033,0.9758672643400366,0.9696717325465006,15,27,8.98397445678711,7.978053569793701,17,5
1873,64,3.8602613862153534,5.805681903024481,1.0002343777332137,0.9966637951229782,29,56,9.233235359191895,7.978053569793701,35,8
1873,128,3.3573573675137345,5.784477993806021,0.9991190910442747,0.9980798899606985,71,119,9.53042984008789,7.978053569793701,57,9
1874,1,8.368557104528943,8.368557104528945,0.9544929996291314,0.9544929996291328,0,0,8.478549003601074,8.478549003601074,1,1
1874,2,7.083179417931159,7.08317941793116,0.9810344767342939,0.9810344767342948,0,0,9.137682914733887,8.478549003601074,2,2
1874,3,6.506913018018505,6.506913018018505,0.9921214865529642,0.992121486552965,0,0,9.327648162841797,8.478549003601074,3,3
1874,4,6.278309748071952,6.278309748071952,0.9955084283341542,0.9955084283341551,0,0,9.450931549072266,8.478549003601074,4,4
1874,8,5.697123470932503,5.714763766947602,1.0062581201288021,1.0056825534143616,1,1,9.910181999206543,8.478549003601074,7,7
1874,16,5.224314736180416,5.503842427665039,1.0125892928391007,1.012902930003246,4,7,10.567946434020996,8.478549003601074,12,9
1874,32,4.5175501543440735,5.3070028331063925,1.0163231150863317,1.017964964153625,15,19,10.95692253112793,8.478549003601074,17,13
1874,64,3.464037717105761,5.02930219895146,1.0157789604938285,1.0279812234973618,32,46,11.710999488830566,8.478549003601074,32,18
1874,128,2.091993225670585,4.942327566094257,1.0061148678459992,1.0321470166280557,59,109,12.21191692352295,8.478549003601074,69,19
1875,1,8.666419050968162,8.666419050968162,0.9635368734618198,0.9635368734618222,0,0,8.735179901123047,8.735179901123047,1,1
1875,2,7.072930055370531,7.072930055370531,0.9918684896632737,0.9918684896632746,0,0,8.882879257202148,8.735179901123047,2,2
1875,3,5.6415485823734945,5.641548582373494,1.0132133292537875,1.0132133292537884,0,0,8.980026245117188,8.735179901123047,3,3
1875,4,5.597450607676569,5.597450607676569,1.013569750266626,1.0135697502666259,0,0,9.170491218566895,8.735179901123047,4,4
1875,8,5.142587025396033,5.156570832531242,1.020109913423434,1.0200040750155888,1,1,9.9994478225708,8.735179901123047,7,7
1875,16,4.897075686643037,4.953608099576904,1.023982251529055,1.0254785534985302,7,7,10.623679161071777,8.735179901123047,9,9
1875,32,4.055365202196495,4.873736135563529,1.0164024400112173,1.0285468520364551,13,19,11.031746864318848,8.735179901123047,19,13
1875,64,3.5192232687586396,4.864307534529815,1.0052439551195937,1.028952429094284,30,48,11.636116027832031,8.735179901123047,34,16
1875,128,2.033240679222112,4.849160655507091,0.999974627961155,1.03004365542014,64,113,12.144522666931152,8.735179901123047,64,15
1876,1,8.223845355810663,8.223845355810665,0.9636196563088701,0.9636196563088709,0,0,8.295500755310059,8.295500755310059,1,1
1876,2,6.581897195263792,6.581897195263792,0.9868526182962094,0.9868526182962098,0,0,8.650059700012207,8.295500755310059,2,2
1876,3,6.526844933680454,6.526844933680454,0.9875698779447009,0.9875698779447009,0,0,8.72327709197998,8.295500755310059,3,3
1876,4,5.886933735406027,5.886933735406027,0.9966461393014187,0.9966461393014194,0,0,8.845519065856934,8.295500755310059,4,4
1876,8,5.723764986121712,5.780142520675521,0.9981661601834033,0.9983055695933469,1,3,9.318952560424805,8.295500755310059,7,5
1876,16,5.063414866977687,5.612408929013482,1.0033499613786085,1.0036799780331256,7,9,9.830628395080566,8.295500755310059,9,7
1876,32,4.539974519167801,5.53218882182846,1.000269929983659,1.0071696337979348,13,24,10.278430938720703,8.295500755310059,19,8
1876,64,3.7419403822189876,5.484028056629837,0.9955795187035272,1.008586458368186,30,54,10.68138599395752,8.295500755310059,34,10
1876,128,2.947860313806314,5.474215501754991,0.9930395350486854,1.0096796520451057,56,115,11.292495727539062,8.295500755310059,72,13
1877,1,7.376779286319484,7.376779286319485,0.9774068891331872,0.9774068891331886,0,0,7.408234596252441,7.408234596252441,1,1
1877,2,5.819737079001667,5.819737079001668,0.99550771001588,0.9955077100158817,0,0,7.45543909072876,7.408234596252441,2,2
1877,3,5.124785724385337,5.124785724385336,1.004471013954196,1.0044710139541966,0,0,7.944572925567627,7.408234596252441,3,3
1877,4,4.599606029541702,4.599606029541701,1.013318976141661,1.0133189761416614,0,0,8.08818531036377,7.408234596252441,4,4
1877,8,4.274511692472251,4.407381136169433,1.0165817584903158,1.0165714818987859,1,2,8.666607856750488,7.408234596252441,7,6
1877,16,3.9639178550421836,4.270639048284713,1.0198796224045272,1.020932123003359,6,7,8.96667766571045,7.408234596252441,10,9
1877,32,3.53533778698142,4.229489912723019,1.0172719873047074,1.0218458859789976,15,21,9.640290260314941,7.408234596252441,17,11
1877,64,2.49128746275858,4.08901992280986,1.0092739646436828,1.025276088258952,32,51,10.250042915344238,7.408234596252441,32,13
1877,128,1.5344864548538382,4.084625538874341,1.0041359352726562,1.0255996931545515,65,114,10.906076431274414,7.408234596252441,63,14
1878,1,12.151387241825589,12.151387241825589,0.9035568423610795,0.9035568423610808,0,0,12.502535820007324,12.502535820007324,1,1
1878,2,9.83626935303976,9.836269353039759,0.969956395692821,0.9699563956928223,0,0,12.535844802856445,12.502535820007324,2,2
1878,3,9.700424159867504,9.700424159867504,0.9732755880846223,0.9732755880846234,0,0,12.702920913696289,12.502535820007324,3,3
1878,4,9.581588174914696,9.581588174914696,0.9766796510574721,0.9766796510574727,0,0,13.064577102661133,12.502535820007324,4,4
1878,8,8.936767514402076,8.944667609694188,0.9885196540323234,0.9885869116195887,1,1,13.128746032714844,12.502535820007324,7,7
1878,16,7.706206278313741,7.738864906344878,1.0296208651714513,1.0294066122684595,7,7,13.58789348602295,12.502535820007324,9,9
1878,32,6.586272105713736,7.160351340042616,1.0385939731064096,1.0434945506948123,14,22,13.945362091064453,12.502535820007324,18,10
1878,64,5.511827605764381,7.06763185440677,1.0411971450245696,1.0455285610581053,32,51,14.386845588684082,12.502535820007324,32,13
1878,128,3.232656290562661,6.933669719232537,1.0125769683241521,1.0515205636155358,63,113,14.794042587280273,12.502535820007324,65,15
1879,1,8.484125266149082,8.484125266149086,0.9515152540250591,0.9515152540250612,0,0,8.608399391174316,8.608399391174316,1,1
1879,2,7.439015573146991,7.439015573146991,0.9732532872502804,0.973253287250281,0,0,8.839065551757812,8.608399391174316,2,2
1879,3,7.245442502937815,7.245442502937815,0.978180698430241,0.9781806984302416,0,0,9.306676864624023,8.608399391174316,3,3
1879,4,7.229157301892788,7.229157301892788,0.9780742521888632,0.978074252188864,0,0,9.431160926818848,8.608399391174316,4,4
1879,8,5.452569934573615,5.569635058061612,1.014046837695535,1.0117956125107126,1,2,10.094294548034668,8.608399391174316,7,6
1879,16,4.571175341372056,4.8155206564674105,1.0312829658149307,1.0284754848682445,4,6,10.727482795715332,8.608399391174316,12,10
1879,32,4.020324734010477,4.726320215841935,1.0287773955980586,1.0314044279991155,15,18,11.335010528564453,8.608399391174316,17,14
1879,64,2.8994110932790047,4.638864674476381,1.0153364681456294,1.0357006792222554,32,50,12.0595064163208,8.608399391174316,32,14
1879,128,1.9176125273212261,4.592858450608377,1.0066151018066276,1.037781649200694,59,111,12.637537002563477,8.608399391174316,69,17
1880,1,4.78548594720669,4.78548594720669,0.9900925272944225,0.9900925272944241,0,0,4.795083999633789,4.795083999633789,1,1
1880,2,4.785443105387001,4.785443105387002,0.9901235091080487,0.9901235091080502,0,0,5.890279293060303,4.795083999633789,2,2
1880,3,3.7742541358523822,3.7742541358523827,1.003115091428502,1.0031150914285019,0,0,6.083333969116211,4.795083999633789,3,3
1880,4,3.3586893758282077,3.3586893758282077,1.007061873277416,1.0070618732774166,0,0,6.314027309417725,4.795083999633789,4,4
1880,8,3.094368162336214,3.0952327469315466,1.0093056851897948,1.0093787459897894,2,2,6.59389591217041,4.795083999633789,6,6
1880,16,2.9319269787419526,2.9804343643675315,1.0116592178895125,1.0114089670523818,5,7,6.996348857879639,4.795083999633789,11,9
1880,32,2.542317860735475,2.874181335279057,1.0110958629863829,1.0139805551100833,14,20,7.551932334899902,4.795083999633789,18,12
1880,64,1.6778160237276813,2.806228664868405,1.0023458901720943,1.016017008171826,28,51,8.221048355102539,4.795083999633789,36,13
1880,128,0.8578043040035757,2.7931574377863866,0.9993528148011682,1.0166738502495192,63,113,8.89087963104248,4.795083999633789,65,15
1881,1,8.783335291081686,8.783335291081686,0.9526890486477781,0.9526890486477804,0,0,8.894110679626465,8.894110679626465,1,1
1881,2,8.337552246233649,8.33755224623365,0.962877247900845,0.9628772479008461,0,0,9.583181381225586,8.894110679626465,2,2
1881,3,8.042389829337642,8.042389829337642,0.9683110553869123,0.9683110553869136,0,0,9.983372688293457,8.894110679626465,3,3
1881,4,7.533151039745138,7.53315103974514,0.9816440075947119,0.9816440075947143,0,0,10.185035705566406,8.894110679626465,4,4
1881,8,7.152329215510287,7.152329215510286,0.9904883135539368,0.9904883135539393,0,0,10.899649620056152,8.894110679626465,8,8
1881,16,6.670978484256481,6.842405499651971,0.9992108487466089,0.9998913094859744,7,7,11.56842041015625,8.894110679626465,9,9
1881,32,5.8624946452146185,6.7656123265858845,0.9929768215459329,1.0032911574410524,16,23,12.109421730041504,8.894110679626465,16,9
1881,64,5.0109124437862285,6.679815200448412,1.0005029576793918,1.0074552446196166,30,50,12.542625427246094,8.894110679626465,34,14
1881,128,2.7431778700724907,6.126838288692968,1.0031574220403754,1.0224138760123682,61,115,13.091986656188965,8.894110679626465,67,13
1882,1,8.027386710769928,8.027386710769932,0.9639862902973084,0.9639862902973115,0,0,8.099875450134277,8.099875450134277,1,1
1882,2,6.557281716810744,6.557281716810746,0.9877754701302432,0.9877754701302457,0,0,8.519453048706055,8.099875450134277,2,2
1882,3,5.986214080004029,5.986214080004029,0.9981964057547754,0.9981964057547779,0,0,8.861661911010742,8.099875450134277,3,3
1882,4,5.825573680104594,5.825573680104595,1.001499116563336,1.0014991165633378,0,0,8.864049911499023,8.099875450134277,4,4
1882,8,5.538424522825662,5.563062377976747,1.0063192781857562,1.0059791409519758,3,3,9.225417137145996,8.099875450134277,5,5
1882,16,5.251491568020132,5.408780976189033,1.0085619204314178,1.0086773725088145,7,8,9.923966407775879,8.099875450134277,9,8
1882,32,4.6468302391826315,5.335116144466769,1.0131251734482445,1.0124191904544038,14,21,10.412278175354004,8.099875450134277,18,11
1882,64,3.426141575965422,5.227092881112777,1.0073181471774393,1.0187453228263244,27,50,11.07498550415039,8.099875450134277,37,14
1882,128,1.8507465642318444,5.116110706266942,1.003615290003287,1.023722983588526,61,112,11.799739837646484,8.099875450134277,67,16
1883,1,7.063180003865867,7.063180003865868,0.9682105093310326,0.9682105093310333,0,0,7.1286773681640625,7.1286773681640625,1,1
1883,2,6.480315956644125,6.480315956644126,0.9782314747405226,0.9782314747405226,0,0,7.782357215881348,7.1286773681640625,2,2
1883,3,5.929296131805026,5.929296131805026,0.9907395328296401,0.9907395328296396,0,0,7.84207820892334,7.1286773681640625,3,3
1883,4,5.553966919598351,5.557932783978582,0.9979231669542975,0.9976972923316565,1,1,7.924671173095703,7.1286773681640625,3,3
1883,8,5.145111766371669,5.150075998271037,1.0030412036131335,1.0029358154935988,1,1,8.026106834411621,7.1286773681640625,7,7
1883,16,4.584376294419035,4.669791549202758,1.012122724730836,1.0115594547947249,3,6,8.43358325958252,7.1286773681640625,13,10
1883,32,4.197174396286858,4.525313661060858,1.0129209539233832,1.0148559314393943,14,18,9.075860977172852,7.1286773681640625,18,14
1883,64,2.609962676672153,4.347698420634657,1.0055922953767666,1.0179476863193162,29,48,9.655013084411621,7.1286773681640625,35,16
1883,128,1.2630014960941707,4.141858576119807,0.9996640412230642,1.0219972565747155,62,110,10.361832618713379,7.1286773681640625,66,18
1884,1,6.153194245302103,6.153194245302103,0.9788827351723755,0.9788827351723771,0,0,6.186122417449951,6.186122417449951,1,1
1884,2,5.019564122309443,5.0195641223094425,0.9922105192348836,0.9922105192348829,0,0,7.095179080963135,6.186122417449951,2,2
1884,3,4.9906889688790725,4.9906889688790725,0.9934287987502496,0.993428798750249,0,0,7.480825424194336,6.186122417449951,3,3
1884,4,4.702424947686321,4.7026606140905125,0.9980064501926083,0.998064337858114,1,1,7.520480632781982,6.186122417449951,3,3
1884,8,4.026098152126918,4.065444437066641,1.0089082493993218,1.0074220922605213,2,2,8.12073802947998,6.186122417449951,6,6
1884,16,3.535424358159355,3.7321401688821965,1.0124414392010768,1.0130854536183347,7,9,8.642772674560547,6.186122417449951,9,7
1884,32,3.0281433858508024,3.7054196945409466,1.0131938608955204,1.014415924288705,13,23,8.985553741455078,6.186122417449951,19,9
1884,64,2.0238353758687286,3.45538281856614,1.0069613795556969,1.0196414905508493,28,52,9.51272201538086,6.186122417449951,36,12
1884,128,1.113761346408039,3.428901363282626,1.0009374179665724,1.0212708394711467,64,111,10.506710052490234,6.186122417449951,64,17
1885,1,5.696949209767038,5.696949209767038,0.9787524368924913,0.9787524368924918,0,0,5.73341178894043,5.73341178894043,1,1
1885,2,4.974266620311312,4.974266620311313,0.9892575808232896,0.9892575808232904,0,0,5.777923583984375,5.73341178894043,2,2
1885,3,4.818736174259766,4.818736174259766,0.9906228539103896,0.9906228539103892,0,0,5.914366245269775,5.73341178894043,3,3
1885,4,3.6117344728750256,3.611734472875026,1.0028179460384608,1.0028179460384603,0,0,5.944593906402588,5.73341178894043,4,4
1885,8,3.3272512993783097,3.330418065573432,1.0076152713125937,1.0075407062953514,1,1,6.6026153564453125,5.73341178894043,7,7
1885,16,2.8978860501612096,3.091601546708686,1.0112131108962346,1.010920656437622,4,6,6.949609756469727,5.73341178894043,12,10
1885,32,2.30793598813412,2.83804433244154,1.0126717099918843,1.0154217308255593,15,19,7.451627254486084,5.73341178894043,17,13
1885,64,1.7481400484014664,2.8211446058776826,1.0055155584228093,1.0162243744686612,28,50,8.0923433303833,5.73341178894043,36,14
1885,128,0.887495954936051,2.8052278859939954,1.0003870164412816,1.0170775498117257,64,110,8.840063095092773,5.73341178894043,64,18
1886,1,3.5360564130753085,3.5360564130753094,0.9892259177951269,0.9892259177951293,0,0,3.5517210960388184,3.5517210960388184,1,1
1886,2,3.2089898279372644,3.208989827937265,0.9928462949713872,0.9928462949713885,0,0,4.328423023223877,3.5517210960388184,2,2
1886,3,3.2089850624844085,3.208989827937265,0.9928419909727075,0.9928462949713885,1,1,4.518897533416748,3.5517210960388184,2,2
1886,4,3.206103690221822,3.206103690221822,0.9929062820030538,0.9929062820030551,0,0,4.549357891082764,3.5517210960388184,4,4
1886,8,3.025061263795497,3.044467449123393,0.9954305280978105,0.9955678320460581,1,1,4.787599086761475,3.5517210960388184,7,7
1886,16,2.3095868377218265,2.5047106638049845,1.0007120509600012,1.0007136586544727,8,8,5.582655906677246,3.5517210960388184,8,8
1886,32,2.0318264088040348,2.3699337061984704,1.0001411666939934,1.0026706293138292,16,21,5.815175533294678,3.5517210960388184,16,11
1886,64,1.221650636900798,2.343529695606793,0.9994771733986725,1.0035558113495129,32,52,6.291067600250244,3.5517210960388184,32,12
1886,128,0.32752169320986957,2.2751075733795876,0.9985760660110623,1.0050480668849149,58,114,6.957361221313477,3.5517210960388184,70,14
1887,1,7.6588951450728295,7.65889514507283,0.9641506521850871,0.9641506521850881,0,0,7.73632287979126,7.73632287979126,1,1
1887,2,5.906298677385346,5.9062986773853465,0.9919925344001731,0.9919925344001732,0,0,7.740209102630615,7.73632287979126,2,2
1887,3,5.396623437234166,5.396623437234165,1.0010204368655118,1.0010204368655111,0,0,7.957619667053223,7.73632287979126,3,3
1887,4,5.341987364049503,5.341987364049502,1.002140959543939,1.0021409595439392,0,0,8.235081672668457,7.73632287979126,4,4
1887,8,4.848508782335488,4.848508782335487,1.0096085974316906,1.0096085974316913,0,0,8.554746627807617,7.73632287979126,8,8
1887,16,4.639231438753889,4.753399077920204,1.0132418190467312,1.0128985549803913,5,6,8.966487884521484,7.73632287979126,11,10
1887,32,3.9897390425449726,4.71319597740941,1.0123860826101971,1.0149759853958769,12,18,9.543937683105469,7.73632287979126,20,14
1887,64,2.5210469664890494,4.598283810019927,1.0014362637435354,1.0181010034363287,27,49,10.172076225280762,7.73632287979126,37,15
1887,128,1.3412432578688658,4.5824374045625005,0.9990680695610297,1.0192744532587452,65,112,10.927926063537598,7.73632287979126,63,16
1888,1,6.733252666065072,6.7332526660650736,0.9773661381686881,0.977366138168692,0,0,6.766955375671387,6.766955375671387,1,1
1888,2,5.803967791644243,5.803967791644244,0.992036805118653,0.9920368051186557,0,0,7.087287902832031,6.766955375671387,2,2
1888,3,4.595264864934902,4.5952648649349,1.008144866586801,1.0081448665868025,0,0,7.388126850128174,6.766955375671387,3,3
1888,4,4.593930567365675,4.593930567365675,1.008023903284483,1.0080239032844838,0,0,7.598578929901123,6.766955375671387,4,4
1888,8,4.032765733519167,4.034189411987919,1.0183667557942666,1.0183827598608266,1,1,8.511091232299805,6.766955375671387,7,7
1888,16,3.669034524372192,3.8436689248593763,1.0224397039087227,1.0229049251439484,6,7,8.886680603027344,6.766955375671387,10,9
1888,32,3.362658457976433,3.7914667442989227,1.0210372305978264,1.025285311323282,13,19,9.718663215637207,6.766955375671387,19,13
1888,64,2.648184676504182,3.7630636922240206,1.0075589094763586,1.027764022339793,30,50,10.634892463684082,6.766955375671387,34,14
1888,128,1.6518624964513333,3.666821814930139,1.0009077438016125,1.0299843818926986,63,114,11.459840774536133,6.766955375671387,65,14
1889,1,10.0259555837171,10.0259555837171,0.9412184475549505,0.9412184475549513,0,0,10.180450439453125,10.180450439453125,1,1
1889,2,8.121262226958436,8.121262226958434,0.9805700630637946,0.9805700630637941,0,0,10.292744636535645,10.180450439453125,2,2
1889,3,7.810942710606323,7.810942710606323,0.9888157087809848,0.9888157087809843,0,0,10.649862289428711,10.180450439453125,3,3
1889,4,7.410311702631477,7.410311702631477,0.9976676231372278,0.9976676231372269,0,0,10.741697311401367,10.180450439453125,4,4
1889,8,7.042711370965325,7.145031828766217,1.0058208542674305,1.0056728274527313,1,2,11.539441108703613,10.180450439453125,7,6
1889,16,6.536957508442426,7.0911923900084535,1.0075765038832745,1.009051411562826,6,7,12.178352355957031,10.180450439453125,10,9
1889,32,5.787360375808733,7.005186619005305,1.013026899754816,1.0147939434851383,13,20,12.514854431152344,10.180450439453125,19,12
1889,64,4.298853266622178,6.744939255609845,1.0200233922970656,1.0253565695471778,32,51,12.791192054748535,10.180450439453125,32,13
1889,128,2.183470865453303,6.696043175291519,1.0055616425164833,1.0283532514070362,62,111,13.294635772705078,10.180450439453125,66,17
1890,1,7.648710580122628,7.648710580122629,0.9624717277966502,0.9624717277966521,0,0,7.728832244873047,7.728832244873047,1,1
1890,2,7.017049993424829,7.01704999342483,0.9753563019779744,0.9753563019779751,0,0,7.985492706298828,7.728832244873047,2,2
1890,3,6.558170471286064,6.558170471286064,0.9862284836649952,0.9862284836649959,0,0,8.51224422454834,7.728832244873047,3,3
1890,4,6.305129059299332,6.305129059299331,0.9925327362208384,0.9925327362208389,0,0,8.556554794311523,7.728832244873047,4,4
1890,8,5.2052102723751466,5.272234684999605,1.0108849239740147,1.0108101988574765,1,2,9.118218421936035,7.728832244873047,7,6
1890,16,4.815262371582374,5.143837866045146,1.013211419804998,1.0145012122260635,6,8,10.149113655090332,7.728832244873047,10,8
1890,32,4.106207874367124,4.975108213702938,1.0130441347715884,1.0193017406331069,14,24,11.43272590637207,7.728832244873047,18,8
1890,64,2.808628742752321,4.90574778042271,1.0037143803926472,1.0256605102381324,29,53,12.326504707336426,7.728832244873047,35,11
1890,128,1.5471907326687762,4.70189033904594,1.0011063278263537,1.0315757361356945,62,116,13.314212799072266,7.728832244873047,66,12
1891,1,10.706243142368484,10.706243142368486,0.9188207605638764,0.9188207605638771,0,0,10.97976016998291,10.97976016998291,1,1
1891,2,9.056170912462198,9.056170912462196,0.9648111268375905,0.9648111268375907,0,0,11.433160781860352,10.97976016998291,2,2
1891,3,8.935396446783352,8.935396446783352,0.9674617380863741,0.9674617380863743,0,0,11.458685874938965,10.97976016998291,3,3
1891,4,8.927694051455477,8.927694051455477,0.9679681575486024,0.9679681575486027,0,0,12.016032218933105,10.97976016998291,4,4
1891,8,8.44860085988086,8.653354796909651,0.9764607165340334,0.9765566840973988,2,2,12.385507583618164,10.97976016998291,6,6
1891,16,7.532554784645007,8.525307903027532,0.993183318292759,0.9864918190876173,5,7,13.355493545532227,10.97976016998291,11,9
1891,32,5.959425544682485,7.72505837779398,1.0197262629690043,1.0188848756895443,14,23,13.833484649658203,10.97976016998291,18,9
1891,64,4.600891433332484,7.262740149616913,1.0203463497683731,1.0324126979921162,31,54,14.259305000305176,10.97976016998291,33,10
1891,128,2.828241217942002,7.1282307428125025,1.0034910438990963,1.0385298358984707,64,113,14.795857429504395,10.97976016998291,64,15
1892,1,11.072539708266001,11.072539708266005,0.9272358684297497,0.9272358684297523,0,0,11.285472869873047,11.285472869873047,1,1
1892,2,8.735392530096613,8.735392530096613,0.9907909805993655,0.990790980599368,0,0,11.678211212158203,11.285472869873047,2,2
1892,3,8.269022720490732,8.269022720490732,1.0022012243462748,1.0022012243462757,0,0,11.994585990905762,11.285472869873047,3,3
1892,4,8.173270858344845,8.173270858344845,1.0048402453113872,1.0048402453113883,0,0,12.41777229309082,11.285472869873047,4,4
1892,8,7.8898553630646155,7.889855363064615,1.0132828516543186,1.0132828516543206,0,0,13.164176940917969,11.285472869873047,8,8
1892,16,7.171712866922465,7.732587538746577,1.0156496510358868,1.0209462305031907,5,5,13.817095756530762,11.285472869873047,11,11
1892,32,6.160182825732196,7.5001085633664,1.014584058308341,1.0327079031526272,14,19,14.582544326782227,11.285472869873047,18,13
1892,64,4.562070153585446,7.433681982364418,1.0135805673012905,1.0375598282503211,31,48,15.25850772857666,11.285472869873047,33,16
1892,128,3.297981663949528,7.334244037631061,1.0057069781890031,1.0448025275955104,62,112,16.27565574645996,11.285472869873047,66,16
1893,1,6.973486823497008,6.97348682349701,0.9670012526188062,0.9670012526188079,0,0,7.044350624084473,7.044350624084473,1,1
1893,2,5.85335043306443,5.853350433064428,0.9881759059425903,0.9881759059425917,0,0,7.6095075607299805,7.044350624084473,2,2
1893,3,5.458605258346058,5.458605258346058,0.9952964727317605,0.9952964727317615,0,0,7.622265815734863,7.044350624084473,3,3
1893,4,4.653521005096078,4.653521005096084,1.006943169215488,1.0069431692154884,0,0,7.657586097717285,7.044350624084473,4,4
1893,8,4.150954893321854,4.150954893321853,1.0117471745735251,1.0117471745735256,0,0,8.066762924194336,7.044350624084473,8,8
1893,16,3.717288514985501,3.8355904571721315,1.0156811307104874,1.016880448802637,4,6,8.44900131225586,7.044350624084473,12,10
1893,32,3.248969760357326,3.5862647804162386,1.01219270451779,1.0204491562186326,14,16,9.776206016540527,7.044350624084473,18,16
1893,64,2.6091435697664345,3.578833418979692,1.0037941284122478,1.0211193848716287,33,45,10.681164741516113,7.044350624084473,31,19
1893,128,1.4904374357870236,3.5640816980500203,0.9990747741781417,1.0221816920003848,58,106,11.333131790161133,7.044350624084473,70,22
1894,1,8.755422692262455,8.755422692262457,0.9470074280781787,0.947007428078181,0,0,8.896355628967285,8.896355628967285,1,1
1894,2,7.795352439585955,7.795352439585955,0.9638287233575251,0.9638287233575265,0,0,8.899752616882324,8.896355628967285,2,2
1894,3,7.279971741874768,7.2799717418747685,0.975535296737188,0.9755352967371882,0,0,9.217907905578613,8.896355628967285,3,3
1894,4,6.3441751462202,6.3441751462202,0.9974743304106746,0.9974743304106757,0,0,9.385242462158203,8.896355628967285,4,4
1894,8,6.050843148370297,6.050843148370297,1.006147847189748,1.006147847189749,0,0,10.528582572937012,8.896355628967285,8,8
1894,16,5.608046403632221,5.655648969802167,1.0174656701844278,1.0173898805138457,5,5,11.172612190246582,8.896355628967285,11,11
1894,32,4.7138108292672385,5.400334783155026,1.0186267124326798,1.0247870398156285,13,20,12.036163330078125,8.896355628967285,19,12
1894,64,3.1005300028096694,5.292986552692221,1.008193040963928,1.0279896864228573,28,53,13.061501502990723,8.896355628967285,36,11
1894,128,1.93941766363746,5.292941300655065,1.0001760936914375,1.028081177740999,59,116,13.930809020996094,8.896355628967285,69,12
1895,1,5.995518678171661,5.995518678171662,0.9841172657298617,0.9841172657298627,0,0,6.015002250671387,6.015002250671387,1,1
1895,2,4.807071799057559,4.807071799057559,0.9969919527669083,0.9969919527669089,0,0,6.051885604858398,6.015002250671387,2,2
1895,3,4.766965140542967,4.7669651405429665,0.9983631032668069,0.9983631032668073,0,0,6.651474952697754,6.015002250671387,3,3
1895,4,4.657776901239879,4.657776901239879,1.0003018285310248,1.000301828531026,0,0,6.743222713470459,6.015002250671387,4,4
1895,8,3.630111424083072,3.6727043961611976,1.0118671262895296,1.0115483149403592,3,3,7.127873420715332,6.015002250671387,5,5
1895,16,3.408854227057308,3.4998042749192746,1.0139427390147047,1.0147000561577622,4,6,7.6183576583862305,6.015002250671387,12,10
1895,32,2.7378878468644903,3.4091501644955953,1.0106634620608452,1.0173651365776877,12,19,8.247199058532715,6.015002250671387,20,13
1895,64,1.7847022399258998,3.3236867396553205,1.005893276684664,1.0199303833263573,30,48,8.834246635437012,6.015002250671387,34,16
1895,128,0.945646781433162,3.319132983050901,0.9989045405258928,1.020410884422009,65,109,9.516633987426758,6.015002250671387,63,19
1896,1,8.85577947296981,8.85577947296981,0.9444029541013876,0.9444029541013892,0,0,9.011011123657227,9.011011123657227,1,1
1896,2,7.775298847952013,7.775298847952013,0.9671767583190426,0.9671767583190422,0,0,9.037425994873047,9.011011123657227,2,2
1896,3,7.622876684614769,7.62287668461477,0.9716678216630636,0.9716678216630636,0,0,9.178009033203125,9.011011123657227,3,3
1896,4,7.385885314929149,7.385885314929149,0.9782633186769736,0.9782633186769731,0,0,9.18592357635498,9.011011123657227,4,4
1896,8,6.688633646921582,7.139336973579715,0.9858592092673181,0.9833548501151406,2,3,9.897687911987305,9.011011123657227,6,5
1896,16,6.315246441981323,6.976680596508065,0.9907296118711274,0.9908422158721338,6,9,10.680259704589844,9.011011123657227,10,7
1896,32,5.173222464897313,6.534949270307499,1.0041305411961026,1.0082593003990739,12,22,11.465956687927246,9.011011123657227,20,10
1896,64,3.6232995218229633,5.996795038229933,1.0101267623703378,1.022256512074478,28,48,12.053291320800781,9.011011123657227,36,16
1896,128,1.9396083566034112,5.744834071290274,0.9998522184628262,1.0311533576499128,62,115,13.066691398620605,9.011011123657227,66,13
1897,1,11.872435675906388,11.87243567590639,0.9075348058450694,0.9075348058450703,0,0,12.189554214477539,12.189554214477539,1,1
1897,2,10.549030018376813,10.549030018376813,0.9458873622070614,0.9458873622070616,0,0,12.794909477233887,12.189554214477539,2,2
1897,3,10.238259552143331,10.238259552143331,0.9527710135851526,0.9527710135851539,0,0,12.843101501464844,12.189554214477539,3,3
1897,4,10.191158005479817,10.191158005479819,0.954964703206058,0.954964703206058,0,0,13.157751083374023,12.189554214477539,4,4
1897,8,9.789334920251003,10.090057916150517,0.9639848694141753,0.9600518941129239,2,2,13.397439002990723,12.189554214477539,6,6
1897,16,8.652292167373686,9.388960442705459,0.994829979191961,0.9846182332082556,6,7,13.987229347229004,12.189554214477539,10,9
1897,32,7.062711929945926,8.95779685241969,1.0100929876248708,0.9991334492406803,12,25,14.277572631835938,12.189554214477539,20,7
1897,64,5.06092930672519,8.58690275375725,1.0143722238556396,1.0135346895894357,32,55,14.65345573425293,12.189554214477539,32,9
1897,128,2.5940317541419398,8.565207057099474,1.0020839725557116,1.0157472290116056,57,115,15.203617095947266,12.189554214477539,71,13
1898,1,7.997993519129577,7.997993519129579,0.963774241496262,0.9637742414962631,0,0,8.072952270507812,8.072952270507812,1,1
1898,2,6.0217528263808555,6.0217528263808555,0.9922370208238158,0.9922370208238156,0,0,8.29150676727295,8.072952270507812,2,2
1898,3,5.9019755410244965,5.901975541024496,0.9960094756315285,0.9960094756315285,0,0,8.840118408203125,8.072952270507812,3,3
1898,4,5.589170585304129,5.589170585304129,1.0054554602746593,1.0054554602746586,0,0,9.1149263381958,8.072952270507812,4,4
1898,8,5.289911528823257,5.303970533579374,1.0115228757234884,1.0120476701703474,2,3,9.464329719543457,8.072952270507812,6,5
1898,16,4.788907101231363,5.0267048822819245,1.017305176326207,1.018777644105919,4,9,10.451781272888184,8.072952270507812,12,7
1898,32,3.7015740864622435,4.964790072988655,1.005870366717223,1.0226926514942147,15,23,11.376794815063477,8.072952270507812,17,9
1898,64,2.884633628756239,4.673850621178755,1.0109471559965122,1.0280168252493298,32,51,12.273415565490723,8.072952270507812,32,13
1898,128,1.8093128317526592,4.576218326820117,1.0046474788070539,1.031161953795295,67,116,13.273306846618652,8.072952270507812,61,12
1899,1,7.180654879995121,7.180654879995122,0.9743645667462782,0.9743645667462835,0,0,7.221213340759277,7.221213340759277,1,1
1899,2,5.394110193860352,5.394110193860351,0.9967669831652177,0.9967669831652206,0,0,7.230707168579102,7.221213340759277,2,2
1899,3,5.337372400216095,5.337372400216095,0.9994980261718259,0.9994980261718281,0,0,8.63239574432373,7.221213340759277,3,3
1899,4,5.285539835998279,5.285539835998279,1.000600740847327,1.0006007408473292,0,0,8.998300552368164,7.221213340759277,4,4
1899,8,4.293413374781941,4.295964109782726,1.0175447310283356,1.017932920858404,2,2,10.098329544067383,7.221213340759277,6,6
1899,16,3.927847546863187,4.221400963677599,1.0170509554414837,1.021515046188846,5,8,10.779738426208496,7.221213340759277,11,8
1899,32,3.547349732590065,3.8335734987668313,1.02253450238877,1.0287223941904833,14,20,11.747310638427734,7.221213340759277,18,12
1899,64,2.8030754012816472,3.8093922009373853,1.0110455359129693,1.0309996857724624,29,49,12.665328025817871,7.221213340759277,35,15
1899,128,1.7209931293779988,3.809391765315087,1.0022069043101167,1.0310055487281102,61,113,13.650958061218262,7.221213340759277,67,15
1900,1,10.462802084993568,10.462802084993568,0.9367904086973969,0.9367904086973983,0,0,10.637144088745117,10.637144088745117,1,1
1900,2,9.67701684883032,9.67701684883032,0.9605751384158396,0.9605751384158407,0,0,11.549538612365723,10.637144088745117,2,2
1900,3,9.42352583132747,9.423525831327472,0.9680714636822105,0.9680714636822111,0,0,11.646648406982422,10.637144088745117,3,3
1900,4,8.840300521023384,8.840300521023384,0.98354978333236,0.9835497833323593,0,0,11.802664756774902,10.637144088745117,4,4
1900,8,8.550077819389921,8.721898631907735,0.9882964965653739,0.9880398839876013,3,3,12.115357398986816,10.637144088745117,5,5
1900,16,7.069514366966975,7.535943057362618,1.0190105251841794,1.0176264755862297,6,7,12.675948143005371,10.637144088745117,10,9
1900,32,6.315205161053778,7.244336059361279,1.0256305343442247,1.0253744370062645,14,21,13.152393341064453,10.637144088745117,18,11
1900,64,4.807682025191608,7.19082284344177,1.0165985583005475,1.02915777897234,27,50,13.799721717834473,10.637144088745117,37,14
1900,128,3.0056055486942603,7.118439857216326,1.0066338761383429,1.0358331160002479,59,112,14.34952163696289,10.637144088745117,69,16
1901,1,10.131362572532971,10.131362572532971,0.9443575516718284,0.9443575516718308,0,0,10.256522178649902,10.256522178649902,1,1
1901,2,9.094723101079541,9.094723101079541,0.9737182331809836,0.9737182331809857,0,0,12.205528259277344,10.256522178649902,2,2
1901,3,8.328325460763729,8.328325460763729,0.9934987827987503,0.9934987827987509,0,0,12.408730506896973,10.256522178649902,3,3
1901,4,8.29411095564213,8.294110955642132,0.9959400152995581,0.9959400152995596,0,0,12.986005783081055,10.256522178649902,4,4
1901,8,7.5961174546823855,7.608462342593884,1.0218793382821802,1.0216050329440232,1,1,13.55910873413086,10.256522178649902,7,7
1901,16,7.325835768155797,7.382677996781059,1.02846730803938,1.0300057898475252,6,6,14.598420143127441,10.256522178649902,10,10
1901,32,6.468314245419769,7.271313253684318,1.0274229333005964,1.0356280344581172,14,20,15.259620666503906,10.256522178649902,18,12
1901,64,5.152234242587306,7.187762861836044,1.016796960978429,1.0376650579624753,28,49,16.016098022460938,10.256522178649902,36,15
1901,128,3.176192583153848,7.137463985463876,1.0033397873648167,1.0427640697856448,60,111,17.1546688079834,10.256522178649902,68,17
1902,1,9.949168541854728,9.94916854185473,0.9370810378700135,0.9370810378700143,0,0,10.127029418945312,10.127029418945312,1,1
1902,2,9.557047833737492,9.55704783373749,0.9491834957657754,0.9491834957657763,0,0,11.321200370788574,10.127029418945312,2,2
1902,3,8.548921362447192,8.548921362447192,0.9786355356700334,0.9786355356700334,0,0,11.472844123840332,10.127029418945312,3,3
1902,4,8.109361867934808,8.109361867934808,0.9909468183148806,0.9909468183148806,0,0,11.718233108520508,10.127029418945312,4,4
1902,8,7.654993024069313,7.717510901219359,1.0043267949567745,1.002223852624455,1,2,11.869367599487305,10.127029418945312,7,6
1902,16,6.959501142245826,7.316113426980351,1.0216837161459411,1.0144463008728528,6,5,12.400075912475586,10.127029418945312,10,11
1902,32,5.5760685217708,6.727278356031813,1.0242730223494267,1.0280847745598267,13,19,12.712361335754395,10.127029418945312,19,13
1902,64,4.133176270263602,6.559675465690881,1.0224857693663005,1.0356697182901105,28,49,13.073074340820312,10.127029418945312,36,15
1902,128,2.7771667152217816,6.530310476642699,1.0113567146400437,1.0372177715369628,61,111,13.449446678161621,10.127029418945312,67,17
1903,1,9.985252948405414,9.985252948405417,0.9361940637526811,0.9361940637526838,0,0,10.162762641906738,10.162762641906738,1,1
1903,2,8.740232617822954,8.740232617822956,0.9683249591820936,0.9683249591820948,0,0,10.188835144042969,10.162762641906738,2,2
1903,3,7.831303619271451,7.831303619271452,0.9898066894007732,0.9898066894007744,0,0,10.386788368225098,10.162762641906738,3,3
1903,4,7.723650728489935,7.723650728489935,0.993521607786642,0.9935216077866431,0,0,10.495138168334961,10.162762641906738,4,4
1903,8,6.470515071996994,6.476647547254067,1.018732313048129,1.018166254222498,2,2,10.97940731048584,10.162762641906738,6,6
1903,16,5.867138306500779,6.114289386631427,1.0299551744211075,1.0294556298419308,4,5,11.658734321594238,10.162762641906738,12,11
1903,32,5.182171989359259,6.072091557319112,1.0262550759981302,1.0311473951549643,13,21,12.462848663330078,10.162762641906738,19,11
1903,64,3.8124051246197435,6.006084324437109,1.0168408302309735,1.0342268770114438,29,49,13.416107177734375,10.162762641906738,35,15
1903,128,2.3984521302858792,5.986319988583613,1.0050029956799502,1.035869378536743,63,111,14.277813911437988,10.162762641906738,65,17
1904,1,9.127957249681645,9.127957249681648,0.9479986431179502,0.9479986431179518,0,0,9.25886058807373,9.25886058807373,1,1
1904,2,7.2819166484203555,7.281916648420356,0.9819457459978953,0.9819457459978959,0,0,9.489324569702148,9.25886058807373,2,2
1904,3,6.309660331279926,6.309660331279926,1.0017643064098474,1.0017643064098458,0,0,9.664255142211914,9.25886058807373,3,3
1904,4,6.064301126264154,6.064301126264154,1.0052210119277083,1.0052210119277065,0,0,9.773483276367188,9.25886058807373,4,4
1904,8,5.84677486209143,5.853657887489689,1.0084774636222786,1.0085244035644525,1,1,9.955353736877441,9.25886058807373,7,7
1904,16,5.383072240222121,5.499658230066787,1.0176153141841149,1.0158668888705495,6,8,10.384163856506348,9.25886058807373,10,8
1904,32,4.906007858066694,5.385975059136793,1.0226900708927238,1.0194475962618799,10,17,10.830467224121094,9.25886058807373,22,15
1904,64,3.9538835208056575,5.079458426908632,1.0146641840889377,1.0259662466110224,27,50,11.530952453613281,9.25886058807373,37,14
1904,128,2.580510237063646,5.079021895672091,1.0047381432375417,1.0262772991480187,65,110,12.286443710327148,9.25886058807373,63,18
1905,1,9.997848281156468,9.99784828115647,0.9500520066699033,0.9500520066699061,0,0,10.105883598327637,10.105883598327637,1,1
1905,2,8.12373844125345,8.12373844125345,0.990238086557682,0.9902380865576847,0,0,10.157439231872559,10.105883598327637,2,2
1905,3,7.375124581451728,7.375124581451726,1.0077852469256456,1.0077852469256472,0,0,10.720417022705078,10.105883598327637,3,3
1905,4,7.328150163594311,7.3281501635943105,1.0090167992758938,1.0090167992758958,0,0,10.756038665771484,10.105883598327637,4,4
1905,8,6.935253773161899,6.99388129755804,1.0199009889679425,1.0197722471631916,1,1,11.278674125671387,10.105883598327637,7,7
1905,16,6.354302940527223,6.54451039571754,1.0311152375522488,1.0298519743678096,5,7,11.907319068908691,10.105883598327637,11,9
1905,32,5.528658932918795,6.459470266438065,1.038792178573154,1.0338420804265704,9,18,12.636512756347656,10.105883598327637,23,14
1905,64,4.03866085598365,6.437409313563876,1.0171318381339998,1.036287928179571,29,49,13.275927543640137,10.105883598327637,35,15
1905,128,2.7622561187571315,6.371336252391279,1.006328981172031,1.0402183406919558,54,111,14.06251335144043,10.105883598327637,74,17
1906,1,12.962985616137892,12.962985616137894,0.8812896008250788,0.8812896008250801,0,0,13.447530746459961,13.447530746459961,1,1
1906,2,11.463582620314247,11.463582620314249,0.9339439288350719,0.9339439288350725,0,0,13.530646324157715,13.447530746459961,2,2
1906,3,10.872484759338185,10.872484759338183,0.9555379754606026,0.9555379754606024,0,0,13.54393482208252,13.447530746459961,3,3
1906,4,10.47412564952238,10.474125649522382,0.962920825516705,0.9629208255167052,0,0,13.546673774719238,13.447530746459961,4,4
1906,8,9.055729793179024,9.10938862736614,0.9999449068119789,0.9994092696381719,3,3,13.842010498046875,13.447530746459961,5,5
1906,16,8.522178411319283,8.948060125141454,1.0138173052552464,1.0043787845628818,5,9,14.244305610656738,13.447530746459961,11,7
1906,32,7.612294645269871,8.144976651766038,1.0365299365806466,1.0336798706035317,11,17,14.82817554473877,13.447530746459961,21,15
1906,64,5.674666729000366,8.141790678642796,1.0059217487823986,1.0348809880490997,31,48,15.367898941040039,13.447530746459961,33,16
1906,128,4.299140546181891,8.007501232319187,1.004236117857756,1.0386678413393815,69,114,15.978852272033691,13.447530746459961,59,14
1907,1,8.31168760884636,8.311687608846363,0.9591899655922443,0.9591899655922455,0,0,8.400148391723633,8.400148391723633,1,1
1907,2,6.437571020186171,6.43757102018617,0.9941177275292252,0.9941177275292254,0,0,8.453083992004395,8.400148391723633,2,2
1907,3,6.382275066424274,6.382275066424274,0.9946309828600876,0.9946309828600872,0,0,8.66917610168457,8.400148391723633,3,3
1907,4,6.30622981967168,6.306229819671681,0.9951820027683533,0.9951820027683538,0,0,8.740072250366211,8.400148391723633,4,4
1907,8,6.179078984257199,6.273556682206377,0.9966146680988129,0.9962715220093801,2,2,9.927192687988281,8.400148391723633,6,6
1907,16,5.27921718834444,5.779826312230896,1.018429618896948,1.011463863761839,4,9,10.780545234680176,8.400148391723633,12,7
1907,32,4.809818532044545,5.513101976665689,1.0220813895123144,1.0230116327105225,15,19,11.145243644714355,8.400148391723633,17,13
1907,64,3.1416476558954365,5.472012364476417,1.005067927253104,1.0244617953786577,34,51,12.17599868774414,8.400148391723633,30,13
1907,128,2.016214598636599,5.219926320895624,1.0038606878350533,1.0314971778610256,54,114,13.200803756713867,8.400148391723633,74,14
1908,1,10.179710110781325,10.179710110781327,0.9369841267676957,0.9369841267676966,0,0,10.354775428771973,10.354775428771973,1,1
1908,2,8.797390196406704,8.797390196406704,0.9707456323167942,0.9707456323167942,0,0,10.395645141601562,10.354775428771973,2,2
1908,3,7.498894117901678,7.4988941179016795,0.9941537402518155,0.9941537402518159,0,0,10.483777046203613,10.354775428771973,3,3
1908,4,6.771859150435973,6.771859150435973,1.0090812207705748,1.009081220770576,0,0,10.540316581726074,10.354775428771973,4,4
1908,8,5.717827528002257,5.717827528002256,1.0294539174778627,1.0294539174778632,0,0,10.903213500976562,10.354775428771973,8,8
1908,16,5.480733863414253,5.588574786214669,1.0308471194598097,1.0311104125056756,4,7,11.135199546813965,10.354775428771973,12,9
1908,32,4.438099008225418,5.202533482580201,1.0368784358617607,1.0384469760263482,11,20,11.709073066711426,10.354775428771973,21,12
1908,64,3.454719238877556,5.192564990458696,1.0169085711130716,1.038978258020737,32,49,12.152844429016113,10.354775428771973,32,15
1908,128,2.1917661149219927,5.157377292552837,1.0082725713512073,1.0422358683895527,67,106,12.582054138183594,10.354775428771973,61,22
1909,1,8.162885177386315,8.162885177386318,0.9600314534257166,0.9600314534257192,0,0,8.253758430480957,8.253758430480957,1,1
1909,2,7.971241042699401,7.971241042699403,0.9681452286206579,0.9681452286206598,0,0,9.448653221130371,8.253758430480957,2,2
1909,3,7.606016784509262,7.606016784509264,0.9786395597278241,0.978639559727826,0,0,10.42082405090332,8.253758430480957,3,3
1909,4,7.217482429676657,7.217482429676659,0.9941228834876584,0.9941228834876608,0,0,10.808575630187988,8.253758430480957,4,4
1909,8,6.753972765688117,6.75399695531219,1.010353162442737,1.0103484316809084,1,1,11.329833984375,8.253758430480957,7,7
1909,16,5.776122006993983,6.2845421916439035,1.026304061440014,1.026141086384216,7,6,12.460046768188477,8.253758430480957,9,10
1909,32,4.323642809646483,6.187210252564783,1.0184846780884496,1.0305906134955816,13,20,13.325960159301758,8.253758430480957,19,12
1909,64,3.3203152806731877,6.130778828881126,1.0131506679526467,1.0337440037794818,31,50,13.916394233703613,8.253758430480957,33,14
1909,128,2.0963167560712397,6.0376778301952125,1.0049677212249848,1.038563774894391,64,112,14.710001945495605,8.253758430480957,64,16
1910,1,9.300205754860283,9.300205754860286,0.9512026691187022,0.9512026691187045,0,0,9.415316581726074,9.415316581726074,1,1
1910,2,8.21431411341575,8.214314113415746,0.974701265106656,0.9747012651066576,0,0,9.843716621398926,9.415316581726074,2,2
1910,3,7.689825839165636,7.689825839165636,0.9883271542944961,0.9883271542944975,0,0,10.694265365600586,9.415316581726074,3,3
1910,4,6.93531457232972,6.935314572329719,1.004229232075216,1.004229232075217,0,0,10.817708015441895,9.415316581726074,4,4
1910,8,6.41668409347044,6.585578712628308,1.0129046572027884,1.0113715851680154,1,1,11.155600547790527,9.415316581726074,7,7
1910,16,5.738749863952981,6.173291398772259,1.0258536088937418,1.0211587302029757,6,6,11.4772310256958,9.415316581726074,10,10
1910,32,4.975253760443211,5.739364493518866,1.0370845986185704,1.0350488463579879,12,20,12.179657936096191,9.415316581726074,20,12
1910,64,3.8803666328327573,5.632064439376507,1.020562123626159,1.0382799699209406,31,51,12.760082244873047,9.415316581726074,33,13
1910,128,2.394204227082681,5.590006093351333,1.0052080493735505,1.0422405053664645,66,109,13.29804801940918,9.415316581726074,62,19
1911,1,9.452550674796127,9.452550674796125,0.9515711349341108,0.9515711349341132,0,0,9.560683250427246,9.560683250427246,1,1
1911,2,8.125481514294595,8.125481514294593,0.9771959688296767,0.9771959688296789,0,0,10.148726463317871,9.560683250427246,2,2
1911,3,7.7360566548625345,7.7360566548625345,0.9863233884847662,0.9863233884847677,0,0,10.433551788330078,9.560683250427246,3,3
1911,4,7.250595577208604,7.250595577208604,0.9948075143432977,0.9948075143432986,0,0,10.661975860595703,9.560683250427246,4,4
1911,8,6.278978067071289,6.417075851658017,1.0148852374843897,1.0145140342191175,2,2,10.937234878540039,9.560683250427246,6,6
1911,16,5.445909623659095,6.149779153980615,1.0237661878464202,1.0238288731043343,6,7,12.083977699279785,9.560683250427246,10,9
1911,32,4.500124825543789,6.118220114163054,1.0198324198168613,1.026743705301926,15,19,12.94006633758545,9.560683250427246,17,13
1911,64,3.2562630810114945,5.699965391407509,1.0131257070222621,1.036764028677602,32,52,13.491877555847168,9.560683250427246,32,12
1911,128,2.036116143278393,5.691378502400742,1.003996150523061,1.0368921639839739,68,115,14.127070426940918,9.560683250427246,60,13
1912,1,6.066628859814778,6.066628859814778,0.9760341693294095,0.9760341693294107,0,0,6.109410762786865,6.109410762786865,1,1
1912,2,5.212242479694668,5.212242479694668,0.9915664015083341,0.9915664015083347,0,0,7.478311538696289,6.109410762786865,2,2
1912,3,4.883166397552717,4.883166397552718,0.9973997048156855,0.9973997048156862,0,0,7.588388919830322,6.109410762786865,3,3
1912,4,4.598390819989175,4.598390819989176,1.0005892487967925,1.0005892487967936,0,0,7.715116500854492,6.109410762786865,4,4
1912,8,4.15556280963533,4.215368541986703,1.0080803812646442,1.0072775507542007,2,3,8.114959716796875,6.109410762786865,6,5
1912,16,3.7214801119342935,4.055904405991388,1.011380865174815,1.011995287617391,4,6,8.951030731201172,6.109410762786865,12,10
1912,32,3.0114746023668704,3.998504345394581,1.003599355138721,1.0143695017150887,13,21,9.524717330932617,6.109410762786865,19,11
1912,64,2.309617284372666,3.833474858055183,1.0024466691205047,1.0190527602377923,32,49,10.398298263549805,6.109410762786865,32,15
1912,128,1.4103825860025367,3.8309947404114086,0.999303802498019,1.0194328149799134,60,110,11.208873748779297,6.109410762786865,68,18
1913,1,9.97098520563746,9.97098520563746,0.9424355395103657,0.9424355395103683,0,0,10.114590644836426,10.114590644836426,1,1
1913,2,8.44380786765283,8.443807867652831,0.9760034670307912,0.9760034670307913,0,0,10.536422729492188,10.114590644836426,2,2
1913,3,7.855036752789801,7.855036752789801,0.9873850939635833,0.9873850939635831,0,0,10.83299446105957,10.114590644836426,3,3
1913,4,7.741460446384125,7.741460446384124,0.992689697670597,0.9926896976705973,0,0,11.4948091506958,10.114590644836426,4,4
1913,8,7.191636664984843,7.196921555544567,1.0058087492842205,1.0061434426729718,1,1,11.567790031433105,10.114590644836426,7,7
1913,16,6.902711781496295,6.990564655400973,1.0141826379027363,1.0126922922875967,6,6,12.064661979675293,10.114590644836426,10,10
1913,32,5.980781305451821,6.6108421623894715,1.0238662548338096,1.0253265506797444,11,20,12.677227973937988,10.114590644836426,21,12
1913,64,4.4212374129580185,6.556287693264084,1.0141129523249248,1.0287807125594444,29,50,13.408676147460938,10.114590644836426,35,14
1913,128,2.6244770950640346,6.555587122090921,1.001820457930313,1.029051983688027,66,113,14.255249977111816,10.114590644836426,62,15
1914,1,7.3730349037604235,7.373034903760424,0.9684005965600266,0.9684005965600269,0,0,7.43435001373291,7.43435001373291,1,1
1914,2,6.636755532848478,6.636755532848478,0.9825648446576222,0.9825648446576223,0,0,8.127197265625,7.43435001373291,2,2
1914,3,5.47357165113626,5.473571651136261,0.9980562692245765,0.9980562692245772,0,0,8.251908302307129,7.43435001373291,3,3
1914,4,4.96337608505112,4.963376085051119,1.0069672114468846,1.0069672114468846,0,0,8.45273208618164,7.43435001373291,4,4
1914,8,4.851304114289363,4.904563326245271,1.0081311623296751,1.0079876902994418,2,2,8.646159172058105,7.43435001373291,6,6
1914,16,4.301008458186758,4.382383943870342,1.0174192721206148,1.017173468465193,5,8,8.96740436553955,7.43435001373291,11,8
1914,32,3.8568889150055545,4.306446149210801,1.0208850806607486,1.0188880970193093,13,18,9.36268138885498,7.43435001373291,19,14
1914,64,2.9689720286582784,4.195589146803159,1.0113272520982124,1.021356271964339,31,49,9.666095733642578,7.43435001373291,33,15
1914,128,1.5158267480377343,4.0502991349587605,1.0039569935250787,1.0244925383524206,58,109,10.16299057006836,7.43435001373291,70,19
1915,1,10.01525864449804,10.015258644498042,0.9474921682120723,0.9474921682120735,0,0,10.134136199951172,10.134136199951172,1,1
1915,2,8.635339466757467,8.635339466757465,0.9770499987089927,0.9770499987089939,0,0,10.549460411071777,10.134136199951172,2,2
1915,3,7.952430044742925,7.952430044742925,0.9907603635334511,0.9907603635334529,0,0,10.627429008483887,10.134136199951172,3,3
1915,4,7.848444637034887,7.848444637034887,0.9940584774072192,0.9940584774072201,0,0,11.168720245361328,10.134136199951172,4,4
1915,8,6.770020311037881,6.786280957031534,1.019060421740442,1.0181896613952637,1,1,11.572104454040527,10.134136199951172,7,7
1915,16,6.386891460763436,6.654406566509564,1.024223837792819,1.0222623735219518,5,6,12.062921524047852,10.134136199951172,11,10
1915,32,4.918995771414496,6.565694020886246,1.022840064857012,1.0248903785392307,12,21,12.796558380126953,10.134136199951172,20,11
1915,64,4.348084969527095,6.384581916979446,1.0198095665476883,1.0351328661620842,29,50,13.367293357849121,10.134136199951172,35,14
1915,128,2.4970768962827083,6.312138964733006,1.0015180761864997,1.0395406927644815,65,111,14.149201393127441,10.134136199951172,63,17
1916,1,7.936090823754831,7.936090823754833,0.9610044535816855,0.961004453581687,0,0,8.023305892944336,8.023305892944336,1,1
1916,2,6.568243921403997,6.568243921403998,0.9826674792382112,0.9826674792382131,0,0,8.05891227722168,8.023305892944336,2,2
1916,3,6.424374843637029,6.42437484363703,0.9848242912194509,0.9848242912194518,0,0,8.290327072143555,8.023305892944336,3,3
1916,4,6.414477599271587,6.414477599271587,0.9850607784145503,0.9850607784145519,0,0,8.363968849182129,8.023305892944336,4,4
1916,8,5.650602236987434,5.741729620922134,0.9954383851350737,0.9957707913776938,3,4,8.793956756591797,8.023305892944336,5,4
1916,16,5.441342937940824,5.733833553976171,0.9973075467737058,0.9962817828678752,8,10,9.087712287902832,8.023305892944336,8,6
1916,32,4.713128285899128,5.490915541981916,1.005480253585609,1.0062367709177469,16,21,9.720309257507324,8.023305892944336,16,11
1916,64,2.865066446013424,5.057612433739596,1.0083967100898894,1.0175605716053446,31,54,10.30520248413086,8.023305892944336,33,10
1916,128,1.5460675878673824,5.001540225646797,0.9994034135178478,1.0208446186890885,64,113,10.861085891723633,8.023305892944336,64,15
1917,1,12.781291252864472,12.781291252864477,0.9024006946661918,0.9024006946661938,0,0,13.104150772094727,13.104150772094727,1,1
1917,2,11.25527008850392,11.25527008850392,0.9455835794503821,0.9455835794503824,0,0,13.34570598602295,13.104150772094727,2,2
1917,3,10.482612249195768,10.48261224919577,0.967646123740278,0.9676461237402763,0,0,13.400290489196777,13.104150772094727,3,3
1917,4,10.464666643952325,10.464666643952325,0.9681490068119762,0.968149006811975,0,0,13.602511405944824,13.104150772094727,4,4
1917,8,9.358365910321277,9.384913751607368,1.0054714226703911,1.0044670912342437,2,2,14.05311107635498,13.104150772094727,6,6
1917,16,8.128528848606207,8.398437345608723,1.0437828489476866,1.0359206421377423,5,5,14.536296844482422,13.104150772094727,11,11
1917,32,7.243753872396528,7.857038665168464,1.062718267645029,1.0541816446826124,11,15,15.08664321899414,13.104150772094727,21,17
1917,64,6.075954028306858,7.443931041839099,1.0502004315653077,1.068952437847658,28,44,15.704547882080078,13.104150772094727,36,20
1917,128,3.499843609018045,7.436812627863069,1.0132492649577374,1.0702307504189545,60,105,16.228511810302734,13.104150772094727,68,23
1918,1,10.498030397337036,10.498030397337036,0.9373878682082684,0.9373878682082706,0,0,10.660136222839355,10.660136222839355,1,1
1918,2,7.950853338267958,7.950853338267958,0.9915561191579003,0.9915561191579014,0,0,10.738408088684082,10.660136222839355,2,2
1918,3,7.832130663022576,7.832130663022576,0.9953632409120571,0.9953632409120576,0,0,10.867879867553711,10.660136222839355,3,3
1918,4,7.714228354175012,7.714228354175012,0.9973506409352739,0.997350640935274,0,0,11.075417518615723,10.660136222839355,4,4
1918,8,6.914977216561157,6.921857076418671,1.016115172904667,1.0161238503909082,1,2,11.658175468444824,10.660136222839355,7,6
1918,16,6.23240903754898,6.39242117007815,1.0323683854597387,1.0307404775428632,5,5,12.60323715209961,10.660136222839355,11,11
1918,32,5.340612228922059,6.350310905990769,1.028389359070751,1.0338977376775085,15,20,13.2910737991333,10.660136222839355,17,12
1918,64,4.235534213976319,6.156618322098288,1.0133939171489583,1.044156396747712,32,51,13.797285079956055,10.660136222839355,32,13
1918,128,2.665403061457833,6.156618322098287,1.0031347978724572,1.044156396747712,69,115,14.606688499450684,10.660136222839355,59,13
1919,1,9.015897454501076,9.015897454501077,0.9470209497281709,0.9470209497281725,0,0,9.15689754486084,9.15689754486084,1,1
1919,2,8.092675677718839,8.092675677718837,0.971287032755182,0.9712870327551828,0,0,9.313758850097656,9.15689754486084,2,2
1919,3,6.435011779344788,6.435011779344789,0.9965451042163386,0.9965451042163381,0,0,9.385533332824707,9.15689754486084,3,3
1919,4,6.201569693670995,6.201569693670995,1.0001359212673964,1.0001359212673973,0,0,9.629735946655273,9.15689754486084,4,4
1919,8,5.831215950148069,5.831215950148069,1.0124069086547276,1.012406908654727,0,0,10.281423568725586,9.15689754486084,8,8
1919,16,5.413497597586148,5.482682174850201,1.0216047149633316,1.021351589600482,4,3,11.227564811706543,9.15689754486084,12,13
1919,32,4.825269765910624,5.148747880518295,1.0280263338727704,1.03154948512685,12,17,11.83678150177002,9.15689754486084,20,15
1919,64,3.5905353088625014,4.946341324756925,1.0195511146582679,1.0393875771932988,30,45,12.394474983215332,9.15689754486084,34,19
1919,128,2.1718252016213206,4.804794948980087,1.0053584880678386,1.0464989622038394,64,108,13.226694107055664,9.15689754486084,64,20
1920,1,5.6875881983988625,5.687588198398863,0.9787528823224887,0.9787528823224896,0,0,5.723844051361084,5.723844051361084,1,1
1920,2,5.173907171883096,5.173907171883097,0.9871076520421679,0.9871076520421681,0,0,5.841355323791504,5.723844051361084,2,2
1920,3,4.970075624455566,4.970075624455565,0.9894309712914868,0.9894309712914868,0,0,6.298899173736572,5.723844051361084,3,3
1920,4,4.625119969048347,4.625119969048347,0.9948201702664333,0.9948201702664341,0,0,6.53459358215332,5.723844051361084,4,4
1920,8,3.872346003665755,3.8857698534708986,1.002135130794719,1.0024166717229686,2,2,7.000365257263184,5.723844051361084,6,6
1920,16,3.5900637206517216,3.706825610871305,1.0052384754794053,1.0060012099226219,6,8,7.650661945343018,5.723844051361084,10,8
1920,32,2.9635234894194222,3.569076409739837,1.005841261475421,1.00923701072846,15,19,8.175737380981445,5.723844051361084,17,13
1920,64,2.0581568347416406,3.5409129228848024,1.004916208392433,1.010822931750102,24,49,8.703857421875,5.723844051361084,40,15
1920,128,0.9515078545581974,3.4928922045301696,0.9988672302735063,1.0118859018968474,57,113,9.523324966430664,5.723844051361084,71,15
1921,1,8.623391711456637,8.623391711456629,0.960279083416377,0.9602790834163794,0,0,8.70654296875,8.70654296875,1,1
1921,2,7.146917882876536,7.146917882876536,0.9900404067038566,0.990040406703857,0,0,9.41481876373291,8.70654296875,2,2
1921,3,7.08472681860606,7.08472681860606,0.9917770063001963,0.9917770063001964,0,0,9.647323608398438,8.70654296875,3,3
1921,4,6.403791260843941,6.403791260843942,1.0067489470855047,1.0067489470855049,0,0,10.295080184936523,8.70654296875,4,4
1921,8,6.0168008571147364,6.2514908380954095,1.011801931423715,1.0133659163599233,2,2,10.997730255126953,8.70654296875,6,6
1921,16,5.2976970694016625,5.86934493405811,1.0175140354191095,1.0240878165703038,5,9,12.718223571777344,8.70654296875,11,7
1921,32,4.857772373690069,5.602526156357938,1.0219028909724905,1.038781042812093,14,19,13.664603233337402,8.70654296875,18,13
1921,64,4.013538816742693,5.451534053051038,1.0177309363160008,1.0441585685710906,29,54,14.714133262634277,8.70654296875,35,10
1921,128,2.7687013051962817,5.40984422169948,1.0055130360299183,1.0465924734830234,58,117,15.738911628723145,8.70654296875,70,11
1922,1,12.083724231905318,12.08372423190532,0.9013432389006167,0.9013432389006178,0,0,12.442041397094727,12.442041397094727,1,1
1922,2,11.46782246172545,11.46782246172545,0.9247568681370217,0.9247568681370226,0,0,13.614715576171875,12.442041397094727,2,2
1922,3,10.467090550965438,10.46709055096543,0.9598175158529998,0.9598175158530006,0,0,13.758037567138672,12.442041397094727,3,3
1922,4,10.460732959975896,10.460732959975896,0.9606443211148549,0.9606443211148553,0,0,14.226593971252441,12.442041397094727,4,4
1922,8,9.748750275432993,9.876315978769897,0.9834817556810833,0.9824711215404861,3,4,14.604083061218262,12.442041397094727,5,4
1922,16,8.909777328588463,9.385267651672105,1.005837814670595,1.0032861246954,5,11,14.880531311035156,12.442041397094727,11,5
1922,32,8.206963903171482,9.376687621665642,1.00971771572391,1.0042126482337503,13,26,15.14697551727295,12.442041397094727,19,6
1922,64,6.182380583769097,8.713927445244709,1.0083336169569546,1.0260970577647783,32,53,15.641792297363281,12.442041397094727,32,11
1922,128,4.202175365718658,8.484877791121818,1.0028247507502033,1.037068638123206,63,116,16.093782424926758,12.442041397094727,65,12
1923,1,8.135726862206395,8.135726862206395,0.9593328154160157,0.9593328154160181,0,0,8.227282524108887,8.227282524108887,1,1
1923,2,6.709249658437009,6.70924965843701,0.9839397663575948,0.9839397663575967,0,0,8.534380912780762,8.227282524108887,2,2
1923,3,6.277399306663314,6.277399306663314,0.9911299684350444,0.991129968435045,0,0,8.772623062133789,8.227282524108887,3,3
1923,4,5.901755279137683,5.901755279137682,0.9974964041513293,0.9974964041513298,0,0,8.78446102142334,8.227282524108887,4,4
1923,8,5.398090333208655,5.398444476511333,1.0065823761231847,1.0066047705823937,1,1,9.261489868164062,8.227282524108887,7,7
1923,16,4.813501871317253,5.020386533829726,1.0139828858914153,1.0146723596019482,4,8,9.70029067993164,8.227282524108887,12,8
1923,32,3.795161456797371,4.77860377795031,1.015701591323983,1.0216502469733113,10,21,10.153921127319336,8.227282524108887,22,11
1923,64,2.752847857800143,4.70324101810782,1.0101465750406817,1.024252228234493,32,47,10.642463684082031,8.227282524108887,32,17
1923,128,1.386272115678071,4.684982531495767,1.0004278154027517,1.0258929524309537,64,108,11.407825469970703,8.227282524108887,64,20
1924,1,9.361497128470452,9.361497128470456,0.9395022290032216,0.9395022290032229,0,0,9.53805160522461,9.53805160522461,1,1
1924,2,8.249275031282751,8.249275031282753,0.9649453069169303,0.9649453069169314,0,0,9.6967191696167,9.53805160522461,2,2
1924,3,7.484019853098559,7.4840198530985615,0.980494804396327,0.9804948043963269,0,0,9.752092361450195,9.53805160522461,3,3
1924,4,7.40321410807973,7.4840198530985615,0.9820786571807574,0.9804948043963269,1,1,9.754532814025879,9.53805160522461,3,3
1924,8,6.452535748484681,6.668060843509516,0.999947020678981,0.9959305509732304,4,4,10.391922950744629,9.53805160522461,4,4
1924,16,5.618278400958098,6.646911998493104,1.0056520978596175,0.9978471834726992,9,9,10.759798049926758,9.53805160522461,7,7
1924,32,5.3059561399064865,6.574837923422978,1.0060656233632879,1.0008784248684708,15,23,11.047428131103516,9.53805160522461,17,9
1924,64,3.960209260336917,6.202030290364915,1.0057403478752243,1.0140790852789814,27,53,11.539261817932129,9.53805160522461,37,11
1924,128,2.2249497677226433,5.74546332432255,1.0050697550450995,1.026587374775722,58,114,12.005175590515137,9.53805160522461,70,14
1925,1,7.111491677886518,7.111491677886519,0.9682483691182111,0.9682483691182123,0,0,7.177192687988281,7.177192687988281,1,1
1925,2,5.235908587536863,5.235908587536863,0.9998535528998831,0.9998535528998832,0,0,7.201476097106934,7.177192687988281,2,2
1925,3,4.9839713448765,4.9839713448765,1.003345862974749,1.0033458629747491,0,0,7.469252586364746,7.177192687988281,3,3
1925,4,4.946486667635363,4.946486667635363,1.0043836034793485,1.0043836034793487,0,0,7.943551540374756,7.177192687988281,4,4
1925,8,4.274501380779537,4.548891817925105,1.0105033967475658,1.010598775937793,1,1,8.376239776611328,7.177192687988281,7,7
1925,16,3.8579426241376797,4.179387110308219,1.016398907763263,1.0195271904680838,6,6,9.295097351074219,7.177192687988281,10,10
1925,32,3.0920452169692427,4.053622365735253,1.0131545832469333,1.0248768038069254,16,16,9.900834083557129,7.177192687988281,16,16
1925,64,2.2633250125383335,3.9508109811662595,1.0055331796213332,1.0278359863192368,30,46,10.851203918457031,7.177192687988281,34,18
1925,128,1.4527819709266034,3.9078338536459887,0.9999732896990816,1.030511093405295,62,108,11.708260536193848,7.177192687988281,66,20
1926,1,11.05596227949451,11.055962279494508,0.9296257837141921,0.9296257837141939,0,0,11.25822925567627,11.25822925567627,1,1
1926,2,8.218600389934409,8.218600389934409,0.9945535119125083,0.9945535119125086,0,0,11.32296371459961,11.25822925567627,2,2
1926,3,7.688818020978107,7.688818020978107,1.0023607477073821,1.0023607477073835,0,0,11.423354148864746,11.25822925567627,3,3
1926,4,7.5532307985952105,7.55323079859521,1.006020698252339,1.0060206982523403,0,0,11.586812973022461,11.25822925567627,4,4
1926,8,7.335302552498698,7.337666895084937,1.0139477806763024,1.0140470714016616,1,1,11.99171257019043,11.25822925567627,7,7
1926,16,6.6652220014625465,6.832342694676723,1.0257498052318885,1.0228373389132188,5,7,12.264382362365723,11.25822925567627,11,9
1926,32,5.944924486934278,6.613973355585689,1.0333495819145817,1.028454366280699,12,21,12.738389015197754,11.25822925567627,20,11
1926,64,5.077164113151502,6.529679007078206,1.0348928457305044,1.0332165563350058,24,46,13.071297645568848,11.25822925567627,40,18
1926,128,3.1117939850272887,6.320706215246851,1.0120609878680147,1.0394996415417652,60,111,13.564483642578125,11.25822925567627,68,17
1927,1,4.325843001621527,4.325843001621527,0.991540257709224,0.9915402577092247,0,0,4.333782196044922,4.333782196044922,1,1
1927,2,3.108511690007715,3.108511690007715,0.9967587913601657,0.9967587913601655,0,0,4.434686183929443,4.333782196044922,2,2
1927,3,3.101688893744717,3.108511690007715,0.9964315271792588,0.9967587913601655,1,1,4.665764808654785,4.333782196044922,2,2
1927,4,3.0940587519430887,3.108511690007715,0.9963871493657674,0.9967587913601655,2,2,4.7214741706848145,4.333782196044922,2,2
1927,8,2.921490268204598,2.939239563848001,0.9998430399047423,1.000386284086928,3,4,5.0375165939331055,4.333782196044922,5,4
1927,16,2.5351021261397935,2.939239563848001,1.0017970895673058,1.000386284086928,5,12,5.169460296630859,4.333782196044922,11,4
1927,32,2.1029229154317752,2.9028542689014274,1.000422400207415,1.0011918957559258,13,25,5.558588981628418,4.333782196044922,19,7
1927,64,1.4901280912298764,2.8152083208619634,0.9983374801185583,1.0033602575523448,34,56,5.90052604675293,4.333782196044922,30,8
1927,128,0.9116561798156333,2.7923629785947575,0.998246934074114,1.0042466682000395,63,120,6.427152633666992,4.333782196044922,65,8
1928,1,12.591727944771431,12.591727944771423,0.9115269771627367,0.9115269771627382,0,0,12.861502647399902,12.861502647399902,1,1
1928,2,10.443757751843307,10.443757751843306,0.9786584035899144,0.9786584035899142,0,0,13.569910049438477,12.861502647399902,2,2
1928,3,9.89963279675828,9.89963279675828,0.9934175674100181,0.9934175674100172,0,0,13.635059356689453,12.861502647399902,3,3
1928,4,8.960675277078671,8.96067527707867,1.018551177319266,1.018551177319265,0,0,13.769025802612305,12.861502647399902,4,4
1928,8,8.714041623910859,8.785439456570298,1.025798266134592,1.0248847216865231,2,2,14.191744804382324,12.861502647399902,6,6
1928,16,8.021435262400871,8.456310143473335,1.0422374535044547,1.0361532158104565,5,7,14.59454345703125,12.861502647399902,11,9
1928,32,7.094645134739963,7.823060190602657,1.0568015095055845,1.0590419887376883,13,18,15.290193557739258,12.861502647399902,19,14
1928,64,5.410186940505814,7.657259022613118,1.0330858207331421,1.0661631833049197,31,47,15.869528770446777,12.861502647399902,33,17
1928,128,2.8012071680806585,7.3306665134062206,1.0082174793458836,1.0817695578429198,60,112,16.495155334472656,12.861502647399902,68,16
1929,1,9.742508268776428,9.742508268776426,0.9464832153381171,0.9464832153381175,0,0,9.874650001525879,9.874650001525879,1,1
1929,2,8.14158879162215,8.14158879162215,0.9802546772587233,0.9802546772587227,0,0,10.052875518798828,9.874650001525879,2,2
1929,3,7.840696012571183,7.840696012571182,0.9858302728144861,0.9858302728144851,0,0,10.141097068786621,9.874650001525879,3,3
1929,4,7.6132996467060225,7.6132996467060225,0.9898323512743524,0.9898323512743523,0,0,10.28215217590332,9.874650001525879,4,4
1929,8,6.083286957525306,6.128353799206992,1.0158346920339216,1.01517467138524,2,2,10.76107120513916,9.874650001525879,6,6
1929,16,5.37965616568678,5.761111376526853,1.0274237830084991,1.0244935833721718,5,8,11.34643840789795,9.874650001525879,11,8
1929,32,4.736810818448835,5.702148734334101,1.0265868664673952,1.0267883581816,15,21,11.920981407165527,9.874650001525879,17,11
1929,64,3.8755418292835353,5.285552862978901,1.020058663201215,1.0391299487098782,33,49,12.514391899108887,9.874650001525879,31,15
1929,128,2.406424566812905,5.264578108966085,1.00663097441422,1.0414229416587915,65,109,13.128582000732422,9.874650001525879,63,19
1930,1,10.18125116536558,10.181251165365582,0.925790770625457,0.9257907706254576,0,0,10.42916488647461,10.42916488647461,1,1
1930,2,8.883709720402743,8.883709720402743,0.9654984995357965,0.9654984995357965,0,0,11.336856842041016,10.42916488647461,2,2
1930,3,7.8174537549936165,7.817453754993617,0.9911060458826846,0.9911060458826848,0,0,11.376850128173828,10.42916488647461,3,3
1930,4,7.717020851359492,7.717020851359492,0.9946337911731177,0.994633791173118,0,0,11.436922073364258,10.42916488647461,4,4
1930,8,7.287783188289863,7.287783188289864,1.0050724489946017,1.0050724489946004,0,0,11.626405715942383,10.42916488647461,8,8
1930,16,6.944917744860781,7.0986439194586355,1.013137563982458,1.0127655924307528,4,6,12.45351505279541,10.42916488647461,12,10
1930,32,5.906317787354699,6.573356989044582,1.024036320799634,1.0305390739902345,13,17,12.903510093688965,10.42916488647461,19,15
1930,64,4.250291491824549,6.2887707169619365,1.0241493673055482,1.0426389081646308,33,43,13.400609970092773,10.42916488647461,31,21
1930,128,2.5651963597590624,6.016917667880306,1.0079387717297945,1.0510835897380102,59,107,13.99360179901123,10.42916488647461,69,21
1931,1,11.806584613904539,11.806584613904544,0.8977366072546551,0.8977366072546583,0,0,12.181536674499512,12.181536674499512,1,1
1931,2,11.476050492086438,11.47605049208644,0.9110472834644399,0.9110472834644425,0,0,13.362652778625488,12.181536674499512,2,2
1931,3,11.416500690016674,11.416500690016674,0.9157780579796646,0.9157780579796657,0,0,13.956891059875488,12.181536674499512,3,3
1931,4,11.405722033276177,11.40572203327618,0.916616037582792,0.916616037582794,0,0,13.974352836608887,12.181536674499512,4,4
1931,8,10.54471662820463,10.622718432855157,0.9551348818076021,0.9523611027474996,2,2,14.163931846618652,12.181536674499512,6,6
1931,16,10.074361973811598,10.618613512281827,0.9589461046741767,0.9530457691891605,6,8,14.616661071777344,12.181536674499512,10,8
1931,32,7.754278149298134,9.107734501256012,1.0233395263463283,1.0130023320237165,12,25,15.031024932861328,12.181536674499512,20,7
1931,64,6.048081096671163,8.483604369709909,1.0240764624437046,1.0328462449137654,33,55,15.514054298400879,12.181536674499512,31,9
1931,128,4.173177255399548,7.8902241937907,1.0162062209614984,1.0530924286387662,63,114,16.210779190063477,12.181536674499512,65,14
1932,1,10.858423993515563,10.858423993515562,0.9131189296523844,0.913118929652387,0,0,11.170197486877441,11.170197486877441,1,1
1932,2,10.679293148468789,10.679293148468773,0.9182210753722109,0.9182210753722129,0,0,11.6873140335083,11.170197486877441,2,2
1932,3,10.06729891858077,10.067298918580752,0.9372978286796906,0.937297828679692,0,0,11.855025291442871,11.170197486877441,3,3
1932,4,10.06650551698393,10.067298918580752,0.9371800294472181,0.937297828679692,1,1,12.049429893493652,11.170197486877441,3,3
1932,8,8.125825016191152,8.127585381994948,0.9878034430651138,0.9878001879551361,1,1,12.331755638122559,11.170197486877441,7,7
1932,16,7.695869633024814,8.045564563504533,0.9946510220130441,0.9914813924886643,6,7,12.527922630310059,11.170197486877441,10,9
1932,32,7.10455435711894,7.890756380766784,0.9982876769155212,0.9961245934585891,17,23,13.010342597961426,11.170197486877441,15,9
1932,64,5.164940556332658,7.2528716053185205,1.01985967560691,1.023074792375874,30,53,13.629963874816895,11.170197486877441,34,11
1932,128,3.67712826963859,7.187948570695804,1.0169387820920943,1.027603883361132,61,115,14.265697479248047,11.170197486877441,67,13
1933,1,9.578779263784742,9.578779263784744,0.9530230479896975,0.9530230479896991,0,0,9.679808616638184,9.679808616638184,1,1
1933,2,8.30344832624232,8.30344832624232,0.9741767683869805,0.9741767683869811,0,0,9.680102348327637,9.679808616638184,2,2
1933,3,7.947527521806514,7.9475275218065145,0.9805737712638216,0.9805737712638214,0,0,9.922164916992188,9.679808616638184,3,3
1933,4,7.629420454600209,7.62942045460021,0.9865255895397522,0.9865255895397519,0,0,9.929451942443848,9.679808616638184,4,4
1933,8,6.2283738753638005,6.235311262223736,1.017406229759142,1.0176563418065088,1,1,10.608068466186523,9.679808616638184,7,7
1933,16,5.407917268002134,5.597642779452468,1.0272762172469034,1.028004629671396,6,5,10.94074821472168,9.679808616638184,10,11
1933,32,4.835877180645378,5.373737453804259,1.0268914356341559,1.0343317507958423,12,19,11.48568058013916,9.679808616638184,20,13
1933,64,3.899383851247595,5.248234948255097,1.0210047439202525,1.0366105581480594,32,48,12.086633682250977,9.679808616638184,32,16
1933,128,2.1784083459786827,5.226957699849695,1.0036546122760794,1.038563579449316,61,107,12.717040061950684,9.679808616638184,67,21
1934,1,8.040603564658793,8.040603564658793,0.9627441814167363,0.9627441814167383,0,0,8.119532585144043,8.119532585144043,1,1
1934,2,7.29665190659635,7.296651906596351,0.9802977617828463,0.9802977617828474,0,0,8.553313255310059,8.119532585144043,2,2
1934,3,6.820736703753359,6.820736703753359,0.9896639984367452,0.9896639984367458,0,0,8.81827449798584,8.119532585144043,3,3
1934,4,6.778419406026026,6.778419406026026,0.9917466698769021,0.9917466698769033,0,0,9.163352966308594,8.119532585144043,4,4
1934,8,6.482024049036874,6.4837392693145,0.999271159102434,0.9996106519186481,1,1,9.832505226135254,8.119532585144043,7,7
1934,16,4.976405383628397,5.581304438787311,1.0132996502317368,1.0158319696135694,4,8,9.938956260681152,8.119532585144043,12,8
1934,32,4.247471110865766,5.443959087725049,1.0119362799872291,1.018969401733984,16,20,10.613889694213867,8.119532585144043,16,12
1934,64,3.274171159053729,5.285309806285522,1.007029105197836,1.0211131949880887,30,52,10.992692947387695,8.119532585144043,34,12
1934,128,1.5892124280112159,5.247685979886012,1.0001889177514443,1.0235937262111237,57,114,11.453195571899414,8.119532585144043,71,14
1935,1,7.416676588159518,7.416676588159519,0.9674528385428098,0.9674528385428106,0,0,7.482022762298584,7.482022762298584,1,1
1935,2,6.244622946712798,6.244622946712798,0.9863167387278745,0.9863167387278752,0,0,7.752386093139648,7.482022762298584,2,2
1935,3,6.148123346018478,6.148123346018477,0.9899383462117597,0.9899383462117605,0,0,7.827539920806885,7.482022762298584,3,3
1935,4,5.8197243682847315,5.8197243682847315,0.9979486842202738,0.997948684220275,0,0,8.494551658630371,7.482022762298584,4,4
1935,8,5.472435158650728,5.591345002207965,1.0010346056448993,1.0021903268208663,2,2,9.036725997924805,7.482022762298584,6,6
1935,16,4.560988469213473,5.2251549111306455,1.0096755844394718,1.0097996012054316,5,9,9.320663452148438,7.482022762298584,11,7
1935,32,3.8856214435316367,5.042438751208134,1.0077591227392175,1.0146275022081996,12,19,9.949150085449219,7.482022762298584,20,13
1935,64,3.2573313335008525,5.008850949444048,1.0052484037621072,1.018129371489823,31,47,10.63296127319336,7.482022762298584,33,17
1935,128,2.043310859532005,4.833020320751472,1.003276676137629,1.0252227955804412,61,109,11.513534545898438,7.482022762298584,67,19
1936,1,10.113156793270322,10.113156793270324,0.9363727991266397,0.9363727991266404,0,0,10.293158531188965,10.293158531188965,1,1
1936,2,7.816841878903394,7.816841878903393,0.9827342717101235,0.9827342717101231,0,0,10.296784400939941,10.293158531188965,2,2
1936,3,7.473845673866958,7.473845673866958,0.9897800286887051,0.9897800286887033,0,0,10.442712783813477,10.293158531188965,3,3
1936,4,7.421727684978986,7.421727684978985,0.9909887581045342,0.9909887581045334,0,0,10.739629745483398,10.293158531188965,4,4
1936,8,7.058003557724778,7.060133720045284,0.9993651138500256,0.9995159251475877,1,1,11.543622016906738,10.293158531188965,7,7
1936,16,6.3564014435819285,6.850825203918858,1.011782125646356,1.0104606300303525,5,5,12.092289924621582,10.293158531188965,11,11
1936,32,5.255365935535238,6.647625605011237,1.014404009707163,1.0188355987805027,14,22,12.734519004821777,10.293158531188965,18,10
1936,64,3.757878868496791,6.467486238096421,1.0057081218243848,1.0287366212865425,32,52,13.480965614318848,10.293158531188965,32,12
1936,128,2.0538581129851576,6.44734268979169,1.0030672794212725,1.0318271565710304,63,114,14.305336952209473,10.293158531188965,65,14
1937,1,8.45137737649546,8.45137737649546,0.9622655806029643,0.9622655806029647,0,0,8.528297424316406,8.528297424316406,1,1
1937,2,6.788773609078977,6.788773609078977,0.9929804043614401,0.9929804043614396,0,0,8.924915313720703,8.528297424316406,2,2
1937,3,6.7287799291373265,6.728779929137359,0.9938489546398452,0.9938489546398445,0,0,9.354992866516113,8.528297424316406,3,3
1937,4,6.112168629404242,6.112168629404241,1.0049636806943332,1.0049636806943334,0,0,9.482839584350586,8.528297424316406,4,4
1937,8,5.785256774069818,5.78586923906404,1.0115600720622757,1.0115449905912213,1,1,9.977261543273926,8.528297424316406,7,7
1937,16,5.505126042289908,5.782368238577005,1.009160771766036,1.0116480958732375,6,7,10.414986610412598,8.528297424316406,10,9
1937,32,4.654889903589621,5.62867450766461,1.0065203853854277,1.0165967778050196,17,21,10.780529975891113,8.528297424316406,15,11
1937,64,3.2828746071720976,5.568739494723857,1.0090460492378992,1.0196476539640085,29,48,11.222207069396973,8.528297424316406,35,16
1937,128,2.107112127914416,5.532882125297866,1.0038918842190105,1.021237125874514,60,112,11.866995811462402,8.528297424316406,68,16
1938,1,7.741168431651428,7.741168431651427,0.9697055737082791,0.9697055737082821,0,0,7.793299674987793,7.793299674987793,1,1
1938,2,7.043791301159301,7.043791301159301,0.9813527349842435,0.9813527349842456,0,0,7.89557409286499,7.793299674987793,2,2
1938,3,6.009634602917847,6.009634602917847,0.9961252566897971,0.9961252566897976,0,0,8.362282752990723,7.793299674987793,3,3
1938,4,6.005989597422689,6.009634602917847,0.9957735015211747,0.9961252566897976,1,1,8.917202949523926,7.793299674987793,3,3
1938,8,5.329654285347055,5.334145256123216,1.0104147995194739,1.010932116152173,1,1,10.027420997619629,7.793299674987793,7,7
1938,16,4.922961847179324,5.218250627963666,1.0131199292347743,1.01614258460257,5,7,10.65226936340332,7.793299674987793,11,9
1938,32,4.004711462768767,5.0069321939693445,1.0183484542886494,1.027539610828705,13,19,11.117242813110352,7.793299674987793,19,13
1938,64,3.2417313485261263,4.88690099024759,1.0142357670104818,1.0319696777383007,32,46,11.847326278686523,7.793299674987793,32,18
1938,128,1.8013106111807982,4.8679717090220915,1.002405386006425,1.0341441674564704,64,105,12.786203384399414,7.793299674987793,64,23
1939,1,11.553188328002832,11.553188328002838,0.908922292713717,0.9089222927137209,0,0,11.862957000732422,11.862957000732422,1,1
1939,2,10.339693115533246,10.339693115533247,0.9464925695819109,0.9464925695819137,0,0,12.523099899291992,11.862957000732422,2,2
1939,3,9.40621379513343,9.406213795133434,0.9733322444980397,0.9733322444980426,0,0,13.048604965209961,11.862957000732422,3,3
1939,4,9.36451537397778,9.36451537397778,0.977873141476097,0.9778731414760993,0,0,13.970743179321289,11.862957000732422,4,4
1939,8,8.417025310365828,8.6787397883923,1.0013898478857168,1.0056510138073036,1,1,14.663637161254883,11.862957000732422,7,7
1939,16,7.635702465810259,8.588790423467561,1.0140913038790644,1.0114362336544898,7,8,15.605870246887207,11.862957000732422,9,8
1939,32,6.611985248479394,8.545188336799436,1.0107697562657494,1.0174969411168593,13,23,16.362686157226562,11.862957000732422,19,9
1939,64,5.234813317421728,8.327203314849205,1.004934151656303,1.0302099851872193,30,55,17.14647674560547,11.862957000732422,34,9
1939,128,3.851281033970469,8.299190662159278,0.9887206451899091,1.034920945309087,66,116,17.983718872070312,11.862957000732422,62,12
1940,1,3.4640798807552473,3.4640798807552473,0.9922057503363313,0.9922057503363312,0,0,3.4724056720733643,3.4724056720733643,1,1
1940,2,2.8050213586143866,2.8050213586143866,0.9973128667703102,0.9973128667703097,0,0,3.625913381576538,3.4724056720733643,2,2
1940,3,2.6871811058896333,2.6871811058896338,0.997695308393916,0.9976953083939168,0,0,3.6532273292541504,3.4724056720733643,3,3
1940,4,2.6147883067801776,2.6871811058896338,0.9974176290535152,0.9976953083939168,1,1,3.828166961669922,3.4724056720733643,3,3
1940,8,2.2393183646723047,2.271340787123587,1.0024435233735896,1.0024843615588424,1,3,4.16344690322876,3.4724056720733643,7,5
1940,16,1.825508222840763,2.174382676976146,1.0036487995508927,1.0035446303857691,6,9,4.543746471405029,3.4724056720733643,10,7
1940,32,1.5064759336252307,2.062945913957468,1.0029232164419684,1.0054899211646267,13,23,5.018801689147949,3.4724056720733643,19,9
1940,64,0.9898944929528202,2.062945913957468,1.0010409557460767,1.0054899211646267,33,55,5.470627307891846,3.4724056720733643,31,9
1940,128,0.29984714329690976,1.968780062876269,0.9998088140677421,1.0069457030865738,63,116,6.050331115722656,3.4724056720733643,65,12
1941,1,9.319953359877395,9.319953359877395,0.9401598900303265,0.9401598900303281,0,0,9.48925495147705,9.48925495147705,1,1
1941,2,7.811043740625072,7.811043740625073,0.9723859323863498,0.9723859323863502,0,0,9.634629249572754,9.48925495147705,2,2
1941,3,7.3378584436031185,7.3378584436031185,0.9815542033153319,0.9815542033153322,0,0,9.748320579528809,9.48925495147705,3,3
1941,4,7.039097129515123,7.039097129515123,0.989608068550308,0.9896080685503076,0,0,10.279976844787598,9.48925495147705,4,4
1941,8,6.636896019132091,6.642486979585317,1.00202425079196,1.0022308277756231,2,2,11.02578353881836,9.48925495147705,6,6
1941,16,5.827734447493296,6.015141496723229,1.0200960095635523,1.019965760762517,6,9,11.475040435791016,9.48925495147705,10,7
1941,32,5.2491056826162925,6.014720546895688,1.0133187687438763,1.0201166513457582,16,24,12.127853393554688,9.48925495147705,16,8
1941,64,4.260744552795382,5.931782760039443,1.0115703110120555,1.0262283108500507,30,51,12.887040138244629,9.48925495147705,34,13
1941,128,2.689079260471198,5.705715122609706,1.0020055939681929,1.035583010818296,61,117,13.543793678283691,9.48925495147705,67,11
1942,1,8.822168740844454,8.822168740844456,0.956821365977431,0.956821365977432,0,0,8.915940284729004,8.915940284729004,1,1
1942,2,7.428061897360374,7.428061897360372,0.9912548423663443,0.9912548423663448,0,0,9.752659797668457,8.915940284729004,2,2
1942,3,6.834514827569406,6.834514827569406,0.9993399818720929,0.9993399818720934,0,0,9.85742473602295,8.915940284729004,3,3
1942,4,6.762946082958232,6.762946082958232,0.9998763567924648,0.9998763567924652,0,0,9.857534408569336,8.915940284729004,4,4
1942,8,6.337699325614011,6.401494202395374,1.008714976080467,1.0091744183787514,2,1,10.546186447143555,8.915940284729004,6,7
1942,16,5.539151178806112,5.872083132857694,1.0166383471871379,1.0214949196388756,4,5,11.086400985717773,8.915940284729004,12,11
1942,32,4.808849825359487,5.6582453284942265,1.0158595353879434,1.0286940401707954,12,20,11.63963508605957,8.915940284729004,20,12
1942,64,3.5143180721809335,5.437359622531305,1.011816697973726,1.032489306635063,28,48,12.014959335327148,8.915940284729004,36,16
1942,128,1.8587270204486939,5.41239408203143,1.0020261543998616,1.0341282962846314,60,109,12.596636772155762,8.915940284729004,68,19
1943,1,10.04975931449464,10.049759314494638,0.9441777736688507,0.9441777736688547,0,0,10.185022354125977,10.185022354125977,1,1
1943,2,9.122208228910353,9.122208228910354,0.9636556344594138,0.9636556344594149,0,0,10.189875602722168,10.185022354125977,2,2
1943,3,7.266295398490136,7.266295398490137,1.001268086634119,1.001268086634121,0,0,10.430712699890137,10.185022354125977,3,3
1943,4,7.234426076547678,7.266295398490137,1.0012660562780638,1.001268086634121,1,1,10.858834266662598,10.185022354125977,3,3
1943,8,6.561602005223413,6.954361301990677,1.0153863539749632,1.0125511833412744,3,4,11.518647193908691,10.185022354125977,5,4
1943,16,5.932989802477796,6.521069577810363,1.0326894087280913,1.0281019264280782,4,6,12.061605453491211,10.185022354125977,12,10
1943,32,5.159772779514667,6.186240819662991,1.0341134987689302,1.0399671785638516,13,20,12.585578918457031,10.185022354125977,19,12
1943,64,3.9132450332587485,6.149529947820943,1.0232928302668964,1.0427671247101342,28,46,13.183624267578125,10.185022354125977,36,18
1943,128,2.7300069439105785,5.933197105942252,1.0073250995201093,1.0543800195357436,60,106,13.9526948928833,10.185022354125977,68,22
1944,1,9.0483709453959,9.048370945395902,0.9488303830776399,0.9488303830776426,0,0,9.17523193359375,9.17523193359375,1,1
1944,2,8.172375662137268,8.17237566213727,0.969548317073957,0.9695483170739587,0,0,9.297553062438965,9.17523193359375,2,2
1944,3,7.615262375672895,7.615262375672894,0.98245298916614,0.9824529891661412,0,0,9.432811737060547,9.17523193359375,3,3
1944,4,7.536229260269358,7.536229260269358,0.98416647648642,0.9841664764864206,0,0,9.473937034606934,9.17523193359375,4,4
1944,8,6.179583233402092,6.180129462631123,1.0076488199369438,1.0076472066284936,2,2,9.911178588867188,9.17523193359375,6,6
1944,16,5.572652893980581,5.811731910386327,1.0161595778684958,1.0160265516706115,5,6,10.414648056030273,9.17523193359375,11,10
1944,32,5.016371848310865,5.476631297227634,1.032835219874747,1.028483619602219,11,16,11.156702995300293,9.17523193359375,21,16
1944,64,3.8023595273390107,5.307782515606525,1.0194700767154523,1.0354997441015974,34,47,11.73541259765625,9.17523193359375,30,17
1944,128,2.509840332217764,5.258128486011657,1.0091123872413308,1.0378981688226268,66,109,12.391698837280273,9.17523193359375,62,19
1945,1,9.426700506107178,9.426700506107183,0.9390700739014364,0.9390700739014388,0,0,9.603076934814453,9.603076934814453,1,1
1945,2,7.964611180963308,7.964611180963309,0.9686036259340652,0.9686036259340658,0,0,9.64171028137207,9.603076934814453,2,2
1945,3,7.766198517619983,7.766198517619983,0.9702313552107156,0.9702313552107154,0,0,9.94528579711914,9.603076934814453,3,3
1945,4,7.2178848752605065,7.2178848752605065,0.9808790917091028,0.9808790917091025,0,0,10.119674682617188,9.603076934814453,4,4
1945,8,6.261600620938681,6.267511748254097,0.9963737480716597,0.9965063012319881,1,2,10.327089309692383,9.603076934814453,7,6
1945,16,6.010327830807232,6.178713336580093,0.999126487116297,0.9986397201884617,8,9,10.776824951171875,9.603076934814453,8,7
1945,32,5.465751936140623,5.736598013819956,1.014022124032493,1.0146630922398439,12,20,11.099296569824219,9.603076934814453,20,12
1945,64,3.854172207641829,5.62555723252877,1.0187857317157984,1.0214825247614752,27,46,11.447769165039062,9.603076934814453,37,18
1945,128,2.008278811303448,5.438895446320591,1.0072661475104527,1.0272783656174789,65,107,11.843439102172852,9.603076934814453,63,21
1946,1,8.844699821511238,8.844699821511242,0.9456044996008623,0.9456044996008636,0,0,8.991606712341309,8.991606712341309,1,1
1946,2,7.009153916071264,7.009153916071263,0.9826319445928439,0.9826319445928444,0,0,9.183431625366211,8.991606712341309,2,2
1946,3,6.651810008758198,6.651810008758183,0.9909202998953883,0.9909202998953889,0,0,9.429863929748535,8.991606712341309,3,3
1946,4,6.03058819358132,6.03058819358132,0.9994097008438543,0.9994097008438549,0,0,9.569650650024414,8.991606712341309,4,4
1946,8,5.410604922697992,5.447580846068449,1.0098070226395555,1.0096063452989128,2,2,9.804536819458008,8.991606712341309,6,6
1946,16,5.059792398844789,5.317696615296987,1.013681959923334,1.0126620318551705,5,7,10.367181777954102,8.991606712341309,11,9
1946,32,4.427903753744423,5.185838640198307,1.0156871878327025,1.017694544841737,13,18,10.806977272033691,8.991606712341309,19,14
1946,64,3.1157683326146453,5.005256087390478,1.011568033548666,1.0233351220475215,29,47,11.30693531036377,8.991606712341309,35,17
1946,128,1.7955845723592572,4.865453539741329,1.002554497905583,1.027751171404845,56,113,11.870814323425293,8.991606712341309,72,15
1947,1,11.637890365986921,11.63789036598692,0.9196087066950941,0.9196087066950982,0,0,11.880887031555176,11.880887031555176,1,1
1947,2,9.10509684885477,9.105096848854767,0.9894144807001735,0.9894144807001759,0,0,12.282370567321777,11.880887031555176,2,2
1947,3,8.669031175176894,8.669031175176894,0.9983427470662144,0.998342747066216,0,0,12.626237869262695,11.880887031555176,3,3
1947,4,8.52809237851488,8.528092378514883,1.003256296913725,1.0032562969137282,0,0,12.719942092895508,11.880887031555176,4,4
1947,8,7.38897743954721,7.397119611008288,1.0315750239730916,1.0312615079271352,1,1,13.101325988769531,11.880887031555176,7,7
1947,16,7.223024752708295,7.264125953863319,1.0367133147068301,1.0347816087867163,4,5,13.465545654296875,11.880887031555176,12,11
1947,32,6.460924475047136,6.987248064631962,1.046126309243196,1.045121785093685,11,18,13.816625595092773,11.880887031555176,21,14
1947,64,5.074041132116117,6.725426847122488,1.0459595598318914,1.0519701785685278,26,49,14.20506763458252,11.880887031555176,38,15
1947,128,3.330795433841248,6.489659558759383,1.0220126564794572,1.0609724218561505,63,109,14.750813484191895,11.880887031555176,65,19
1948,1,2.2467074998173016,2.2467074998173016,0.9929365015124896,0.9929365015124912,0,0,2.257354497909546,2.257354497909546,1,1
1948,2,2.1346731411076068,2.1346731411076068,0.9941050508260063,0.9941050508260076,0,0,2.7135086059570312,2.257354497909546,2,2
1948,3,1.8091967591425795,1.8091967591425795,0.9978130546305184,0.9978130546305192,0,0,2.7493631839752197,2.257354497909546,3,3
1948,4,1.6984646117714448,1.698464611771445,0.9981139929840821,0.9981139929840829,0,0,2.8775198459625244,2.257354497909546,4,4
1948,8,1.559563370755727,1.5623119915196093,0.9989980519149126,0.9989533922247792,1,1,3.3433051109313965,2.257354497909546,7,7
1948,16,1.2965064480570596,1.4325988175427156,0.9991117701177806,0.9999005371420728,6,7,3.6974282264709473,2.257354497909546,10,9
1948,32,1.018328188267149,1.360024086875443,0.9979978667227755,1.0007650361351188,13,19,4.176977634429932,2.257354497909546,19,13
1948,64,0.6523947929150355,1.315506665412929,0.9973943129137327,1.0010603197701027,27,46,4.62525749206543,2.257354497909546,37,18
1948,128,0.10292063873696805,1.2967340833699064,0.9965243875104497,1.0013781081328919,63,110,5.203664779663086,2.257354497909546,65,18
1949,1,6.801642102025549,6.8016421020255535,0.966364374626199,0.9663643746262015,0,0,6.876974105834961,6.876974105834961,1,1
1949,2,5.762697158829879,5.762697158829882,0.9844452386979883,0.9844452386979907,0,0,7.112062931060791,6.876974105834961,2,2
1949,3,5.727827530227987,5.727827530227988,0.9848953734200343,0.9848953734200356,0,0,7.298525333404541,6.876974105834961,3,3
1949,4,5.096363259317914,5.096363259317915,0.9953260924032497,0.9953260924032508,0,0,7.559963703155518,6.876974105834961,4,4
1949,8,4.655176401738746,4.8176360665759255,1.0007990517818883,1.0012233145640232,2,3,8.352242469787598,6.876974105834961,6,5
1949,16,3.8464846690118226,4.382719833845503,1.0133319705985784,1.0102018053980069,5,8,8.845390319824219,6.876974105834961,11,8
1949,32,3.1687814510289027,3.9906518323879467,1.0138819035166684,1.0218369421308848,12,20,9.409724235534668,6.876974105834961,20,12
1949,64,2.1650703028423965,3.893345665397084,1.0067297033576583,1.024846451248778,28,49,10.142080307006836,6.876974105834961,36,15
1949,128,1.215738607252671,3.801213835491002,1.0016184016774425,1.0257321662751462,64,108,10.911169052124023,6.876974105834961,64,20
1950,1,2.3802949310574206,2.380294931057422,0.9954867214321307,0.9954867214321318,0,0,2.384387254714966,2.384387254714966,1,1
1950,2,1.898985698654677,1.8989856986546776,0.997959794154972,0.9979597941549724,0,0,2.516515016555786,2.384387254714966,2,2
1950,3,1.7256931923739467,1.7256931923739471,0.9991024368641839,0.9991024368641843,0,0,2.603658437728882,2.384387254714966,3,3
1950,4,1.5408679472954343,1.540867947295434,1.0006556745342894,1.0006556745342898,0,0,2.716137647628784,2.384387254714966,4,4
1950,8,1.2271529477622143,1.2438195325818344,1.0015937387525913,1.001587609254642,2,2,2.8692610263824463,2.384387254714966,6,6
1950,16,1.012323440072845,1.0532796014597765,1.0028071612479814,1.002601565047634,3,7,3.3499596118927,2.384387254714966,13,9
1950,32,0.7948145514807726,0.9830843921425186,1.0024732759172537,1.0028587966429066,14,22,3.786524534225464,2.384387254714966,18,10
1950,64,0.4167508998844947,0.8227938146767291,1.0007689592154954,1.0030364529863565,31,48,4.200032711029053,2.384387254714966,33,16
1950,128,0.05794734488824406,0.8203495120945095,0.9997171475875153,1.0032262454310423,64,112,4.679759979248047,2.384387254714966,64,16
1951,1,8.864038623099379,8.864038623099377,0.9468254461688823,0.9468254461688841,0,0,9.008519172668457,9.008519172668457,1,1
1951,2,7.834462821120167,7.834462821120166,0.9665712185638387,0.9665712185638393,0,0,9.213808059692383,9.008519172668457,2,2
1951,3,7.195409054246485,7.195409054246485,0.9802477617488092,0.980247761748809,0,0,9.27169418334961,9.008519172668457,3,3
1951,4,6.961491586348862,6.9614915863488465,0.9859123967512395,0.98591239675124,0,0,9.53622817993164,9.008519172668457,4,4
1951,8,6.588486097771333,6.591331889752898,0.9945233093726507,0.9945011466708293,3,3,9.847026824951172,9.008519172668457,5,5
1951,16,5.837635403827493,6.172361653453857,1.0039808334170894,1.003313129940926,7,9,10.282711029052734,9.008519172668457,9,7
1951,32,5.207684147911174,5.6786820809803835,1.013548642216214,1.0134285913268353,17,22,10.76517105102539,9.008519172668457,15,10
1951,64,3.9122262803411725,5.5756761008979625,1.0034431244372168,1.0172257979465458,33,50,11.122257232666016,9.008519172668457,31,14
1951,128,2.210960455186964,5.435862162796435,1.0043097006259054,1.0243950651803855,68,110,11.573013305664062,9.008519172668457,60,18
1952,1,8.983928171169875,8.983928171169875,0.9532415980890387,0.9532415980890389,0,0,9.093936920166016,9.093936920166016,1,1
1952,2,7.714482983146445,7.714482983146446,0.975544642235071,0.9755446422350706,0,0,9.75865650177002,9.093936920166016,2,2
1952,3,6.858246152752699,6.858246152752699,0.9917012014816479,0.9917012014816471,0,0,10.067320823669434,9.093936920166016,3,3
1952,4,6.852302012532511,6.852302012532512,0.9923551094018018,0.9923551094018008,0,0,10.118555068969727,9.093936920166016,4,4
1952,8,6.8270599351820485,6.827136775347165,0.9930894587153231,0.9930674360909604,1,1,10.656698226928711,9.093936920166016,7,7
1952,16,5.728769108822867,5.959604982199126,1.013034474671845,1.0155328259652023,6,9,11.023445129394531,9.093936920166016,10,7
1952,32,4.862145259428896,5.953361158938051,1.014304545556716,1.0161450864673747,14,23,11.522632598876953,9.093936920166016,18,9
1952,64,3.3023202308048125,5.758111925564498,1.005195646142803,1.0238282550117117,30,55,12.051149368286133,9.093936920166016,34,9
1952,128,1.8863299392719581,5.750882262467803,0.9993064836623606,1.0249066624893803,62,119,12.455751419067383,9.093936920166016,66,9
1953,1,9.244159636835104,9.244159636835105,0.9500693744228261,0.9500693744228286,0,0,9.36335277557373,9.36335277557373,1,1
1953,2,8.438848491327931,8.43884849132793,0.9666778947741546,0.9666778947741554,0,0,9.616595268249512,9.36335277557373,2,2
1953,3,7.762393670703653,7.762393670703652,0.9791734391537315,0.9791734391537334,0,0,9.942076683044434,9.36335277557373,3,3
1953,4,7.009429493538344,7.009429493538344,0.9938155374347946,0.9938155374347969,0,0,9.957642555236816,9.36335277557373,4,4
1953,8,5.681699455481959,5.682525362768883,1.0176971832143562,1.017774964098218,2,2,10.680733680725098,9.36335277557373,6,6
1953,16,5.309671461614467,5.535243929453385,1.021908458413688,1.024291587160116,6,7,11.290701866149902,9.36335277557373,10,9
1953,32,4.6277296603859615,5.22209653713053,1.0286940028139322,1.0345699824307424,13,22,11.873064041137695,9.36335277557373,19,10
1953,64,3.7259430909143556,5.206980047989147,1.0221285920434116,1.0361433893895522,31,51,12.362351417541504,9.36335277557373,33,13
1953,128,2.1961592840785267,5.202536852597275,1.0047683982277675,1.036942249818669,54,115,12.998334884643555,9.36335277557373,74,13
1954,1,11.162021425565566,11.162021425565566,0.926105525598908,0.9261055255989089,0,0,11.372233390808105,11.372233390808105,1,1
1954,2,10.267134346428215,10.267134346428215,0.9551208694252111,0.9551208694252115,0,0,12.446453094482422,11.372233390808105,2,2
1954,3,9.747728960615078,9.74772896061508,0.9726007312134598,0.97260073121346,0,0,12.908166885375977,11.372233390808105,3,3
1954,4,9.631142946065259,9.631142946065259,0.9776430712230899,0.9776430712230905,0,0,13.330977439880371,11.372233390808105,4,4
1954,8,9.119542608949155,9.266670337092165,0.998755444790923,0.9965096724561797,1,1,14.037104606628418,11.372233390808105,7,7
1954,16,8.68871538892903,9.145990171987982,1.0021943249188559,1.0025294509636034,5,7,14.777115821838379,11.372233390808105,11,9
1954,32,7.592625356606716,8.99090761253901,1.0099035371127947,1.0117525782239796,14,22,15.355600357055664,11.372233390808105,18,10
1954,64,6.024687758822174,8.956193103673497,1.0113200617349907,1.0164369882593354,33,53,15.88320255279541,11.372233390808105,31,11
1954,128,3.6995036493032125,8.507011124201833,1.0092086758984182,1.0296082849133068,65,117,16.311668395996094,11.372233390808105,63,11
1955,1,3.0039097105014627,3.0039097105014627,0.9953918762262223,0.9953918762262227,0,0,3.0072836875915527,3.0072836875915527,1,1
1955,2,2.677041170670668,2.6770411706706674,0.9975132603290713,0.9975132603290713,0,0,3.04166841506958,3.0072836875915527,2,2
1955,3,2.397573771362095,2.3975737713620955,0.9982078227382101,0.9982078227382116,0,0,3.0920627117156982,3.0072836875915527,3,3
1955,4,2.3444931665188244,2.344493166518825,0.9985949160602619,0.9985949160602612,0,0,3.136249303817749,3.0072836875915527,4,4
1955,8,1.4892507344071777,1.7083738098014858,1.000370887142898,1.0007099470207939,3,4,3.2794322967529297,3.0072836875915527,5,4
1955,16,1.2160101967551833,1.6775020483221668,1.0008986462683107,1.0009225294123085,5,8,3.6648151874542236,3.0072836875915527,11,8
1955,32,0.8813655335541805,1.6290123914256454,1.0003478432121824,1.0020001163944767,13,22,3.8984384536743164,3.0072836875915527,19,10
1955,64,0.5673107968464702,1.6240095956261926,1.0002608930522827,1.0022081534392036,27,52,4.33508825302124,3.0072836875915527,37,12
1955,128,0.05266122905491789,1.6037734788827607,0.9996591624797431,1.0026964914795737,58,114,4.8098225593566895,3.0072836875915527,70,14
1956,1,9.024578885260878,9.024578885260878,0.9517445148707823,0.9517445148707843,0,0,9.13853645324707,9.13853645324707,1,1
1956,2,8.059613329406856,8.059613329406856,0.9764299625478448,0.9764299625478462,0,0,10.310575485229492,9.13853645324707,2,2
1956,3,7.8045643147537085,7.80456431475371,0.9847993367887661,0.9847993367887671,0,0,11.872810363769531,9.13853645324707,3,3
1956,4,7.803779544791266,7.804564314753709,0.98450896723214,0.9847993367887673,1,1,12.528343200683594,9.13853645324707,3,3
1956,8,7.509512549998625,7.6086903219387025,0.9903621421897071,0.9925298927048869,3,3,13.044098854064941,9.13853645324707,5,5
1956,16,6.639897976039926,7.205863114946218,1.012157343859226,1.0156427202890455,6,8,13.563904762268066,9.13853645324707,10,8
1956,32,5.522598448819762,6.860395292022849,1.0118976506567132,1.0252529449949623,15,24,14.110936164855957,9.13853645324707,17,8
1956,64,4.161257688185027,6.455411455706999,1.0051174372689018,1.0382467840443066,29,51,14.602296829223633,9.13853645324707,35,13
1956,128,2.633349740830824,6.229651881086046,1.0002791707207768,1.043938275500606,56,111,15.170869827270508,9.13853645324707,72,17
1957,1,5.596941734885935,5.5969417348859345,0.9852601424203888,0.9852601424203903,0,0,5.614607810974121,5.614607810974121,1,1
1957,2,5.03962981077658,5.03962981077658,0.9904156825719431,0.9904156825719443,0,0,6.586275577545166,5.614607810974121,2,2
1957,3,4.263936069091049,4.263936069091049,1.0018037867963656,1.0018037867963665,0,0,6.7694196701049805,5.614607810974121,3,3
1957,4,4.159283564123156,4.159283564123157,1.0039863016739154,1.0039863016739163,0,0,6.968852996826172,5.614607810974121,4,4
1957,8,3.6778320759121326,3.6791252451279814,1.0100585538423494,1.0102405171617836,2,2,7.6749162673950195,5.614607810974121,6,6
1957,16,3.1201153128909445,3.2562076512862914,1.0144461404248997,1.0182747119732622,5,6,8.14969253540039,5.614607810974121,11,10
1957,32,2.6095607077430967,3.2534333992168727,1.0075761992753602,1.0187355998619378,13,20,8.969367027282715,5.614607810974121,19,12
1957,64,1.9454067108492845,3.246653447427514,1.0007374286962978,1.0193137112400024,29,52,9.747413635253906,5.614607810974121,35,12
1957,128,1.1713207881508891,3.2196164059853394,1.0004756209191172,1.020019950151147,70,116,10.628228187561035,5.614607810974121,58,12
1958,1,7.907014635883002,7.9070146358830025,0.9666254540953249,0.9666254540953265,0,0,7.970874786376953,7.970874786376953,1,1
1958,2,7.7504888883910645,7.7504888883910645,0.9748483469764826,0.974848346976484,0,0,10.048152923583984,7.970874786376953,2,2
1958,3,7.467597282903225,7.467597282903225,0.9828929793384708,0.9828929793384718,0,0,10.055286407470703,7.970874786376953,3,3
1958,4,6.65233893239785,6.654769352413858,0.9995987639434503,0.9996808621503928,1,1,10.19474983215332,7.970874786376953,3,3
1958,8,6.119802220836946,6.169569004767516,1.01457876785891,1.0140417450598256,1,1,10.502960205078125,7.970874786376953,7,7
1958,16,5.395862683564666,5.6407982541224255,1.0276318767216868,1.0280295306467455,7,8,10.986212730407715,7.970874786376953,9,8
1958,32,4.403732351223609,5.547341633791971,1.0171412116621399,1.0311974011825353,11,21,11.636862754821777,7.970874786376953,21,11
1958,64,3.262849641547288,5.540629848562182,1.009953857407119,1.0321671835515558,29,50,12.240836143493652,7.970874786376953,35,14
1958,128,1.9660291604518292,5.480737349862318,1.007379386548561,1.0351752423544975,63,114,12.921463966369629,7.970874786376953,65,14
1959,1,11.340020695858794,11.34002069585879,0.9315576695720531,0.9315576695720561,0,0,11.517325401306152,11.517325401306152,1,1
1959,2,9.928143285881772,9.928143285881772,0.9660007101275535,0.9660007101275534,0,0,11.574941635131836,11.517325401306152,2,2
1959,3,9.0224885324826,9.0224885324826,0.9880961071807078,0.9880961071807076,0,0,11.689083099365234,11.517325401306152,3,3
1959,4,8.705151768573058,8.705151768573058,0.994973464501654,0.9949734645016541,0,0,11.756865501403809,11.517325401306152,4,4
1959,8,7.855055313447727,7.855055313447728,1.0154747423228434,1.0154747423228432,0,0,12.11925220489502,11.517325401306152,8,8
1959,16,7.1801765870200285,7.373472785703476,1.0365057670094278,1.031631440444349,3,4,12.749968528747559,11.517325401306152,13,12
1959,32,6.403723776785086,6.986742722434285,1.0418083258950832,1.0413730067044775,14,21,13.448003768920898,11.517325401306152,18,11
1959,64,4.877761621971115,6.929190653569958,1.0292475165332071,1.0459199131073804,30,51,14.129327774047852,11.517325401306152,34,13
1959,128,3.0685538121529663,6.873380559476734,1.0063683257384333,1.0480446892109145,63,116,14.776572227478027,11.517325401306152,65,12
1960,1,9.382370419269678,9.382370419269678,0.9489952929675569,0.9489952929675575,0,0,9.50645923614502,9.50645923614502,1,1
1960,2,8.135800896221495,8.135800896221493,0.9778343880508742,0.9778343880508734,0,0,10.037511825561523,9.50645923614502,2,2
1960,3,7.281223558151935,7.281223558151934,0.994111066342678,0.9941110663426772,0,0,10.134634017944336,9.50645923614502,3,3
1960,4,7.263771180099263,7.263771180099262,0.995610159922641,0.9956101599226398,0,0,11.07194709777832,9.50645923614502,4,4
1960,8,6.561155366611311,6.561583577900169,1.0126864108065639,1.0127076561456765,2,2,11.64294719696045,9.50645923614502,6,6
1960,16,6.154101376961464,6.455331335663553,1.012177137776846,1.0159936952310096,5,8,12.761972427368164,9.50645923614502,11,8
1960,32,5.177759038784878,6.222811947442353,1.019250248470689,1.0264084949588672,14,23,13.344112396240234,9.50645923614502,18,9
1960,64,4.372601413019802,6.043203609766722,1.0163206277993178,1.0322845720787595,29,49,14.254916191101074,9.50645923614502,35,15
1960,128,2.7596393399644583,5.9205926928650765,1.0076070595072653,1.042267258092998,61,112,14.89375114440918,9.50645923614502,67,16
1961,1,9.631407936641333,9.631407936641336,0.9481956037707217,0.9481956037707225,0,0,9.755191802978516,9.755191802978516,1,1
1961,2,9.359194278524221,9.359194278524221,0.9567876743180924,0.9567876743180921,0,0,9.888177871704102,9.755191802978516,2,2
1961,3,8.325418302076928,8.325418302076928,0.9804568664674373,0.9804568664674382,0,0,10.184188842773438,9.755191802978516,3,3
1961,4,7.223868506218301,7.223868506218301,1.0056383311515908,1.00563833115159,0,0,10.234216690063477,9.755191802978516,4,4
1961,8,7.084737571005165,7.12652605700502,1.008126135975517,1.008489039434396,2,2,10.83230972290039,9.755191802978516,6,6
1961,16,6.44310433451466,6.779502804246948,1.0212775518694306,1.02007188329365,5,8,11.45528793334961,9.755191802978516,11,8
1961,32,5.584856972537569,6.689539102825951,1.0246140340065804,1.0241047753394659,13,22,11.918902397155762,9.755191802978516,19,10
1961,64,4.3648226713421,6.627517687405307,1.0143008966619242,1.029300725394129,28,50,12.612336158752441,9.755191802978516,36,14
1961,128,2.29695417450702,6.6105650296396705,1.0024840983756373,1.0310457403743194,61,111,13.23099136352539,9.755191802978516,67,17
1962,1,4.080623486626226,4.080623486626222,0.990586777638738,0.9905867776387403,0,0,4.090977668762207,4.090977668762207,1,1
1962,2,3.84396652982868,3.843966529828681,0.9921652060476798,0.9921652060476805,0,0,4.092844009399414,4.090977668762207,2,2
1962,3,3.0517371430872444,3.0517371430872444,0.9988361544192181,0.9988361544192195,0,0,4.117283821105957,4.090977668762207,3,3
1962,4,2.9799336493566533,2.9799336493566533,0.9994773008370964,0.999477300837097,0,0,4.303473472595215,4.090977668762207,4,4
1962,8,2.8022318876964674,2.810068892258399,1.001477142541728,1.0011364172836754,1,1,5.307877063751221,4.090977668762207,7,7
1962,16,2.331987899584799,2.7638146415132274,1.0009793115124273,1.0022886746364863,5,6,5.7748870849609375,4.090977668762207,11,10
1962,32,1.6290325561733336,2.680847221083688,1.0023892230291493,1.0045008576712988,12,20,6.161006927490234,4.090977668762207,20,12
1962,64,0.922717619716191,2.665998511019785,1.001209475428945,1.0048429636970013,25,52,6.827226638793945,4.090977668762207,39,12
1962,128,0.19628552233784363,2.605067349781773,0.9995600291014095,1.0075391112949899,63,116,7.553038120269775,4.090977668762207,65,12
1963,1,7.005200976665927,7.0052009766659245,0.9731599187972393,0.9731599187972414,0,0,7.051782608032227,7.051782608032227,1,1
1963,2,6.005351123559394,6.005351123559395,0.9878674385819375,0.9878674385819384,0,0,7.455114841461182,7.051782608032227,2,2
1963,3,5.212891931317625,5.212891931317625,1.0016231593401954,1.0016231593401965,0,0,7.643545150756836,7.051782608032227,3,3
1963,4,5.1840927735974365,5.184092773597436,1.0023515359665407,1.0023515359665418,0,0,8.064714431762695,7.051782608032227,4,4
1963,8,4.7424160783039575,4.776577374053655,1.0058291160872714,1.0063918511679133,3,4,8.48361873626709,7.051782608032227,5,4
1963,16,4.383935828862236,4.608700213253964,1.0106623386487223,1.0118733147693058,8,10,9.156381607055664,7.051782608032227,8,6
1963,32,3.6749734118307416,4.540103190143829,1.0083354420957606,1.0147686193903327,17,21,9.831862449645996,7.051782608032227,15,11
1963,64,2.9441150358480805,4.396709705187958,1.0016636462012287,1.0210241151394177,29,50,10.37500286102295,7.051782608032227,35,14
1963,128,1.6014220466184241,4.253612179854074,0.9995630831837916,1.0240431962970291,58,114,11.003236770629883,7.051782608032227,70,14
1964,1,10.77234767474029,10.77234767474029,0.9322619731924009,0.9322619731924037,0,0,10.951099395751953,10.951099395751953,1,1
1964,2,8.735669292061996,8.735669292061994,0.9811611043791513,0.9811611043791544,0,0,11.319780349731445,10.951099395751953,2,2
1964,3,8.306023313093888,8.306023313093888,0.9942894789508755,0.9942894789508776,0,0,11.891875267028809,10.951099395751953,3,3
1964,4,8.305999050219496,8.306023313093888,0.9942731981837235,0.9942894789508776,1,1,12.46284008026123,10.951099395751953,3,3
1964,8,7.227485674501633,7.567160799976915,1.0115892934501467,1.0132707434284554,3,4,13.695976257324219,10.951099395751953,5,4
1964,16,6.889225870105622,7.546223942648572,1.0154916399286624,1.0159110536433127,7,11,14.468696594238281,10.951099395751953,9,5
1964,32,6.313790310196742,7.399719352002423,1.0223479216945184,1.0301315307558343,14,25,15.189037322998047,10.951099395751953,18,7
1964,64,4.520534975682667,7.054908192080604,1.0158627234040174,1.045304357217103,34,55,15.962202072143555,10.951099395751953,30,9
1964,128,3.152472701881206,6.7075575379387455,1.0077075767238064,1.056438607101869,66,114,16.870098114013672,10.951099395751953,62,14
1965,1,7.638105643190201,7.638105643190203,0.9620706577990039,0.9620706577990057,0,0,7.7237324714660645,7.7237324714660645,1,1
1965,2,6.852147395622986,6.852147395622989,0.9787871529210608,0.9787871529210623,0,0,8.540410041809082,7.7237324714660645,2,2
1965,3,6.778611719750816,6.778611719750818,0.9807454700016401,0.9807454700016417,0,0,8.834653854370117,7.7237324714660645,3,3
1965,4,6.777458180177857,6.7774581801778595,0.9808842138470364,0.980884213847038,0,0,8.899744033813477,7.7237324714660645,4,4
1965,8,6.479359630197469,6.601567965716768,0.9850490200115648,0.9854303602704039,3,3,9.311524391174316,7.7237324714660645,5,5
1965,16,5.411622876042452,6.215791622121979,0.9924317518768535,0.9950076415927362,7,8,9.961939811706543,7.7237324714660645,9,8
1965,32,4.818557482196854,6.152515629587318,0.9978030190169352,0.9983600580433757,16,25,10.220927238464355,7.7237324714660645,16,7
1965,64,3.4700775471938425,5.841267748414204,0.9946935862955943,1.0072050371898453,32,51,10.690025329589844,7.7237324714660645,32,13
1965,128,2.177735940596424,5.440429606952012,0.9985256213025555,1.0168227772045098,64,115,11.333648681640625,7.7237324714660645,64,13
1966,1,9.911575987804634,9.911575987804635,0.9427173101559531,0.9427173101559551,0,0,10.055061340332031,10.055061340332031,1,1
1966,2,7.999707020012794,7.999707020012794,0.9837524794753909,0.9837524794753909,0,0,10.257699012756348,10.055061340332031,2,2
1966,3,7.363085452800623,7.363085452800624,0.9962923678782611,0.9962923678782605,0,0,10.31905460357666,10.055061340332031,3,3
1966,4,6.622668684607005,6.622668684607005,1.0087177166212333,1.008717716621233,0,0,10.476568222045898,10.055061340332031,4,4
1966,8,5.866882938480371,5.866882938480371,1.0226439772074274,1.0226439772074283,0,0,10.768037796020508,10.055061340332031,8,8
1966,16,5.551630161238759,5.576547885798834,1.0327048972269002,1.0321275219366985,5,5,11.494420051574707,10.055061340332031,11,11
1966,32,5.044908977749441,5.570139617937487,1.027715498873234,1.0323268579191767,16,20,12.062061309814453,10.055061340332031,16,12
1966,64,3.922259779188037,5.535306604942454,1.0160152835312843,1.0352149674488929,29,47,12.70059585571289,10.055061340332031,35,17
1966,128,1.9208079940038794,5.450298508129937,1.0050663185652648,1.037543575892024,64,110,13.282904624938965,10.055061340332031,64,18
1967,1,10.101631328222341,10.101631328222343,0.9458836082495241,0.945883608249526,0,0,10.22357177734375,10.22357177734375,1,1
1967,2,8.176499213741083,8.176499213741083,0.9905933571184689,0.9905933571184697,0,0,10.787853240966797,10.22357177734375,2,2
1967,3,7.406504493844496,7.406504493844495,1.003952917513825,1.0039529175138242,0,0,10.893921852111816,10.22357177734375,3,3
1967,4,7.37337544423269,7.373375444232689,1.004579832998945,1.0045798329989442,0,0,10.93531322479248,10.22357177734375,4,4
1967,8,6.374329883111024,6.38120471073614,1.0221277974502725,1.0222329099269822,1,1,11.752049446105957,10.22357177734375,7,7
1967,16,6.041167288878059,6.190244341687895,1.0247289584542174,1.0276247618526446,5,5,12.31164264678955,10.22357177734375,11,11
1967,32,5.099681701270065,5.968608577020699,1.0368623212336898,1.0374416574788121,9,16,12.778937339782715,10.22357177734375,23,16
1967,64,3.794747331802272,5.878005620663443,1.0228443476504872,1.044202601193357,30,47,13.406426429748535,10.22357177734375,34,17
1967,128,2.439868509995699,5.864457537960488,1.0079416735057407,1.0448485006620098,52,109,14.039787292480469,10.22357177734375,76,19
1968,1,11.878654723715737,11.878654723715737,0.9157317391234475,0.9157317391234497,0,0,12.138611793518066,12.138611793518066,1,1
1968,2,10.723113577242813,10.723113577242813,0.9486737628653461,0.9486737628653477,0,0,12.41405963897705,12.138611793518066,2,2
1968,3,9.699277910393626,9.699277910393626,0.9768960946946426,0.9768960946946427,0,0,12.482386589050293,12.138611793518066,3,3
1968,4,9.37667864009519,9.376678640095188,0.9839624284273402,0.9839624284273404,0,0,12.747246742248535,12.138611793518066,4,4
1968,8,8.63992265411604,8.704648929445078,1.005759726512782,1.005149711613085,1,1,13.501758575439453,12.138611793518066,7,7
1968,16,7.58732370786639,7.890869034538082,1.024351453425732,1.0256046055530013,6,10,13.814966201782227,12.138611793518066,10,6
1968,32,6.555388533866228,7.890831190578469,1.0204915332510494,1.0256536714509576,18,25,14.275775909423828,12.138611793518066,14,7
1968,64,5.078799378973492,7.80104263399259,1.0213945599339493,1.0319439002778106,37,53,14.69909954071045,12.138611793518066,27,11
1968,128,3.2234933303224533,7.7707644794351225,1.0038329874476744,1.0351649293334348,64,114,15.241284370422363,12.138611793518066,64,14
1969,1,3.02493032608715,3.0249303260871496,0.9931041937267134,0.9931041937267149,0,0,3.0324301719665527,3.0324301719665527,1,1
1969,2,2.8767051438509808,2.8767051438509816,0.9946112339907778,0.9946112339907788,0,0,3.206700563430786,3.0324301719665527,2,2
1969,3,2.702841662563676,2.702841662563676,0.9963441227807242,0.9963441227807249,0,0,3.5859375,3.0324301719665527,3,3
1969,4,2.5910658421652384,2.591065842165239,0.9973121691102387,0.9973121691102402,0,0,3.7850191593170166,3.0324301719665527,4,4
1969,8,2.4363110738776825,2.487327403062775,0.9975332147113227,0.9980413342037566,3,4,3.9090654850006104,3.0324301719665527,5,4
1969,16,2.03874513717966,2.4794213729332983,0.9967926935460658,0.9980823569569905,6,11,4.122364521026611,3.0324301719665527,10,5
1969,32,1.260487450385299,2.3902802215045833,1.0009559570424487,0.9992390687727598,15,23,4.400839328765869,3.0324301719665527,17,9
1969,64,0.6517502975545669,2.2001188822433595,0.9994118931428861,1.0031689215722095,36,54,4.73914909362793,3.0324301719665527,28,10
1969,128,0.10785441402875114,2.164937643844954,0.999395060458909,1.003675422733846,59,115,5.160518646240234,3.0324301719665527,69,13
1970,1,9.043287290837798,9.043287290837801,0.9570340362510805,0.9570340362510839,0,0,9.132954597473145,9.132954597473145,1,1
1970,2,7.3930357396898785,7.393035739689879,0.9836326128172452,0.9836326128172472,0,0,9.21727466583252,9.132954597473145,2,2
1970,3,6.803320944296278,6.803320944296279,0.9940869430274263,0.9940869430274273,0,0,9.585149765014648,9.132954597473145,3,3
1970,4,6.4358248086080225,6.435824808608023,1.0006334085198174,1.0006334085198187,0,0,10.027791976928711,9.132954597473145,4,4
1970,8,6.088212110232433,6.089710426687748,1.0096927300811527,1.0099894771907012,1,1,10.843341827392578,9.132954597473145,7,7
1970,16,5.4030915509931745,5.526515506744613,1.023333792441435,1.0248569888277226,4,6,11.358053207397461,9.132954597473145,12,10
1970,32,4.724505837623287,5.4424279671904765,1.0212182671754693,1.0282129849237145,14,17,12.120112419128418,9.132954597473145,18,15
1970,64,3.608259044216013,5.419329832360264,1.007683534104559,1.0297981795498181,28,47,13.059593200683594,9.132954597473145,36,17
1970,128,2.3827397874875547,5.360995517634434,1.0075153139919855,1.0339071165652745,60,109,13.975287437438965,9.132954597473145,68,19
1971,1,8.281888027074189,8.281888027074192,0.9619691113845725,0.9619691113845753,0,0,8.357133865356445,8.357133865356445,1,1
1971,2,6.983378535532608,6.983378535532608,0.9867851674070823,0.9867851674070831,0,0,8.696321487426758,8.357133865356445,2,2
1971,3,6.768996400924919,6.7689964009249195,0.9869105048924567,0.9869105048924574,0,0,8.868461608886719,8.357133865356445,3,3
1971,4,6.382112541218195,6.382112541218195,0.9955736400731989,0.995573640073199,0,0,9.115128517150879,8.357133865356445,4,4
1971,8,5.796876056353703,5.844817260657138,1.005320485833157,1.00753774689092,1,2,9.734262466430664,8.357133865356445,7,6
1971,16,5.0572836134587185,5.4406420178571215,1.0134896112575276,1.0141243359331944,7,8,10.191540718078613,8.357133865356445,9,8
1971,32,4.333088129520086,4.852021625582791,1.0252272888065068,1.0253346092774576,13,22,10.86814022064209,8.357133865356445,19,10
1971,64,3.5130349864308283,4.787546745093576,1.0141866667183126,1.0290047208872897,32,51,11.737768173217773,8.357133865356445,32,13
1971,128,2.2072247110763,4.774972627823086,1.002843360697443,1.0310029608913094,57,113,12.693384170532227,8.357133865356445,71,15
1972,1,11.147250990755692,11.147250990755696,0.9256268031015409,0.9256268031015423,0,0,11.36640453338623,11.36640453338623,1,1
1972,2,9.539908446514914,9.539908446514916,0.9682951888083173,0.9682951888083173,0,0,11.863347053527832,11.36640453338623,2,2
1972,3,7.8270525295898326,7.827052529589832,1.0108052161433947,1.0108052161433956,0,0,12.163886070251465,11.36640453338623,3,3
1972,4,7.621663373461203,7.621663373461204,1.016869956394463,1.0168699563944636,0,0,12.212302207946777,11.36640453338623,4,4
1972,8,7.090947578251863,7.114498770193572,1.0283979673692036,1.02822001616742,2,2,12.589585304260254,11.36640453338623,6,6
1972,16,6.8859741328435105,7.014296854047119,1.032413556891448,1.031523907349188,4,7,13.052003860473633,11.36640453338623,12,9
1972,32,6.074653049114606,6.778662915116338,1.0439240085209942,1.0405431152543838,12,17,13.54171371459961,11.36640453338623,20,15
1972,64,4.2901349911696816,6.728967851258421,1.0300019194946963,1.044958292064185,27,46,14.790046691894531,11.36640453338623,37,18
1972,128,2.8281997069397575,6.725981016318847,1.00702229362849,1.0458337746004143,61,109,15.479174613952637,11.36640453338623,67,19
1973,1,9.212482610860109,9.212482610860112,0.9539297439370649,0.9539297439370668,0,0,9.316164016723633,9.316164016723633,1,1
1973,2,8.056475166128637,8.056475166128637,0.9869307486402923,0.9869307486402942,0,0,12.023391723632812,9.316164016723633,2,2
1973,3,7.2555499620412025,7.255549962041202,1.0076701542699227,1.007670154269925,0,0,12.143460273742676,9.316164016723633,3,3
1973,4,7.004848671572685,7.004848671572686,1.012265822565925,1.0122658225659267,0,0,12.329354286193848,9.316164016723633,4,4
1973,8,6.854655949706477,6.854655949706476,1.020100709034398,1.0201007090343992,0,0,12.897493362426758,9.316164016723633,8,8
1973,16,6.285783827812907,6.715710300717947,1.0168015335370617,1.0261039542020411,7,6,13.591545104980469,9.316164016723633,9,10
1973,32,5.70602821299329,6.602778149026411,1.0173134326207578,1.0306642656461231,16,23,14.242049217224121,9.316164016723633,16,9
1973,64,4.548783181885577,6.491991339738611,1.0154742964927697,1.0409567268646183,30,53,15.277631759643555,9.316164016723633,34,11
1973,128,2.9415119158242606,6.423549757769684,1.0030147864813699,1.043206003371751,60,115,16.232789993286133,9.316164016723633,68,13
1974,1,4.5836154663328745,4.583615466332875,0.982389326166637,0.9823893261666398,0,0,4.615682125091553,4.615682125091553,1,1
1974,2,4.07871343531504,4.078713435315039,0.988354842998358,0.9883548429983602,0,0,5.031914710998535,4.615682125091553,2,2
1974,3,3.5547374516038173,3.554737451603818,0.9960919861900683,0.9960919861900698,0,0,5.356151103973389,4.615682125091553,3,3
1974,4,3.539122308675701,3.5391223086757013,0.996210354904568,0.9962103549045699,0,0,5.366577625274658,4.615682125091553,4,4
1974,8,3.357944350488105,3.3986519856221147,0.9974991147201677,0.9974457394256795,3,3,5.936446666717529,4.615682125091553,5,5
1974,16,3.1593650090424,3.360504462876306,0.9996663136959626,0.9988413911457206,5,9,6.4753336906433105,4.615682125091553,11,7
1974,32,2.603170769138245,3.2315748825320876,1.0047391847724603,1.0032548359165276,17,22,6.900139331817627,4.615682125091553,15,10
1974,64,1.5384092146328536,3.090574005339992,1.00205146553448,1.0073662717523586,30,51,7.695907115936279,4.615682125091553,34,13
1974,128,0.5089491971189192,2.9893056235621085,0.9993188125127348,1.0090107451341217,67,111,8.509344100952148,4.615682125091553,61,17
1975,1,7.787545932354533,7.787545932354534,0.9665788558011749,0.966578855801176,0,0,7.853517532348633,7.853517532348633,1,1
1975,2,7.115562164622666,7.115562164622666,0.979539882881393,0.9795398828813935,0,0,8.541929244995117,7.853517532348633,2,2
1975,3,6.977590274723448,6.977590274723448,0.9814070318246016,0.9814070318246018,0,0,8.618088722229004,7.853517532348633,3,3
1975,4,5.920290916053509,5.920290916053508,1.0013260181031927,1.0013260181031929,0,0,9.1661958694458,7.853517532348633,4,4
1975,8,5.654605588209565,5.687203522220737,1.0068818720857535,1.0087479601883083,2,2,9.89286994934082,7.853517532348633,6,6
1975,16,4.75701781893863,5.364240634397141,1.0127898569790832,1.0154418272364034,5,7,10.184925079345703,7.853517532348633,11,9
1975,32,4.154791482000711,5.0852903889715675,1.0149523924838166,1.0226323331056437,14,22,10.930991172790527,7.853517532348633,18,10
1975,64,2.725210292419411,5.000540420073927,1.006330383667128,1.025889433842814,32,52,11.712888717651367,7.853517532348633,32,12
1975,128,1.456919806403713,4.958942746867577,1.0024870006037923,1.0281064595037357,64,110,12.588685035705566,7.853517532348633,64,18
1976,1,9.399343029183775,9.39934302918378,0.9402504100003553,0.9402504100003579,0,0,9.563247680664062,9.563247680664062,1,1
1976,2,8.377343272194038,8.37734327219404,0.9627213482702492,0.9627213482702512,0,0,9.77530288696289,9.563247680664062,2,2
1976,3,8.351964205170201,8.351964205170201,0.9638459513984002,0.9638459513984015,0,0,10.7803373336792,9.563247680664062,3,3
1976,4,8.215230984615959,8.215230984615957,0.9677800131799299,0.9677800131799308,0,0,10.892253875732422,9.563247680664062,4,4
1976,8,7.847788570574767,7.848459054859255,0.9798537926070012,0.9798248923140209,1,1,11.4445161819458,9.563247680664062,7,7
1976,16,6.997248202428066,7.18903291077479,1.004257399185715,1.0031506672839763,5,6,11.957296371459961,9.563247680664062,11,10
1976,32,5.165680580787897,6.622232223590411,1.0145099365796582,1.0193755419796255,12,19,12.53404426574707,9.563247680664062,20,13
1976,64,3.773973325581289,6.353292325028844,1.0138861908647738,1.0263826363170783,29,49,13.171738624572754,9.563247680664062,35,15
1976,128,2.1381798744812506,6.198989994359863,1.003440333650119,1.0334530976975802,61,110,13.804803848266602,9.563247680664062,67,18
1977,1,8.90609603677068,8.906096036770677,0.9669918457793749,0.9669918457793777,0,0,8.96096420288086,8.96096420288086,1,1
1977,2,7.2713459533775815,7.271345953377581,0.9893305540176623,0.9893305540176629,0,0,9.080194473266602,8.96096420288086,2,2
1977,3,6.846895321803242,6.846895321803241,0.9961674931370901,0.9961674931370906,0,0,9.541531562805176,8.96096420288086,3,3
1977,4,6.498573220791322,6.498573220791322,1.0057340893754323,1.005734089375432,0,0,10.305614471435547,8.96096420288086,4,4
1977,8,5.286247174523257,5.304821969847935,1.0296054401666894,1.029359016567585,1,1,11.050843238830566,8.96096420288086,7,7
1977,16,4.786098085771898,5.054551229307226,1.0354901508148375,1.0357938323741034,4,6,11.607522010803223,8.96096420288086,12,10
1977,32,4.188748221816937,4.969679619018485,1.0339272935999855,1.036782190235506,14,19,11.954243659973145,8.96096420288086,18,13
1977,64,3.3846920610522657,4.955234800468283,1.0186672175364249,1.0392441377911117,29,48,12.7763032913208,8.96096420288086,35,16
1977,128,2.154775480348575,4.95441962367219,1.004924828675854,1.0394880794539143,60,109,13.593238830566406,8.96096420288086,68,19
1978,1,8.955968365083194,8.955968365083196,0.9488903584837394,0.9488903584837416,0,0,9.081731796264648,9.081731796264648,1,1
1978,2,7.44394551992273,7.44394551992273,0.9825510881439347,0.982551088143936,0,0,9.765278816223145,9.081731796264648,2,2
1978,3,7.439118338495581,7.439118338495579,0.9827056462641992,0.9827056462642004,0,0,9.910137176513672,9.081731796264648,3,3
1978,4,7.029200033887621,7.030514084862537,0.9926197026791059,0.9926060569207977,1,1,10.641483306884766,9.081731796264648,3,3
1978,8,6.358480453179027,6.597157714015874,1.004704950622311,1.0050918059316944,2,2,10.896120071411133,9.081731796264648,6,6
1978,16,6.121508238759869,6.412805194954346,1.0076896922441088,1.0107986245619278,6,8,11.703704833984375,9.081731796264648,10,8
1978,32,4.75187608062855,5.946545242608501,1.0207578193757219,1.0246973023617407,13,20,11.976068496704102,9.081731796264648,19,12
1978,64,3.162929929744762,5.800218336780545,1.0154648575486607,1.0306714140876085,30,52,12.711258888244629,9.081731796264648,34,12
1978,128,2.087651481123247,5.733551588415524,1.0080175695554887,1.0331467190493357,63,110,13.255109786987305,9.081731796264648,65,18
1979,1,9.229134381273996,9.229134381273997,0.9288699493721917,0.9288699493721925,0,0,9.482657432556152,9.482657432556152,1,1
1979,2,8.923957795502115,8.923957795502115,0.9406482856935707,0.9406482856935712,0,0,10.280753135681152,9.482657432556152,2,2
1979,3,8.921929511110504,8.921929511110504,0.9409810013734949,0.9409810013734949,0,0,10.297901153564453,9.482657432556152,3,3
1979,4,8.845840182511306,8.846028686328534,0.9452934115669877,0.9453471593442047,1,1,10.698060035705566,9.482657432556152,3,3
1979,8,7.467928295615862,7.6376204936421175,0.9852626568677185,0.9841391206641747,3,3,10.974125862121582,9.482657432556152,5,5
1979,16,6.857936019614941,7.52722118985028,0.9942854581337575,0.9894405616405457,7,10,11.406595230102539,9.482657432556152,9,6
1979,32,6.108197865421382,7.420907697607233,0.9966546420328669,0.9938525884878977,14,24,11.747967720031738,9.482657432556152,18,8
1979,64,4.515314909899882,6.9830145963220795,0.994472238634678,1.0057259974149537,32,54,12.206417083740234,9.482657432556152,32,10
1979,128,2.9363989784368236,6.860365526289124,0.9978117197626232,1.0110526754174987,64,116,12.731639862060547,9.482657432556152,64,12
1980,1,9.19505463125172,9.19505463125172,0.9600429549336841,0.9600429549336846,0,0,9.270867347717285,9.270867347717285,1,1
1980,2,7.454187605028755,7.454187605028756,0.9973658749824171,0.9973658749824167,0,0,9.763781547546387,9.270867347717285,2,2
1980,3,7.0391782526697035,7.039178252669703,1.0058252794521727,1.0058252794521716,0,0,10.142292976379395,9.270867347717285,3,3
1980,4,6.942760523115115,6.942760523115115,1.0085972826651382,1.0085972826651368,0,0,10.28864860534668,9.270867347717285,4,4
1980,8,6.726009793326956,6.730896974403367,1.0133768775271572,1.013224539727147,2,2,10.600255012512207,9.270867347717285,6,6
1980,16,5.9615775573131735,6.11060043008767,1.0259224921773593,1.0252999282917943,4,7,11.275636672973633,9.270867347717285,12,9
1980,32,5.393720577483012,6.014773435517853,1.022692739466096,1.0263219452002317,10,22,11.81795883178711,9.270867347717285,22,10
1980,64,4.238616866665118,5.897634783287851,1.017717711748618,1.0282637666342813,29,51,12.210223197937012,9.270867347717285,35,13
1980,128,2.7137460334731576,5.667294701971152,1.0112351945736897,1.0312147982543185,52,110,12.625075340270996,9.270867347717285,76,18
1981,1,7.896521583926625,7.896521583926628,0.9676941127962674,0.9676941127962692,0,0,7.955060005187988,7.955060005187988,1,1
1981,2,7.083711836566477,7.083711836566477,0.9811280168273107,0.9811280168273118,0,0,8.294464111328125,7.955060005187988,2,2
1981,3,5.996813388507368,5.996813388507369,0.9952040351100357,0.9952040351100366,0,0,8.332263946533203,7.955060005187988,3,3
1981,4,5.690743661692361,5.690743661692359,1.0006798903421399,1.0006798903421412,0,0,8.678998947143555,7.955060005187988,4,4
1981,8,5.186670047961932,5.4326312287482015,1.0083611415052582,1.008039911695165,1,1,9.689674377441406,7.955060005187988,7,7
1981,16,4.751701280873214,5.391461602204696,1.0071856049178227,1.0107549661937218,6,5,10.183197975158691,7.955060005187988,10,11
1981,32,3.9840851611049994,4.977288119169302,1.0110118597845137,1.0201410782752611,17,21,10.785558700561523,7.955060005187988,15,11
1981,64,2.755380371458727,4.95434505770871,1.0033413970770892,1.0225618718130556,29,52,11.932900428771973,7.955060005187988,35,12
1981,128,1.6223799166980228,4.950892577882478,1.0005233036412209,1.023240177045685,61,115,12.855466842651367,7.955060005187988,67,13
1982,1,8.88650638560093,8.886506385600931,0.9376381393994397,0.9376381393994406,0,0,9.087495803833008,9.087495803833008,1,1
1982,2,7.153468235161416,7.153468235161414,0.9821257647544894,0.9821257647544892,0,0,9.148406982421875,9.087495803833008,2,2
1982,3,6.042210688892032,6.042210688892032,0.9979792380165611,0.9979792380165605,0,0,9.506608009338379,9.087495803833008,3,3
1982,4,6.038962131923619,6.038962131923619,0.998119624364541,0.9981196243645403,0,0,9.71971607208252,9.087495803833008,4,4
1982,8,5.759228246517716,5.771597959262588,1.006423552480991,1.0064407073631614,2,2,10.213172912597656,9.087495803833008,6,6
1982,16,5.5096322561099464,5.682746424931622,1.0084140442094778,1.010319808053971,6,7,10.380672454833984,9.087495803833008,10,9
1982,32,4.556756839554795,5.156354507260882,1.0170989892771347,1.022507118591236,15,18,10.91562271118164,9.087495803833008,17,14
1982,64,3.424310217006936,4.919651113952791,1.0163183798760589,1.0302572183973553,30,48,11.341154098510742,9.087495803833008,34,16
1982,128,2.1886637185014037,4.878664110875485,1.003067423061051,1.0303210345666072,62,112,11.84250259399414,9.087495803833008,66,16
1983,1,5.541920940618538,5.541920940618539,0.9802866948120122,0.9802866948120137,0,0,5.574677467346191,5.574677467346191,1,1
1983,2,4.878364006974871,4.878364006974872,0.9907661091021731,0.990766109102174,0,0,5.871086597442627,5.574677467346191,2,2
1983,3,3.843924080267271,3.8445305293266165,1.003052765397701,1.0029558233644869,1,1,6.095077037811279,5.574677467346191,2,2
1983,4,3.8434834532118853,3.8445305293266165,1.0030686453132684,1.002955823364487,2,2,6.208874702453613,5.574677467346191,2,2
1983,8,3.4599910936003195,3.590684733772962,1.0059195311444764,1.0054205315600333,3,3,6.857463836669922,5.574677467346191,5,5
1983,16,2.998018265293617,3.556655028560943,1.0058008116901513,1.0064749881078898,9,10,7.268723964691162,5.574677467346191,7,6
1983,32,2.375755967486412,3.5090645566263685,1.0056160721940546,1.0078311069392871,14,25,8.283905982971191,5.574677467346191,18,7
1983,64,1.7831417194688055,3.459891122673264,1.0012245031172624,1.0096007954251474,32,55,9.706908226013184,5.574677467346191,32,9
1983,128,1.078270800055938,3.454944132990778,0.9991813577307466,1.0105526161398284,63,118,11.368946075439453,5.574677467346191,65,10
1984,1,10.965148264126828,10.965148264126826,0.9333285021699729,0.9333285021699735,0,0,11.142481803894043,11.142481803894043,1,1
1984,2,9.659691330984018,9.659691330984018,0.9676723795992328,0.9676723795992332,0,0,12.393743515014648,11.142481803894043,2,2
1984,3,8.316656186848185,8.316656186848185,0.999117829657779,0.9991178296577794,0,0,12.765484809875488,11.142481803894043,3,3
1984,4,7.968786536962627,7.968786536962627,1.0115693879059966,1.0115693879059964,0,0,12.804778099060059,11.142481803894043,4,4
1984,8,7.907216322030254,7.946763385265649,1.0128038801686525,1.0124760063212803,1,1,13.099435806274414,11.142481803894043,7,7
1984,16,6.922746810819305,7.164093733148839,1.0341071105657262,1.0345653783826698,4,7,13.51282024383545,11.142481803894043,12,9
1984,32,6.188022968189554,7.139826489629615,1.0232854039038966,1.0364258974991594,16,19,14.286333084106445,11.142481803894043,16,13
1984,64,4.716324391374398,6.921557080034397,1.0263613200711854,1.0485410848486474,30,48,14.827569007873535,11.142481803894043,34,16
1984,128,3.086539728214326,6.776229384424392,1.01071618006844,1.0541563817146902,61,110,15.397012710571289,11.142481803894043,67,18
1985,1,8.997438616463906,8.997438616463912,0.9468126277163595,0.9468126277163617,0,0,9.136250495910645,9.136250495910645,1,1
1985,2,7.396508131077213,7.396508131077214,0.9838290871503053,0.9838290871503064,0,0,9.287660598754883,9.136250495910645,2,2
1985,3,7.051852160034275,7.051852160034276,0.9908670405169152,0.9908670405169164,0,0,9.716962814331055,9.136250495910645,3,3
1985,4,6.925602582360922,6.925602582360923,0.9947714035433679,0.9947714035433695,0,0,10.188475608825684,9.136250495910645,4,4
1985,8,6.265248536673727,6.405394996233182,1.0101311311018335,1.0096017300465345,2,2,10.97388744354248,9.136250495910645,6,6
1985,16,5.754866316852435,6.3873499744667015,1.0133662974818272,1.0118287717083696,6,8,11.40369987487793,9.136250495910645,10,8
1985,32,5.120064015097872,6.114748152788813,1.019348736266894,1.0219580264999866,17,24,11.82192325592041,9.136250495910645,15,8
1985,64,4.204904427511234,5.725976689811246,1.025358335070721,1.0329940372317252,30,54,12.601170539855957,9.136250495910645,34,10
1985,128,2.6340849289796027,5.673859238550156,1.0118357143516046,1.0347533565276934,65,115,13.322561264038086,9.136250495910645,63,13
1986,1,10.823048661947908,10.82304866194791,0.944889558014751,0.944889558014753,0,0,10.951164245605469,10.951164245605469,1,1
1986,2,10.096509705461697,10.096509705461699,0.961734815037437,0.9617348150374383,0,0,10.953784942626953,10.951164245605469,2,2
1986,3,9.313026888655932,9.313026888655934,0.9767246905843915,0.9767246905843927,0,0,11.08267879486084,10.951164245605469,3,3
1986,4,9.089606769637394,9.089759226003851,0.980694422931303,0.9807245000995182,1,1,11.307376861572266,10.951164245605469,3,3
1986,8,7.714501212429673,7.749756602223818,1.0060202930981148,1.0066629913303085,2,3,11.944445610046387,10.951164245605469,6,5
1986,16,7.038942729446558,7.4203277918366135,1.0182744601834763,1.0140076176153188,5,10,12.259515762329102,10.951164245605469,11,6
1986,32,6.1620992407933235,7.366620194065164,1.019230997078944,1.0177796112402744,17,22,12.578283309936523,10.951164245605469,15,10
1986,64,4.703907267572598,7.009672814397252,1.0214654613178697,1.0295055943281985,30,55,12.83089828491211,10.951164245605469,34,9
1986,128,3.1673100469383786,6.972956768585767,1.0137229434362027,1.031395906503624,60,116,13.01579761505127,10.951164245605469,68,12
1987,1,9.451412123483141,9.451412123483129,0.944110705296055,0.9441107052960578,0,0,9.603911399841309,9.603911399841309,1,1
1987,2,8.247199981983192,8.247199981983188,0.9751319255122257,0.9751319255122274,0,0,10.590030670166016,9.603911399841309,2,2
1987,3,7.546715787396885,7.546715787396885,0.9888680190439338,0.9888680190439356,0,0,10.635055541992188,9.603911399841309,3,3
1987,4,7.514050136497717,7.514050136497718,0.9896390262275745,0.9896390262275758,0,0,10.729954719543457,9.603911399841309,4,4
1987,8,6.9748346355430595,6.974943665544082,0.9988988546874569,0.9988600673264394,1,1,10.955818176269531,9.603911399841309,7,7
1987,16,6.197606775159077,6.773532428283136,1.0129247237981915,1.0063080402334006,5,8,11.431975364685059,9.603911399841309,11,8
1987,32,4.985696372902896,6.538382992968709,1.0165566057987694,1.0131957080043912,11,23,11.873027801513672,9.603911399841309,21,9
1987,64,3.231177945014329,6.400394176814378,1.0060307440857543,1.0183151988156407,34,53,12.300172805786133,9.603911399841309,30,11
1987,128,1.7765829994397704,6.181251773223388,0.99898517698748,1.0285291382304953,65,119,12.83470344543457,9.603911399841309,63,9
1988,1,5.969402753442862,5.969402753442864,0.9689588001533413,0.968958800153342,0,0,6.045696258544922,6.045696258544922,1,1
1988,2,4.694233475020874,4.694233475020874,0.9920367133738237,0.9920367133738227,0,0,6.660645484924316,6.045696258544922,2,2
1988,3,4.38018841505816,4.380188415058159,0.9953595128123794,0.9953595128123787,0,0,6.670425891876221,6.045696258544922,3,3
1988,4,4.357646312795972,4.357646312795972,0.9963956624944096,0.9963956624944089,0,0,6.771986484527588,6.045696258544922,4,4
1988,8,3.958345297851207,3.958345297851207,1.002684879820204,1.0026848798202035,0,0,7.248904228210449,6.045696258544922,8,8
1988,16,3.0893022137802357,3.9199525470653813,1.0035726036876542,1.0049485646131218,6,5,7.878819942474365,6.045696258544922,10,11
1988,32,2.697135959292355,3.8424606773850045,1.0038521746812985,1.0068940838687752,13,22,8.810696601867676,6.045696258544922,19,10
1988,64,1.9021237498512167,3.764103087322769,0.9986879446920457,1.0102017154762208,32,53,9.579923629760742,6.045696258544922,32,11
1988,128,0.9320399652607251,3.7632945520147754,1.0004495377008276,1.0105000628992364,58,115,10.459299087524414,6.045696258544922,70,13
1989,1,6.397441019602048,6.397441019602048,0.9774414527282749,0.9774414527282766,0,0,6.433355808258057,6.433355808258057,1,1
1989,2,5.1949479305195165,5.194947930519517,0.9942066019334017,0.994206601933403,0,0,6.989723205566406,6.433355808258057,2,2
1989,3,5.045524444004796,5.045524444004796,0.9977084504490445,0.9977084504490442,0,0,7.1914496421813965,6.433355808258057,3,3
1989,4,4.814183333796955,4.814183333796957,1.0024374157524725,1.0024374157524731,0,0,8.128435134887695,6.433355808258057,4,4
1989,8,4.442130324965572,4.4421303249655715,1.01215897772101,1.0121589777210112,0,0,8.681722640991211,6.433355808258057,8,8
1989,16,3.5330887457116806,4.050626065369351,1.013816342245873,1.0193378475326544,6,6,9.266374588012695,6.433355808258057,10,10
1989,32,3.254750848125455,4.011145125246512,1.0115251801579308,1.0198904533180528,15,21,9.65120792388916,6.433355808258057,17,11
1989,64,2.532640851570954,3.7653553118694822,1.008400481986369,1.0232273520294641,31,52,10.393457412719727,6.433355808258057,33,12
1989,128,1.3841062723914994,3.7039977264287653,1.0035782408666587,1.0252829842795377,62,116,10.950798034667969,6.433355808258057,66,12
1990,1,6.193776645061471,6.1937766450614715,0.9758185950515438,0.9758185950515453,0,0,6.235217571258545,6.235217571258545,1,1
1990,2,5.817532136692571,5.817532136692572,0.9865004346447122,0.986500434644713,0,0,8.457571029663086,6.235217571258545,2,2
1990,3,4.991031641613564,4.991031641613563,1.0023382937356893,1.0023382937356897,0,0,9.253007888793945,6.235217571258545,3,3
1990,4,4.836283735238304,4.836283735238304,1.006072121301916,1.0060721213019161,0,0,9.419437408447266,6.235217571258545,4,4
1990,8,4.451521799539702,4.656501881100303,1.0075637232244496,1.0107217682881489,2,2,10.112680435180664,6.235217571258545,6,6
1990,16,4.131579379797689,4.570838873369156,1.0100453951044452,1.0142507016315654,6,6,10.99232292175293,6.235217571258545,10,10
1990,32,3.6347699489223784,4.442662123523188,1.0119113410961056,1.018056116735309,13,20,11.312199592590332,6.235217571258545,19,12
1990,64,2.9717857439870303,4.4227691985195765,1.0080076795259365,1.0197060621073955,29,48,11.828670501708984,6.235217571258545,35,16
1990,128,1.4658344124994467,4.281278085450092,0.9995291837491032,1.0247371866952995,57,111,12.450191497802734,6.235217571258545,71,17
1991,1,11.264453587112172,11.264453587112174,0.9226723918758082,0.9226723918758108,0,0,11.497986793518066,11.497986793518066,1,1
1991,2,9.6554205535381,9.655420553538102,0.966702444137715,0.9667024441377163,0,0,12.303497314453125,11.497986793518066,2,2
1991,3,9.641730350053223,9.641730350053225,0.9677559606015499,0.9677559606015511,0,0,12.332053184509277,11.497986793518066,3,3
1991,4,9.100869338495668,9.10086933849567,0.986382223931964,0.9863822239319644,0,0,12.532172203063965,11.497986793518066,4,4
1991,8,8.322137109859609,8.33344003778647,1.0101068733475602,1.0110511827295523,2,2,13.13150405883789,11.497986793518066,6,6
1991,16,7.720019745970545,7.937776403363178,1.0175657802996338,1.0219846688400334,7,9,13.536087036132812,11.497986793518066,9,7
1991,32,6.7504178100709655,7.510964867494901,1.0322960587526306,1.033020823588582,12,21,13.946817398071289,11.497986793518066,20,11
1991,64,5.029159108892093,7.4873576878076245,1.0211159494585018,1.0351761311090426,31,48,14.43799114227295,11.497986793518066,33,16
1991,128,3.512435622660843,7.39695429683292,1.0059695165814115,1.041096035625757,66,107,14.96607780456543,11.497986793518066,62,21
1992,1,3.788976238636831,3.7889762386368226,0.9909097651634955,0.990909765163498,0,0,3.798729181289673,3.798729181289673,1,1
1992,2,3.686409984933467,3.686409984933466,0.994784459550187,0.9947844595501896,0,0,7.072616100311279,3.798729181289673,2,2
1992,3,3.584191835809575,3.5841918358095746,0.9999113955760017,0.9999113955760042,0,0,7.247862339019775,3.798729181289673,3,3
1992,4,3.5425964499934146,3.5425964499934146,1.0005072674298998,1.0005072674299014,0,0,7.453862190246582,3.798729181289673,4,4
1992,8,3.463765397377386,3.471364551187403,1.0024076683117404,1.0027304490751645,1,1,7.803991317749023,3.798729181289673,7,7
1992,16,3.1913300302497087,3.280767074939844,1.0058930299912323,1.0083632655503272,5,7,8.237239837646484,3.798729181289673,11,9
1992,32,2.8325745613759636,3.1448097714890073,1.0081245735200974,1.0095224501481064,15,20,8.79300594329834,3.798729181289673,17,12
1992,64,2.156901311498794,3.0845616719678968,1.0071159395331393,1.011549933997905,26,51,9.49770450592041,3.798729181289673,38,13
1992,128,1.349122774917018,3.043383485394094,1.0018545855503782,1.0131274833614987,59,110,10.34641170501709,3.798729181289673,69,18
1993,1,8.324000589179093,8.324000589179093,0.9558118902971682,0.9558118902971687,0,0,8.429603576660156,8.429603576660156,1,1
1993,2,7.719841940481058,7.719841940481058,0.9681464971203644,0.9681464971203642,0,0,8.93423080444336,8.429603576660156,2,2
1993,3,7.026223885996616,7.026223885996616,0.9829201394943292,0.9829201394943291,0,0,9.021218299865723,8.429603576660156,3,3
1993,4,6.304161381237276,6.304161381237277,0.9955315892509322,0.9955315892509324,0,0,9.088753700256348,8.429603576660156,4,4
1993,8,6.075198620153493,6.228829286452817,0.9983266996863034,0.9969752050476296,2,3,9.178640365600586,8.429603576660156,6,5
1993,16,5.637722704880872,5.995475865345815,1.0102406754303304,1.0051278564043216,6,7,9.714498519897461,8.429603576660156,10,9
1993,32,4.881028362214331,5.835844955939769,1.009832814137615,1.012244175393091,13,19,10.506711959838867,8.429603576660156,19,13
1993,64,3.392329336411528,5.824721597341418,1.0041818623951944,1.0133293028450927,29,47,11.168612480163574,8.429603576660156,35,17
1993,128,1.6197781676261405,5.477272072058277,1.0017368135943645,1.0265019545086747,64,113,12.043621063232422,8.429603576660156,64,15
1994,1,9.458435366081815,9.458435366081817,0.9475428271425511,0.9475428271425547,0,0,9.58618450164795,9.58618450164795,1,1
1994,2,8.852148906722455,8.852148906722455,0.966773844210568,0.966773844210571,0,0,10.709248542785645,9.58618450164795,2,2
1994,3,8.197551772643315,8.197551772643315,0.9825136258594589,0.9825136258594611,0,0,10.830907821655273,9.58618450164795,3,3
1994,4,8.017291458545849,8.01729145854585,0.9886265245862357,0.9886265245862375,0,0,11.055310249328613,9.58618450164795,4,4
1994,8,7.679592179010318,7.766532984503581,0.9987634062213666,0.9996733533281413,1,1,12.275209426879883,9.58618450164795,7,7
1994,16,6.965207755250206,7.340235181769238,1.0178640005312567,1.0189426276328448,5,8,13.129130363464355,9.58618450164795,11,8
1994,32,5.915766908078211,6.940999801982528,1.0312431230323171,1.0344591255402598,14,22,14.130585670471191,9.58618450164795,18,10
1994,64,4.256372990653821,6.833874857145439,1.019529028427736,1.0412391698038297,31,50,14.766077995300293,9.58618450164795,33,14
1994,128,2.9722900956085785,6.777755964385262,1.0142897707331464,1.047456736518392,61,108,15.412769317626953,9.58618450164795,67,20
1995,1,9.410962957636764,9.410962957636768,0.9417874496999364,0.941787449699941,0,0,9.569927215576172,9.569927215576172,1,1
1995,2,7.860271234014592,7.860271234014591,0.981496103023448,0.981496103023451,0,0,10.193185806274414,9.569927215576172,2,2
1995,3,7.196204254164717,7.1962042541647175,0.997342152070053,0.9973421520700556,0,0,10.335057258605957,9.569927215576172,3,3
1995,4,6.965933142624621,6.965933142624621,1.003189467453269,1.0031894674532715,0,0,10.395454406738281,9.569927215576172,4,4
1995,8,6.408060011997773,6.444017034224467,1.01752934368628,1.0174238559493967,1,1,10.897067070007324,9.569927215576172,7,7
1995,16,5.744147081041703,6.2333611715943205,1.0218853269057473,1.029291192658658,5,6,12.23196029663086,9.569927215576172,11,10
1995,32,4.999813877231616,6.229246243232132,1.0176706686201407,1.0299705171779283,15,20,12.78503704071045,9.569927215576172,17,12
1995,64,3.967519234298253,6.145380059380648,1.0108898912085302,1.0350535303207562,31,50,13.779595375061035,9.569927215576172,33,14
1995,128,2.8484480555127605,6.095528654437649,1.0033718775225924,1.0392077531312154,71,113,14.599279403686523,9.569927215576172,57,15
1996,1,10.650928597952015,10.650928597952015,0.9195131123218473,0.9195131123218486,0,0,10.926273345947266,10.926273345947266,1,1
1996,2,9.132869261290336,9.132869261290336,0.9643087074004133,0.9643087074004144,0,0,11.375670433044434,10.926273345947266,2,2
1996,3,8.898863586705414,8.898863586705414,0.9705517156083354,0.970551715608336,0,0,11.431883811950684,10.926273345947266,3,3
1996,4,8.168810338633966,8.168810338633966,0.9868569615428882,0.9868569615428896,0,0,11.47192096710205,10.926273345947266,4,4
1996,8,7.610565446465464,7.616392350698994,1.0007704551358803,1.0008471967515824,1,1,11.706058502197266,10.926273345947266,7,7
1996,16,7.535447659849494,7.613100896298682,0.9991942585564177,1.0012237743136352,7,6,12.455953598022461,10.926273345947266,9,10
1996,32,6.323698701243908,7.568728848756836,0.99305270836282,1.003316647593405,17,21,13.121240615844727,10.926273345947266,15,11
1996,64,5.292620969796239,7.294132079657968,1.0008242784846093,1.0192344714492148,31,51,13.728716850280762,10.926273345947266,33,13
1996,128,3.915922513708678,7.113781823809268,0.9946475428232956,1.0300803693883398,66,112,14.41210651397705,10.926273345947266,62,16
1997,1,5.760313450606647,5.760313450606649,0.9811062910082723,0.9811062910082742,0,0,5.789016246795654,5.789016246795654,1,1
1997,2,4.9493934961972315,4.9493934961972315,0.9909467896980224,0.9909467896980229,0,0,5.820918560028076,5.789016246795654,2,2
1997,3,4.167288749026875,4.167288749026875,1.0002090607546357,1.0002090607546357,0,0,6.04811429977417,5.789016246795654,3,3
1997,4,3.945774419166214,3.9457744191662134,1.0035652351250048,1.0035652351250053,0,0,6.307767868041992,5.789016246795654,4,4
1997,8,3.3810264539187718,3.4428705972497102,1.0112267858815065,1.0099974446930264,1,1,6.651185512542725,5.789016246795654,7,7
1997,16,3.045311448425395,3.2528586079941384,1.0119573413446408,1.0123071059065443,5,6,7.443043231964111,5.789016246795654,11,10
1997,32,2.802665977519799,3.169707366017502,1.010817716673532,1.0149588538199867,14,20,8.020249366760254,5.789016246795654,18,12
1997,64,1.8489562517603846,2.997575096890074,1.0062278575041588,1.0188603114681873,28,47,8.551631927490234,5.789016246795654,36,17
1997,128,1.0480902514403458,2.993070507800329,1.0004919903525555,1.0196301062268445,63,111,9.419007301330566,5.789016246795654,65,17
1998,1,10.41336821938278,10.413368219382782,0.9412924732606996,0.9412924732607021,0,0,10.55810546875,10.55810546875,1,1
1998,2,9.073696310921305,9.073696310921305,0.9731907095790775,0.9731907095790795,0,0,10.959393501281738,10.55810546875,2,2
1998,3,8.423657289408577,8.42365728940858,0.9876649478103414,0.9876649478103428,0,0,11.258228302001953,10.55810546875,3,3
1998,4,7.680670042561351,7.680670042561351,1.0048212822286167,1.004821282228618,0,0,11.299774169921875,10.55810546875,4,4
1998,8,7.13939941315295,7.201279786848917,1.015983669842827,1.0155361875945617,1,1,11.916810989379883,10.55810546875,7,7
1998,16,6.75546673994981,7.0422994459809,1.0267404030751655,1.0219680031334866,5,6,12.428393363952637,10.55810546875,11,10
1998,32,5.804094387832388,6.886551944508488,1.024755182197615,1.0272261332777313,13,22,13.061729431152344,10.55810546875,19,10
1998,64,4.539570282217433,6.8774178844831315,1.0123057251888852,1.0284938680353455,33,55,13.756093978881836,10.55810546875,31,9
1998,128,2.3382717978208114,6.846083275786395,1.0069155282950937,1.0312817153726166,63,116,14.48942756652832,10.55810546875,65,12
1999,1,8.153573160508188,8.15357316050818,0.9702554374032147,0.9702554374032187,0,0,8.202105522155762,8.202105522155762,1,1
1999,2,7.131965070837453,7.131965070837454,0.999960023068983,0.9999600230689851,0,0,10.287036895751953,8.202105522155762,2,2
1999,3,7.082268816527795,7.082268816527796,1.0012680901998385,1.0012680901998419,0,0,10.516439437866211,8.202105522155762,3,3
1999,4,7.023720528346027,7.023720528346026,1.004053058086083,1.004053058086085,0,0,10.999805450439453,8.202105522155762,4,4
1999,8,6.223880048364322,6.238203214512688,1.0239763146124505,1.0246761515014737,2,2,11.532787322998047,8.202105522155762,6,6
1999,16,5.673673557627412,5.886036092816103,1.034025176259262,1.0356739573821108,4,6,12.536062240600586,8.202105522155762,12,10
1999,32,5.1658962941955835,5.851020975700483,1.0289449727670963,1.039762452411301,13,19,13.379416465759277,8.202105522155762,19,13
1999,64,3.8160085257084857,5.63333483187879,1.0151183297496293,1.049002122764289,31,49,14.293598175048828,8.202105522155762,33,15
1999,128,2.6863154904018463,5.626968472360642,1.0123217912524416,1.0496371601377792,61,112,15.129934310913086,8.202105522155762,67,16
2000,1,8.825185469906804,8.825185469906806,0.950267163690312,0.9502671636903138,0,0,8.94900894165039,8.94900894165039,1,1
2000,2,7.026273848772521,7.026273848772521,0.9792703361441857,0.9792703361441865,0,0,9.337052345275879,8.94900894165039,2,2
2000,3,6.825818583966689,6.825818583966688,0.9848692677390255,0.9848692677390256,0,0,9.405445098876953,8.94900894165039,3,3
2000,4,6.543101510636312,6.543101510636313,0.9892142836888174,0.989214283688818,0,0,9.477200508117676,8.94900894165039,4,4
2000,8,6.286554089944801,6.287119972093943,0.9963613180240591,0.9964213060932943,1,1,10.573389053344727,8.94900894165039,7,7
2000,16,5.804999575346491,5.990747929074567,1.0059306804362809,1.0070451128427738,4,6,11.043988227844238,8.94900894165039,12,10
2000,32,4.686230334833049,5.9136707924297,1.0034916549948258,1.0112346494055773,15,20,11.470969200134277,8.94900894165039,17,12
2000,64,3.706080763330499,5.875689424139679,0.9980985683058381,1.0133945809118898,32,52,12.429006576538086,8.94900894165039,32,12
2000,128,2.021144817552399,5.602823380807625,0.9985450536445777,1.020052455622424,61,112,13.158525466918945,8.94900894165039,67,16
2001,1,9.37864006816321,9.378640068163211,0.9358500816177108,0.9358500816177117,0,0,9.57243824005127,9.57243824005127,1,1
2001,2,7.667210466672767,7.667210466672795,0.9768738564511669,0.9768738564511665,0,0,9.83552360534668,9.57243824005127,2,2
2001,3,7.508076985786704,7.508076985786704,0.9815331509145491,0.9815331509145481,0,0,10.192420959472656,9.57243824005127,3,3
2001,4,6.683800158831908,6.6838001588319065,0.9978211925414029,0.9978211925414013,0,0,10.44752025604248,9.57243824005127,4,4
2001,8,6.248348662285655,6.256075404047453,1.0078195704856754,1.0078794155740787,2,2,10.578012466430664,9.57243824005127,6,6
2001,16,5.513525677269114,5.790994609224854,1.0260021507476866,1.0220777542969397,3,4,11.275789260864258,9.57243824005127,13,12
2001,32,5.025061530568096,5.747382739150425,1.0253361826286773,1.0237717587168058,12,20,11.692614555358887,9.57243824005127,20,12
2001,64,3.9923906979257784,5.638645294727246,1.0229037016749278,1.0295701905119774,31,49,12.435546875,9.57243824005127,33,15
2001,128,2.738527931211865,5.554781958745236,1.0092684787954338,1.0339810970568912,61,110,13.359411239624023,9.57243824005127,67,18
2002,1,4.540501655745324,4.5405016557453255,0.9885415362577695,0.9885415362577709,0,0,4.5538482666015625,4.5538482666015625,1,1
2002,2,4.314116945691797,4.314116945691797,0.9913672280300727,0.9913672280300738,0,0,5.592092514038086,4.5538482666015625,2,2
2002,3,3.9656270749195652,3.9656270749195657,0.9973342517085089,0.9973342517085098,0,0,5.855968952178955,4.5538482666015625,3,3
2002,4,3.6213203098317464,3.621320309831746,1.0025480924150716,1.0025480924150725,0,0,6.0216779708862305,4.5538482666015625,4,4
2002,8,3.267927383066381,3.269675153827692,1.0080749211669482,1.0079714817846814,2,2,6.412454128265381,4.5538482666015625,6,6
2002,16,2.5478201670919844,2.9043969254518305,1.0088123721441806,1.0120284912806565,6,6,7.018064975738525,4.5538482666015625,10,10
2002,32,2.3465010273789164,2.8674894224479828,1.007920835333101,1.0138871532761708,11,23,7.669081211090088,4.5538482666015625,21,9
2002,64,1.7856844942972812,2.8674894224479828,1.0019754595260413,1.0138871532761708,26,55,8.222502708435059,4.5538482666015625,38,9
2002,128,0.9968222824358491,2.8210057667994723,1.0009164935658685,1.0157865222740794,66,116,9.063224792480469,4.5538482666015625,62,12
2003,1,11.579651246699536,11.579651246699534,0.9205111559617339,0.9205111559617352,0,0,11.810447692871094,11.810447692871094,1,1
2003,2,9.770822600776379,9.770822600776377,0.9702125918716955,0.9702125918716962,0,0,12.075594902038574,11.810447692871094,2,2
2003,3,8.353571552644542,8.353571552644542,1.001348098553204,1.0013480985532042,0,0,12.313809394836426,11.810447692871094,3,3
2003,4,8.22252931663593,8.22252931663593,1.0030293848874963,1.003029384887495,0,0,12.415790557861328,11.810447692871094,4,4
2003,8,8.112135975450236,8.20004303104355,1.0052878868014983,1.0051364150151785,2,2,13.35759449005127,11.810447692871094,6,6
2003,16,7.45952889416449,7.977614528021366,1.0081158996207926,1.0154216440289718,7,10,14.202258110046387,11.810447692871094,9,6
2003,32,6.223141638705669,7.745310795254084,1.017105053199574,1.03006894801349,15,22,14.980875968933105,11.810447692871094,17,10
2003,64,5.155341203371591,7.538743526564852,1.0237494960050406,1.043828709680776,33,50,15.552082061767578,11.810447692871094,31,14
2003,128,3.150286008079395,7.527018475969287,1.0038906587238599,1.0460707854450926,65,112,16.31438446044922,11.810447692871094,63,16
2004,1,8.074171722435652,8.074171722435652,0.9677498773006591,0.9677498773006601,0,0,8.133649826049805,8.133649826049805,1,1
2004,2,6.640908926494263,6.640908926494263,0.9954266700483297,0.9954266700483304,0,0,8.824825286865234,8.133649826049805,2,2
2004,3,6.1010770915382455,6.1010770915382455,1.0073849890926998,1.0073849890927002,0,0,9.894073486328125,8.133649826049805,3,3
2004,4,5.448287269252634,5.448287269252634,1.0175900384505125,1.0175900384505132,0,0,10.089896202087402,8.133649826049805,4,4
2004,8,5.086241948297914,5.10220777368375,1.0214942417303108,1.0232042263185375,2,2,10.639124870300293,8.133649826049805,6,6
2004,16,4.800118709461867,5.057370520663429,1.0235556717577454,1.023730070657544,7,8,10.921582221984863,8.133649826049805,9,8
2004,32,4.606162762474957,5.009488823458211,1.0240263095902127,1.0249112379886964,14,23,11.22596549987793,8.133649826049805,18,9
2004,64,3.840711782362937,4.9725359905074455,1.0143743427375589,1.026729065309652,30,53,11.517078399658203,8.133649826049805,34,11
2004,128,2.0598202759068474,4.942699982131915,1.0023169276430228,1.028308812140306,62,116,11.804125785827637,8.133649826049805,66,12
2005,1,8.698287750993652,8.698287750993654,0.9518189176511318,0.9518189176511348,0,0,8.814810752868652,8.814810752868652,1,1
2005,2,6.781463497212759,6.781463497212741,0.9888868026879248,0.9888868026879281,0,0,8.985784530639648,8.814810752868652,2,2
2005,3,6.5457920766605255,6.545792076660525,0.9896658590431711,0.9896658590431715,0,0,9.059452056884766,8.814810752868652,3,3
2005,4,5.831112829942905,5.831112829942905,1.0021695484424527,1.002169548442454,0,0,9.107394218444824,8.814810752868652,4,4
2005,8,5.41619596010682,5.418191748160796,1.0117711976035746,1.0119488686166243,1,1,9.814384460449219,8.814810752868652,7,7
2005,16,4.882233166616381,4.97458053662916,1.0185668894331448,1.021088977275842,4,7,10.481743812561035,8.814810752868652,12,9
2005,32,4.04989774002637,4.888832611679507,1.01630276125775,1.0250477302476644,11,19,11.142199516296387,8.814810752868652,21,13
2005,64,2.9868961376516885,4.691898936128732,1.0109536438975102,1.028067248052709,27,48,11.91140365600586,8.814810752868652,37,16
2005,128,1.694719187736734,4.682250880523035,1.0025411600440972,1.029142577410682,66,109,12.726806640625,8.814810752868652,62,19
2006,1,9.12126106604977,9.121261066049776,0.9509606709288793,0.9509606709288831,0,0,9.236215591430664,9.236215591430664,1,1
2006,2,8.700099204160006,8.700099204160008,0.9680019388436731,0.9680019388436752,0,0,11.545537948608398,9.236215591430664,2,2
2006,3,8.3357054260949,8.335705426094899,0.9803433734581468,0.9803433734581478,0,0,12.16684341430664,9.236215591430664,3,3
2006,4,8.16061694629327,8.160616946293272,0.9905759358065254,0.9905759358065259,0,0,12.42638874053955,9.236215591430664,4,4
2006,8,7.5687924074391635,7.625530407131219,1.0030033060934342,1.0059963815934299,2,2,12.808388710021973,9.236215591430664,6,6
2006,16,6.490633695232801,7.23941150676279,1.017760798837179,1.0181846551549967,4,7,13.321861267089844,9.236215591430664,12,9
2006,32,5.50115213675274,6.516847367906863,1.0389748002056869,1.0414316967629946,17,23,14.132401466369629,9.236215591430664,15,9
2006,64,4.010874001701481,6.453844904295701,1.0249578730853741,1.0450820183524046,27,52,15.208788871765137,9.236215591430664,37,12
2006,128,2.6724807206294634,6.349728552131315,1.0098108648514905,1.0522603488138715,61,110,15.992860794067383,9.236215591430664,67,18
2007,1,4.096669194379517,4.096669194379518,0.988510183720581,0.9885101837205817,0,0,4.111939907073975,4.111939907073975,1,1
2007,2,3.665191746371913,3.665191746371913,0.9958488242237458,0.9958488242237464,0,0,4.891791820526123,4.111939907073975,2,2
2007,3,3.5130247163727435,3.513024716372744,0.9982592646696697,0.99825926466967,0,0,5.014292240142822,4.111939907073975,3,3
2007,4,3.512320647683306,3.5123206476833064,0.9983321053592731,0.9983321053592736,0,0,5.182520866394043,4.111939907073975,4,4
2007,8,2.832235348876593,2.868676670758057,1.0032890247874504,1.0035529204258649,3,3,5.908758640289307,4.111939907073975,5,5
2007,16,1.9854907897787635,2.3157406470192474,1.0037580345527424,1.0048522451302506,5,8,6.204031944274902,4.111939907073975,11,8
2007,32,1.51591504720066,2.2159353049143853,1.0035077409567215,1.0068031917812146,13,22,6.889962673187256,4.111939907073975,19,10
2007,64,0.9143280642214876,1.9958808831483688,1.001444766428495,1.0099411694671945,27,54,7.730978012084961,4.111939907073975,37,10
2007,128,0.3457253496047474,1.9936822639961744,1.0001385285070732,1.0103458104516743,66,116,8.64006233215332,4.111939907073975,62,12
2008,1,6.917410461567854,6.917410461567855,0.9767764203771613,0.9767764203771624,0,0,6.953019142150879,6.953019142150879,1,1
2008,2,6.477234277913067,6.477234277913067,0.9828833434499522,0.9828833434499529,0,0,7.111769676208496,6.953019142150879,2,2
2008,3,5.729880279839936,5.729880279839935,0.9934923423408195,0.9934923423408198,0,0,7.133915424346924,6.953019142150879,3,3
2008,4,5.432616448235634,5.432616448235634,0.9969515454638391,0.9969515454638396,0,0,7.408708572387695,6.953019142150879,4,4
2008,8,4.802305182412918,4.918224677364219,1.0052319471330442,1.0037385197716775,2,3,7.5743408203125,6.953019142150879,6,5
2008,16,4.413447149421727,4.725206679026325,1.0084200339750042,1.0087059358138863,6,7,8.693807601928711,6.953019142150879,10,9
2008,32,3.7492326912593046,4.70229043872774,1.010954770022492,1.0102441236522872,17,21,9.3273286819458,6.953019142150879,15,11
2008,64,2.2212156118477706,4.525990850388767,1.0020859666783484,1.0135695910736353,32,54,9.832432746887207,6.953019142150879,32,10
2008,128,1.052532068134833,4.474938899474855,0.998877709761552,1.016458257943996,62,114,10.448111534118652,6.953019142150879,66,14
2009,1,11.253859800895574,11.253859800895555,0.9032985822273909,0.9032985822273929,0,0,11.629071235656738,11.629071235656738,1,1
2009,2,9.837063990875585,9.837063990875588,0.9414493810007569,0.9414493810007583,0,0,11.7293062210083,11.629071235656738,2,2
2009,3,9.288891361865803,9.288891361865804,0.9575262304956486,0.9575262304956498,0,0,11.80391788482666,11.629071235656738,3,3
2009,4,9.275528817071862,9.275528817071862,0.957968270371848,0.9579682703718488,0,0,12.119519233703613,11.629071235656738,4,4
2009,8,7.866734898984497,7.995336111860102,1.0042174272786375,1.0024288154403695,2,2,12.711202621459961,11.629071235656738,6,6
2009,16,7.543087111447047,7.927058666004188,1.0084723063992533,1.0056282399777348,6,7,13.273933410644531,11.629071235656738,10,9
2009,32,6.418422883893481,7.484228476319179,1.0200300511863096,1.0207737472076075,14,20,13.631616592407227,11.629071235656738,18,12
2009,64,4.890628967974691,7.400318943019911,1.0079381817522255,1.0266526984282023,32,50,14.206302642822266,11.629071235656738,32,14
2009,128,3.0384229117035115,7.125226166273277,1.0055320188086787,1.0377220105077496,72,113,14.694839477539062,11.629071235656738,56,15
2010,1,6.755473293583016,6.755473293583017,0.9777358378159478,0.9777358378159503,0,0,6.788738250732422,6.788738250732422,1,1
2010,2,5.871244161909577,5.871244161909578,0.992040364059813,0.9920403640598146,0,0,7.755270957946777,6.788738250732422,2,2
2010,3,5.853639047479503,5.8536390474795015,0.9921227315084232,0.9921227315084244,0,0,8.170023918151855,6.788738250732422,3,3
2010,4,5.8528944980475535,5.853639047479502,0.9919231689657797,0.9921227315084244,1,1,9.010932922363281,6.788738250732422,3,3
2010,8,5.674452184086825,5.778778322053607,0.9958786851685726,0.9953438200907052,3,2,9.46066665649414,6.788738250732422,5,6
2010,16,5.2646293812868015,5.733316251106752,0.9962454925518451,0.9982521138999902,5,11,10.037809371948242,6.788738250732422,11,5
2010,32,3.6295199762014683,5.529628744700067,1.001344700297246,1.007820914588823,16,23,10.713635444641113,6.788738250732422,16,9
2010,64,2.351099178859036,5.453745622773074,1.001407188865388,1.0108478923436457,29,52,11.350706100463867,6.788738250732422,35,12
2010,128,1.2803291910559453,5.45165094244937,1.000019237108472,1.0115344699003925,58,115,12.339799880981445,6.788738250732422,70,13
2011,1,10.821080993290302,10.821080993290305,0.9269048947084925,0.9269048947084976,0,0,11.041642189025879,11.041642189025879,1,1
2011,2,9.354768241271094,9.354768241271096,0.9638224390705354,0.9638224390705397,0,0,11.861517906188965,11.041642189025879,2,2
2011,3,8.476230487035448,8.47623048703545,0.9852200386858181,0.9852200386858203,0,0,12.057546615600586,11.041642189025879,3,3
2011,4,7.2908150778221215,7.2908150778221215,1.013073874047238,1.0130738740472407,0,0,12.253840446472168,11.041642189025879,4,4
2011,8,6.861768048580854,7.049543477193365,1.0252452965645689,1.0219189371742312,1,1,12.649161338806152,11.041642189025879,7,7
2011,16,6.146898044882865,6.484232191183354,1.0366348781771852,1.034614400503124,6,8,13.394789695739746,11.041642189025879,10,8
2011,32,5.516524568705504,6.476238825555417,1.0158366273390178,1.0359403138585304,17,22,15.00970458984375,11.041642189025879,15,10
2011,64,4.539341247421963,6.419712286129676,1.0136436541623692,1.0423029188785509,33,53,16.029695510864258,11.041642189025879,31,11
2011,128,3.1581195943715175,6.390222304559623,1.0013377310315095,1.0472227822187263,63,113,17.34890365600586,11.041642189025879,65,15
2012,1,8.321717929340826,8.321717929340826,0.9477670463213106,0.9477670463213117,0,0,8.469338417053223,8.469338417053223,1,1
2012,2,7.349347727468153,7.349347727468153,0.9736007378415208,0.9736007378415221,0,0,9.492683410644531,8.469338417053223,2,2
2012,3,7.235263817297664,7.235263817297664,0.9787024915819215,0.9787024915819222,0,0,10.292502403259277,8.469338417053223,3,3
2012,4,7.16821110043147,7.168211100431469,0.9817135892033446,0.9817135892033458,0,0,10.49209976196289,8.469338417053223,4,4
2012,8,6.604956804007159,6.637341875243634,0.992883556018488,0.9927019332628502,3,2,10.957864761352539,8.469338417053223,5,6
2012,16,6.0477427940900705,6.440684049537228,1.0011884014782588,1.0016397953829226,7,7,11.49290943145752,8.469338417053223,9,9
2012,32,5.549763400314821,6.164777575329733,1.0068284811854142,1.0113826550194074,14,21,12.138540267944336,8.469338417053223,18,11
2012,64,4.08376705388298,6.014411266940171,1.0000086376759452,1.0200155466394203,31,49,12.74779224395752,8.469338417053223,33,15
2012,128,2.7049669721397462,5.954864590015738,0.9988914163935568,1.0257232108249958,54,111,13.47391128540039,8.469338417053223,74,17
2013,1,10.253586234992701,10.253586234992703,0.9304025121948333,0.9304025121948348,0,0,10.45980167388916,10.45980167388916,1,1
2013,2,8.892970055163211,8.892970055163213,0.96114587232992,0.9611458723299209,0,0,10.497323989868164,10.45980167388916,2,2
2013,3,8.76872137954705,8.768721379547049,0.9619101702803754,0.961910170280374,0,0,10.615513801574707,10.45980167388916,3,3
2013,4,8.38172328491517,8.38172328491517,0.9705257739396358,0.9705257739396347,0,0,10.900156021118164,10.45980167388916,4,4
2013,8,7.902425373646673,7.9030926835877064,0.9862491505091899,0.9864295714892177,1,1,11.345192909240723,10.45980167388916,7,7
2013,16,7.590022263188807,7.6820441826350345,0.9929916100176508,0.994421739733116,7,8,11.819904327392578,10.45980167388916,9,8
2013,32,6.683435244495383,7.496781927914831,0.9938732430129746,1.0020631140676548,13,22,12.426651000976562,10.45980167388916,19,10
2013,64,5.412279434795132,7.35494697835771,0.9996096544260089,1.0089415788305063,29,51,12.820666313171387,10.45980167388916,35,13
2013,128,3.8153147621378816,7.187929882407269,0.9926390308819375,1.0147242289840022,60,114,13.382540702819824,10.45980167388916,68,14
2014,1,9.437648615222155,9.437648615222157,0.9438235257409906,0.9438235257409908,0,0,9.59113883972168,9.59113883972168,1,1
2014,2,7.874653055642045,7.874653055642045,0.9794770792330858,0.9794770792330849,0,0,10.321418762207031,9.59113883972168,2,2
2014,3,7.866330443048207,7.874653055642045,0.9792005300133817,0.9794770792330849,1,1,10.332094192504883,9.59113883972168,2,2
2014,4,7.850977824065996,7.874653055642045,0.9789462155394189,0.9794770792330849,2,2,10.392903327941895,9.59113883972168,2,2
2014,8,7.407249743280715,7.539885031676802,0.9915047781026634,0.9906946580846283,2,2,10.722464561462402,9.59113883972168,6,6
2014,16,6.521561401919267,6.937125860082981,1.0083380821100978,1.00466438851536,7,10,10.98962116241455,9.59113883972168,9,6
2014,32,5.460214050819182,6.650163169956975,1.0220082962165356,1.015039049897105,12,22,11.419351577758789,9.59113883972168,20,10
2014,64,3.9206289699210544,6.506765450600586,1.0141091010107395,1.0200579583869747,33,52,11.916661262512207,9.59113883972168,31,12
2014,128,2.0882734898007236,6.167081102083719,1.0058733347470203,1.0325117143401756,65,115,12.302087783813477,9.59113883972168,63,13
2015,1,10.320844798752512,10.320844798752514,0.9333379109564154,0.9333379109564173,0,0,10.511035919189453,10.511035919189453,1,1
2015,2,8.744524111260409,8.744524111260406,0.9661824530340799,0.9661824530340803,0,0,11.126153945922852,10.511035919189453,2,2
2015,3,8.542097285889842,8.542097285889843,0.9751141446728205,0.9751141446728199,0,0,11.373493194580078,10.511035919189453,3,3
2015,4,8.510851931706592,8.510851931706592,0.9765916031705564,0.9765916031705552,0,0,11.39383602142334,10.511035919189453,4,4
2015,8,7.456294782776373,7.456779717014755,1.0120468398477274,1.012039396554341,1,1,12.118958473205566,10.511035919189453,7,7
2015,16,6.90647803126925,6.988912873531969,1.0243597294479698,1.0233033452398725,2,3,12.353666305541992,10.511035919189453,14,13
2015,32,5.9441610484889065,6.494552940121204,1.034690311059723,1.0355484829153476,14,17,13.060657501220703,10.511035919189453,18,15
2015,64,4.861768155127339,6.306671461860891,1.0246510538444689,1.0429525817879703,30,46,13.568731307983398,10.511035919189453,34,18
2015,128,3.3200275967253017,6.200445240302768,1.015180364077858,1.0483209422854638,65,107,14.278260231018066,10.511035919189453,63,21
2016,1,8.490957092003294,8.490957092003294,0.9547786856320082,0.9547786856320106,0,0,8.596634864807129,8.596634864807129,1,1
2016,2,6.726061084840839,6.72606108484084,0.9876450032729371,0.9876450032729398,0,0,8.789468765258789,8.596634864807129,2,2
2016,3,6.191771798495601,6.1917717984956,0.994358841611398,0.9943588416113991,0,0,9.009833335876465,8.596634864807129,3,3
2016,4,6.004667007887166,6.004667007887166,0.998133428622571,0.9981334286225729,0,0,9.092269897460938,8.596634864807129,4,4
2016,8,5.542256790547641,5.637376217043139,1.003767990255848,1.0030456834996764,1,2,9.32695198059082,8.596634864807129,7,6
2016,16,5.1444225826022585,5.401138701103622,1.0104562863014246,1.0074722192849874,3,5,9.592325210571289,8.596634864807129,13,11
2016,32,4.559712453090993,5.34858126906913,1.0130880486371252,1.009635178028414,13,19,10.065837860107422,8.596634864807129,19,13
2016,64,3.077701949063319,5.206784783597164,1.0081626480666088,1.0146687432713017,31,49,10.708120346069336,8.596634864807129,33,15
2016,128,1.7755253287747106,5.107640425906545,0.9996083324934142,1.0201453396805868,62,111,11.379400253295898,8.596634864807129,66,17
2017,1,9.605838971543035,9.605838971543033,0.9366795260536869,0.9366795260536871,0,0,9.798291206359863,9.798291206359863,1,1
2017,2,8.852060123681392,8.852060123681392,0.9535410077354503,0.9535410077354497,0,0,9.8582763671875,9.798291206359863,2,2
2017,3,7.838331324707285,7.838331324707285,0.9814409343141031,0.981440934314103,0,0,10.227849960327148,9.798291206359863,3,3
2017,4,7.535069794712365,7.535069794712366,0.9885500233037554,0.9885500233037559,0,0,10.674286842346191,9.798291206359863,4,4
2017,8,6.982252032876449,7.018623910087453,1.0035815681941298,1.0028355960244277,2,2,10.86268424987793,9.798291206359863,6,6
2017,16,6.125296126018914,6.368301066837942,1.014922046219703,1.0152450457035906,5,7,11.413827896118164,9.798291206359863,11,9
2017,32,4.864220546086916,6.2734826296621575,1.0155369855254952,1.0186490316297552,11,22,11.84276008605957,9.798291206359863,21,10
2017,64,3.7695524577650916,6.121094090725181,1.0100726326970264,1.0233549434786604,33,50,12.190827369689941,9.798291206359863,31,14
2017,128,2.3211051308984136,5.997736601923501,1.0064444065698397,1.028885439020974,64,112,12.618338584899902,9.798291206359863,64,16
2018,1,7.556809018316814,7.556809018316815,0.9622318741717933,0.9622318741717946,0,0,7.645247459411621,7.645247459411621,1,1
2018,2,6.984288385630902,6.984288385630902,0.9773699128532395,0.9773699128532398,0,0,8.76436996459961,7.645247459411621,2,2
2018,3,6.589789152718425,6.589789152718425,0.9850151416589028,0.985015141658903,0,0,9.357552528381348,7.645247459411621,3,3
2018,4,6.56159327851145,6.561593278511449,0.9864485766121228,0.9864485766121229,0,0,9.830738067626953,7.645247459411621,4,4
2018,8,6.287799734395182,6.40351860379717,0.9895261374143602,0.9912581579333148,3,3,10.031436920166016,7.645247459411621,5,5
2018,16,5.872900370332987,6.246125187921346,0.9971601798620864,0.9967354981857783,8,10,10.336277961730957,7.645247459411621,8,6
2018,32,5.4888928241019235,6.199858950790822,0.9961801040175079,0.9980960637593853,14,25,10.539788246154785,7.645247459411621,18,7
2018,64,4.69608494066223,6.174878974334298,0.9958842301091297,0.9995951652166792,30,56,10.74601936340332,7.645247459411621,34,8
2018,128,3.286242196010736,6.174878974334298,0.9901071711028919,0.9995951652166792,63,120,10.947245597839355,7.645247459411621,65,8
2019,1,9.260134839357937,9.260134839357935,0.9488636072711132,0.9488636072711144,0,0,9.38833236694336,9.38833236694336,1,1
2019,2,8.141473649134872,8.141473649134872,0.9686436417203954,0.9686436417203952,0,0,9.795007705688477,9.38833236694336,2,2
2019,3,7.8667090372171975,7.866709037217197,0.9787832948096931,0.9787832948096927,0,0,10.371914863586426,9.38833236694336,3,3
2019,4,7.761465199305765,7.761465199305765,0.9823662349534396,0.9823662349534387,0,0,10.468378067016602,9.38833236694336,4,4
2019,8,7.2239680874614765,7.230533609792495,0.995434543233548,0.9956900124072987,2,2,10.64755630493164,9.38833236694336,6,6
2019,16,6.668444937368389,6.877566887517752,1.0021425069625818,1.0028721011657953,7,7,10.953929901123047,9.38833236694336,9,9
2019,32,5.60762652259646,6.31066465343448,1.0160224767685442,1.0175908740601993,14,21,11.165153503417969,9.38833236694336,18,11
2019,64,4.582501697841213,6.195093588676215,1.0081240797571889,1.0211650820063962,27,50,11.605009078979492,9.38833236694336,37,14
2019,128,2.651730823081165,6.005435091161107,1.0077648551485714,1.0322625440214022,63,108,12.076112747192383,9.38833236694336,65,20
2020,1,9.614294190514817,9.61429419051482,0.9334604048131189,0.9334604048131201,0,0,9.832059860229492,9.832059860229492,1,1
2020,2,9.096224260375854,9.096224260375854,0.9467456026518102,0.9467456026518111,0,0,9.980926513671875,9.832059860229492,2,2
2020,3,8.718850617185083,8.718850617185087,0.9551180032444917,0.9551180032444925,0,0,10.053044319152832,9.832059860229492,3,3
2020,4,8.718845654767811,8.718850617185087,0.955105876583787,0.9551180032444925,1,1,10.071558952331543,9.832059860229492,3,3
2020,8,8.364869870111999,8.521931173946099,0.9601926851669684,0.9594646597646626,2,4,10.235092163085938,9.832059860229492,6,4
2020,16,7.487844499723595,8.34018093903397,0.9783436308865201,0.9673335296627117,5,9,10.571213722229004,9.832059860229492,11,7
2020,32,6.49025701697394,8.246512318271815,0.9847728732399748,0.9709304306175691,13,23,10.749274253845215,9.832059860229492,19,9
2020,64,4.511185945029919,7.654665585556089,1.0010456961786793,0.9888099161608455,29,58,11.029703140258789,9.832059860229492,35,6
2020,128,2.692548236360371,7.126356794009883,1.0022360193640258,1.0024260407149614,60,121,11.274765968322754,9.832059860229492,68,7
2021,1,11.687203702655628,11.687203702655628,0.9090201895245051,0.9090201895245072,0,0,11.991450309753418,11.991450309753418,1,1
2021,2,10.326422241203028,10.32642224120303,0.9463893788148756,0.9463893788148773,0,0,12.236663818359375,11.991450309753418,2,2
2021,3,10.106767066801229,10.106767066801229,0.9538984960115677,0.9538984960115684,0,0,12.959668159484863,11.991450309753418,3,3
2021,4,8.928027544751197,8.928027544751197,0.9859519560219019,0.9859519560219014,0,0,13.047934532165527,11.991450309753418,4,4
2021,8,8.644679842830033,8.648402895866584,0.9960164448705796,0.9961500003940855,1,1,13.767741203308105,11.991450309753418,7,7
2021,16,7.842307787542988,8.420897161308561,1.0074596248664898,1.0067788610886392,5,9,14.462890625,11.991450309753418,11,7
2021,32,6.546292536275256,8.420897161308561,1.005543129560081,1.0067788610886392,15,25,15.060833930969238,11.991450309753418,17,7
2021,64,5.470132265540332,8.304384152831984,1.0122799192995218,1.0162934261827066,34,52,15.91121768951416,11.991450309753418,30,12
2021,128,3.639043121286882,8.19084449727592,1.0025210594674698,1.0234188277294616,63,118,16.67908477783203,11.991450309753418,65,10
2022,1,7.530562679870643,7.530562679870645,0.9708373975698574,0.970837397569858,0,0,7.58236026763916,7.58236026763916,1,1
2022,2,6.319887793116421,6.319887793116421,0.9885823388456714,0.988582338845671,0,0,7.605690002441406,7.58236026763916,2,2
2022,3,5.790424772527927,5.790424772527927,0.9978047096129566,0.9978047096129561,0,0,7.6871771812438965,7.58236026763916,3,3
2022,4,5.703223642907596,5.703223642907596,0.9994338947364272,0.9994338947364256,0,0,7.713235378265381,7.58236026763916,4,4
2022,8,5.155434367232705,5.197432399629007,1.0072125492084183,1.0065155264609371,1,1,8.114697456359863,7.58236026763916,7,7
2022,16,4.659237637383638,5.006964776469821,1.0119097385395963,1.009861631184427,7,8,8.50573444366455,7.58236026763916,9,8
2022,32,3.693020366152922,4.534672846717186,1.0135186085296053,1.0174019496733469,14,20,9.129201889038086,7.58236026763916,18,12
2022,64,2.360025278142503,4.4708137434572235,1.0093756473902578,1.0206404331531478,29,48,9.657275199890137,7.58236026763916,35,16
2022,128,1.2028071594447736,4.383720895584051,1.0032128435860233,1.0232179145409595,66,109,10.322168350219727,7.58236026763916,62,19
2023,1,2.5293126930957466,2.529312693095747,0.9959636191838092,0.9959636191838094,0,0,2.532440185546875,2.532440185546875,1,1
2023,2,2.327507789889198,2.3275077898891974,0.9945546360955155,0.9945546360955169,0,0,2.567034959793091,2.532440185546875,2,2
2023,3,2.2448252115965297,2.2448252115965297,0.995846029181916,0.9958460291819173,0,0,2.7064547538757324,2.532440185546875,3,3
2023,4,2.063406188172482,2.063406188172482,0.9977235558262929,0.9977235558262944,0,0,2.8964784145355225,2.532440185546875,4,4
2023,8,1.8319846134580333,1.8353572436998518,1.0003941625045183,1.0005697612153264,1,1,3.157970666885376,2.532440185546875,7,7
2023,16,1.4955530888138933,1.689982467074926,1.0004225176221948,1.0006834978240995,7,7,3.486886739730835,2.532440185546875,9,9
2023,32,0.9307099363966367,1.4933227176548676,0.999767044355413,1.0006215218554941,15,24,3.8848652839660645,2.532440185546875,17,8
2023,64,0.3540313868418044,1.4423741091317297,0.9990221568636084,1.001735494896033,30,56,4.245391368865967,2.532440185546875,34,8
2023,128,0.0571182698895373,1.428726931858526,0.9988598710787466,1.00181570758666,67,116,4.735631942749023,2.532440185546875,61,12
2024,1,8.780895200129311,8.780895200129313,0.9518095621322019,0.9518095621322057,0,0,8.89857292175293,8.89857292175293,1,1
2024,2,7.039660669566872,7.039660669566872,0.9874028917362847,0.987402891736286,0,0,9.35845947265625,8.89857292175293,2,2
2024,3,6.839979556435722,6.839979556435724,0.9906102215554348,0.9906102215554359,0,0,9.502493858337402,8.89857292175293,3,3
2024,4,6.262804375432034,6.262804375432033,1.0009429734016402,1.0009429734016413,0,0,9.575823783874512,8.89857292175293,4,4
2024,8,5.655350224931698,5.7201879337862485,1.0154557201025993,1.0132926564420393,2,2,10.094451904296875,8.89857292175293,6,6
2024,16,4.976042128295648,5.634918349035963,1.0208262387416913,1.0169243898642395,5,5,10.358145713806152,8.89857292175293,11,11
2024,32,4.211747665828626,5.387816962646804,1.0218005702939204,1.0231374987423105,14,19,11.0543851852417,8.89857292175293,18,13
2024,64,3.3275613497001584,5.378247319738993,1.0139553024675907,1.024629340206531,24,48,11.761273384094238,8.89857292175293,40,16
2024,128,1.956068706063274,5.266996340161423,1.0041783811594747,1.0310816097384483,60,111,12.509102821350098,8.89857292175293,68,17
2025,1,8.811435947904439,8.81143594790444,0.9459374159282896,0.9459374159282916,0,0,8.955120086669922,8.955120086669922,1,1
2025,2,6.909456897933961,6.909456897933961,0.9803874968553008,0.9803874968553012,0,0,9.076505661010742,8.955120086669922,2,2
2025,3,6.4660141506129944,6.466014150612995,0.9877710607473411,0.9877710607473417,0,0,9.901290893554688,8.955120086669922,3,3
2025,4,6.4377296405683495,6.4377296405683495,0.98883707000272,0.9888370700027205,0,0,9.939099311828613,8.955120086669922,4,4
2025,8,6.0509631975361176,6.063804617282806,1.0015304844519752,1.0013503086623294,1,1,10.406793594360352,8.955120086669922,7,7
2025,16,5.484523214709804,5.61979189667674,1.0134995771803421,1.012374432653926,5,4,10.856879234313965,8.955120086669922,11,12
2025,32,4.738414324883573,5.455312851647034,1.0136381071218772,1.0168828595262758,10,18,11.297749519348145,8.955120086669922,22,14
2025,64,3.7810937008331877,5.198786242667892,1.0114215822618537,1.0220314738947982,27,48,11.748353004455566,8.955120086669922,37,16
2025,128,2.1735712391724635,5.091563829483287,0.9993216140809036,1.0263856664544104,62,109,12.274482727050781,8.955120086669922,66,19
2026,1,9.866567912387255,9.866567912387255,0.9421790322010825,0.9421790322010835,0,0,10.012527465820312,10.012527465820312,1,1
2026,2,7.975030996135448,7.975030996135448,0.9861514801833219,0.9861514801833233,0,0,10.113332748413086,10.012527465820312,2,2
2026,3,7.751171545086878,7.751171545086878,0.9933219729565432,0.9933219729565441,0,0,11.316605567932129,10.012527465820312,3,3
2026,4,7.420714860179621,7.420714860179621,0.9995447271139021,0.9995447271139033,0,0,11.750621795654297,10.012527465820312,4,4
2026,8,7.1019947209537735,7.120784689439117,1.0006047852922995,1.0032589768185534,3,3,12.322495460510254,10.012527465820312,5,5
2026,16,6.176673329966071,6.868357668807459,1.010125095873798,1.0113274322247576,6,9,12.944477081298828,10.012527465820312,10,7
2026,32,5.441852077268125,6.7723347856874705,1.0082624240183158,1.021350750695035,14,20,14.052339553833008,10.012527465820312,18,12
2026,64,3.587934907490117,6.614735994463488,1.004618080715759,1.0309908954276403,32,53,15.263184547424316,10.012527465820312,32,11
2026,128,2.2470242562262657,6.440343310187164,1.0010783365179816,1.0388974958771984,62,115,16.28666114807129,10.012527465820312,66,13
2027,1,10.208213239661491,10.208213239661491,0.9399315661194243,0.939931566119425,0,0,10.368870735168457,10.368870735168457,1,1
2027,2,7.519634751509349,7.519634751509349,0.9946058248915534,0.9946058248915546,0,0,10.700088500976562,10.368870735168457,2,2
2027,3,7.079775150141195,7.079775150141196,1.004483539378883,1.0044835393788833,0,0,10.8855619430542,10.368870735168457,3,3
2027,4,6.985001668986534,6.985001668986534,1.0070541433506521,1.0070541433506528,0,0,11.239810943603516,10.368870735168457,4,4
2027,8,6.329419220125099,6.343489803956314,1.022016263566056,1.0216649062437693,1,1,11.781463623046875,10.368870735168457,7,7
2027,16,5.734112840998439,5.985505935406088,1.0289481909519105,1.0316973962258624,5,7,12.30507755279541,10.368870735168457,11,9
2027,32,5.242608147899788,5.89410988084552,1.0320121122859447,1.0352058577632368,14,20,12.857989311218262,10.368870735168457,18,12
2027,64,3.999767431074613,5.758954425005389,1.0170641177446427,1.0428971827443014,32,47,13.379295349121094,10.368870735168457,32,17
2027,128,2.744400174110682,5.754665990166135,1.003931069502229,1.0439595174579526,68,109,13.86058235168457,10.368870735168457,60,19
2028,1,7.207677888579356,7.207677888579347,0.980764256129117,0.9807642561291178,0,0,7.231122970581055,7.231122970581055,1,1
2028,2,5.820810021874356,5.820810021874356,1.0008951570780042,1.0008951570780056,0,0,8.05178451538086,7.231122970581055,2,2
2028,3,5.211596837174448,5.211596837174447,1.0094345381644172,1.0094345381644176,0,0,8.321081161499023,7.231122970581055,3,3
2028,4,5.202639666417502,5.202639666417503,1.0103509901390202,1.0103509901390206,0,0,9.162879943847656,7.231122970581055,4,4
2028,8,5.03104693267605,5.037732933081478,1.0134763278420014,1.013892569911375,3,3,9.723554611206055,7.231122970581055,5,5
2028,16,4.40814421295925,4.621667227527124,1.022951867153517,1.0242396424670333,5,8,10.065923690795898,7.231122970581055,11,8
2028,32,3.850748646823279,4.490166893702566,1.0191719671191544,1.027008686058205,12,20,10.445871353149414,7.231122970581055,20,12
2028,64,2.8973738621821794,4.4405935876123985,1.008435061545504,1.0296807438557978,27,51,11.066424369812012,7.231122970581055,37,13
2028,128,1.3858741632122986,4.338605243418965,1.0012291250939804,1.0333909773474035,60,111,11.698500633239746,7.231122970581055,68,17
2029,1,7.604972793128523,7.604972793128526,0.9709066774250362,0.9709066774250376,0,0,7.654457092285156,7.654457092285156,1,1
2029,2,6.413219161627622,6.413219161627622,0.9954418695975424,0.9954418695975437,0,0,8.863790512084961,7.654457092285156,2,2
2029,3,6.325780535156606,6.325780535156607,0.9985790269671927,0.9985790269671934,0,0,10.327322006225586,7.654457092285156,3,3
2029,4,6.038445650085206,6.038445650085206,1.0042928951099954,1.004292895109996,0,0,10.412050247192383,7.654457092285156,4,4
2029,8,5.80650347273206,5.808022342024429,1.0134701675517694,1.0137944184541792,1,1,11.397621154785156,7.654457092285156,7,7
2029,16,5.200399167137385,5.483766778534595,1.025216817596289,1.02393034982802,5,10,11.738075256347656,7.654457092285156,11,6
2029,32,4.547430480947041,5.428533351740969,1.0252683751471676,1.028120354899748,13,22,12.303730964660645,7.654457092285156,19,10
2029,64,3.7463281960615653,5.363369893783406,1.0156920638763927,1.0303010183230952,28,52,12.74788761138916,7.654457092285156,36,12
2029,128,2.470976281754377,5.321325477731748,1.0073178810859784,1.0312622996312024,60,119,13.257421493530273,7.654457092285156,68,9
2030,1,3.752207385826021,3.7522073858260208,0.9939489903296209,0.9939489903296223,0,0,3.756793260574341,3.756793260574341,1,1
2030,2,3.0739347184022665,3.0739347184022665,0.9986539544141511,0.9986539544141522,0,0,3.836029052734375,3.756793260574341,2,2
2030,3,2.848727175272328,2.8487271752723284,0.9990846689076684,0.9990846689076684,0,0,3.9861574172973633,3.756793260574341,3,3
2030,4,2.530687105534902,2.530687105534902,0.9999751412282666,0.9999751412282679,0,0,4.026508331298828,3.756793260574341,4,4
2030,8,2.3447212826981976,2.401024454076549,1.0018651867932253,1.0013372654222452,2,3,4.341142654418945,3.756793260574341,6,5
2030,16,2.057474777936709,2.3184250394571086,1.0036002210252155,1.0017755965462969,6,10,4.665590286254883,3.756793260574341,10,6
2030,32,1.7138691628793716,2.250834348047522,1.0043196260688227,1.0031065223282674,15,23,5.01942777633667,3.756793260574341,17,9
2030,64,0.9910858036690173,2.209011741759506,1.0004419506996935,1.0043233952940689,29,52,5.479562282562256,3.756793260574341,35,12
2030,128,0.2076680188322228,2.1360958341230334,0.9996351776906278,1.005873518714317,63,119,5.990137100219727,3.756793260574341,65,9
2031,1,5.422486445172793,5.422486445172794,0.9781080074833995,0.9781080074834013,0,0,5.462551593780518,5.462551593780518,1,1
2031,2,4.939056656466901,4.939056656466902,0.9862523944307358,0.9862523944307369,0,0,6.434341907501221,5.462551593780518,2,2
2031,3,4.599157677541931,4.599157677541931,0.9914226173498027,0.9914226173498035,0,0,6.590481758117676,5.462551593780518,3,3
2031,4,4.349821321427299,4.349821321427299,0.9956186265359324,0.9956186265359332,0,0,6.678948402404785,5.462551593780518,4,4
2031,8,3.7398553131902603,3.743522098337329,1.0081640023959593,1.0081837664839046,1,1,7.241123199462891,5.462551593780518,7,7
2031,16,3.2743530651835764,3.442470804025057,1.0115253240335598,1.0130847528747453,5,4,7.514312267303467,5.462551593780518,11,12
2031,32,2.9353933625608115,3.3641651556521963,1.012107324555416,1.0139148572380576,13,19,8.013940811157227,5.462551593780518,19,13
2031,64,2.2426593741710654,3.349151408526017,1.0048129926344422,1.0147263752906968,30,50,8.555010795593262,5.462551593780518,34,14
2031,128,1.0236392563531633,3.3118975382678486,0.9994077925424951,1.0163486147140484,62,110,9.128809928894043,5.462551593780518,66,18
2032,1,8.871359697893478,8.871359697893478,0.9376053194998236,0.9376053194998254,0,0,9.069866180419922,9.069866180419922,1,1
2032,2,7.6290188786711495,7.6290188786711495,0.9683509234210806,0.9683509234210814,0,0,9.7671480178833,9.069866180419922,2,2
2032,3,7.273069176854496,7.273069176854496,0.9763487880144877,0.9763487880144884,0,0,9.947822570800781,9.069866180419922,3,3
2032,4,6.996531807808155,6.9965318078081555,0.9836701610271031,0.9836701610271037,0,0,10.411237716674805,9.069866180419922,4,4
2032,8,6.45646169240353,6.45646169240353,0.9991466056072216,0.999146605607222,0,0,10.757575988769531,9.069866180419922,8,8
2032,16,5.710370153260092,5.869629720713777,1.0165417823503646,1.018230755533183,5,5,11.305529594421387,9.069866180419922,11,11
2032,32,5.255078188378674,5.727144300647112,1.0193579834908606,1.0240985320376046,10,17,12.1551513671875,9.069866180419922,22,15
2032,64,3.7502375921498707,5.3893303801749575,1.0142360118982585,1.0373137376826038,29,45,12.715222358703613,9.069866180419922,35,19
2032,128,2.4975096537479065,5.3062697265742615,1.0080972219405813,1.0435584554216213,59,110,13.512595176696777,9.069866180419922,69,18
2033,1,5.8850631213571125,5.8850631213571125,0.9845283364092567,0.9845283364092575,0,0,5.9036712646484375,5.9036712646484375,1,1
2033,2,5.50231686710464,5.50231686710464,0.9914420566742015,0.9914420566742013,0,0,6.553443908691406,5.9036712646484375,2,2
2033,3,4.419446856629675,4.419446856629675,1.0031285673466053,1.0031285673466055,0,0,6.840825080871582,5.9036712646484375,3,3
2033,4,4.382063588671811,4.382063588671811,1.0038705743311571,1.003870574331157,0,0,6.990551471710205,5.9036712646484375,4,4
2033,8,4.088599589101089,4.158289083697122,1.0067330182554972,1.0073067513056229,1,1,7.344809532165527,5.9036712646484375,7,7
2033,16,3.587427974499936,3.7048069747682693,1.014737100826347,1.015136042910092,4,6,7.859478950500488,5.9036712646484375,12,10
2033,32,2.9867560474724204,3.5485172350954977,1.011282171293513,1.0182308160628835,13,20,8.357800483703613,5.9036712646484375,19,12
2033,64,2.211065840583086,3.4980754742131364,1.0068442059283633,1.0188609687126504,32,50,8.958983421325684,5.9036712646484375,32,14
2033,128,1.06200646782508,3.496796974367642,0.9999733150103343,1.0191629794080304,65,113,9.73243236541748,5.9036712646484375,63,15
2034,1,9.832423426031816,9.832423426031818,0.9297914182130804,0.9297914182130816,0,0,10.050795555114746,10.050795555114746,1,1
2034,2,8.996133014585359,8.99613301458536,0.9563637009395074,0.9563637009395073,0,0,11.407776832580566,10.050795555114746,2,2
2034,3,8.563853217009095,8.563853217009095,0.971971320243279,0.971971320243279,0,0,12.431578636169434,10.050795555114746,3,3
2034,4,8.431389643748206,8.431389643748206,0.9773879342712226,0.9773879342712224,0,0,12.460282325744629,10.050795555114746,4,4
2034,8,7.861731673013367,7.867012360323098,0.9963794839504858,0.9970643926124825,2,2,12.709845542907715,10.050795555114746,6,6
2034,16,7.65535681659724,7.845391188045271,1.0019148927965684,1.0001318659723848,5,6,13.05684757232666,10.050795555114746,11,10
2034,32,6.552681216063276,7.647840339559579,1.00853296648756,1.0113456029437329,14,18,13.445332527160645,10.050795555114746,18,14
2034,64,5.167390954757294,7.556578460670196,1.011939244933922,1.0149143503984384,28,49,14.2833833694458,10.050795555114746,36,15
2034,128,3.432133336242982,7.541528583237388,1.008265310653776,1.0167950566129558,58,114,14.947425842285156,10.050795555114746,70,14
2035,1,10.060522303135084,10.060522303135082,0.9357842842255587,0.935784284225559,0,0,10.246479034423828,10.246479034423828,1,1
2035,2,8.946950417894056,8.946950417894056,0.9634378263038478,0.9634378263038478,0,0,11.126763343811035,10.246479034423828,2,2
2035,3,7.694769139683757,7.694769139683758,0.9939005166837147,0.9939005166837143,0,0,11.85027027130127,10.246479034423828,3,3
2035,4,7.6244650636494615,7.6244650636494615,0.9971613778522228,0.9971613778522227,0,0,11.852777481079102,10.246479034423828,4,4
2035,8,6.990843362619242,7.156475509029236,1.0146698363563658,1.011997128976751,1,1,12.132794380187988,10.246479034423828,7,7
2035,16,6.794029367825884,7.029795171110547,1.0220746324641756,1.0206463182677457,5,6,12.522205352783203,10.246479034423828,11,10
2035,32,5.889489491062494,6.519295748201199,1.0338357867630739,1.0335298539493039,14,19,12.93742847442627,10.246479034423828,18,13
2035,64,4.2646308617989375,6.46144993761294,1.0213571443685696,1.0366226622744052,29,51,13.615901947021484,10.246479034423828,35,13
2035,128,2.9201270301936857,6.423780992458363,1.008046263306839,1.0401050806259802,63,113,14.038390159606934,10.246479034423828,65,15
2036,1,10.229497207148752,10.229497207148759,0.9427927524044802,0.9427927524044832,0,0,10.372766494750977,10.372766494750977,1,1
2036,2,7.783826309328961,7.783826309328962,0.9976518824403016,0.9976518824403025,0,0,10.464300155639648,10.372766494750977,2,2
2036,3,7.388775927177663,7.388775927177664,1.003290717611576,1.0032907176115784,0,0,10.711780548095703,10.372766494750977,3,3
2036,4,7.284903100843047,7.284903100843046,1.0062305680959072,1.0062305680959087,0,0,10.987372398376465,10.372766494750977,4,4
2036,8,6.130340603783199,6.160170792494849,1.028255189453935,1.0277865527842986,1,1,11.499885559082031,10.372766494750977,7,7
2036,16,5.532716355380318,5.807849175784771,1.0368437051675192,1.0361011054232336,5,4,12.184823989868164,10.372766494750977,11,12
2036,32,5.004814820207403,5.469966011935285,1.0397416852313532,1.0436703829978922,13,14,12.84364128112793,10.372766494750977,19,18
2036,64,3.539204202064411,5.454927263646326,1.0212810339595837,1.045148895811836,26,43,13.692270278930664,10.372766494750977,38,21
2036,128,2.4197616777561497,5.398179496504594,1.0094850969167128,1.0493987947611685,59,108,14.554295539855957,10.372766494750977,69,20
2037,1,6.55555768476014,6.55555768476014,0.9758000328755523,0.9758000328755525,0,0,6.597553253173828,6.597553253173828,1,1
2037,2,5.005452017811346,5.005452017811347,0.9958174109474134,0.9958174109474125,0,0,6.606623649597168,6.597553253173828,2,2
2037,3,4.318296197163138,4.318296197163139,1.003633601463024,1.0036336014630232,0,0,6.7065534591674805,6.597553253173828,3,3
2037,4,4.022665322172697,4.0226653221726965,1.0057335601341189,1.005733560134118,0,0,6.769285678863525,6.597553253173828,4,4
2037,8,3.6127722575550436,3.6129691805230424,1.0107822180694397,1.010769926794258,1,1,7.3381667137146,6.597553253173828,7,7
2037,16,3.3295222767000845,3.603704367900178,1.0105215229989086,1.0115669839128207,6,7,7.7484307289123535,6.597553253173828,10,9
2037,32,2.8741275211152417,3.60249272464383,1.012050150530617,1.011751425829079,15,22,8.226957321166992,6.597553253173828,17,10
2037,64,2.1989509686404545,3.6024895160883053,1.0066252545176126,1.0117567533760576,29,53,8.530512809753418,6.597553253173828,35,11
2037,128,1.1823833959368046,3.5900860517415607,0.999980750063477,1.0129396689438288,60,117,8.88213062286377,6.597553253173828,68,11
2038,1,7.332424237884773,7.332424237884772,0.9702253650587512,0.9702253650587522,0,0,7.386396884918213,7.386396884918213,1,1
2038,2,6.497109333145678,6.497109333145678,0.9846764407404129,0.9846764407404136,0,0,8.866009712219238,7.386396884918213,2,2
2038,3,6.4532946534411355,6.453294653441135,0.9868900501749239,0.9868900501749238,0,0,9.124519348144531,7.386396884918213,3,3
2038,4,6.354833160739009,6.354833160739009,0.9921365644815549,0.9921365644815546,0,0,9.473875045776367,7.386396884918213,4,4
2038,8,5.705068469401116,6.072479033506261,1.001778591045297,0.999173811603352,2,1,9.755568504333496,7.386396884918213,6,7
2038,16,5.236820056683663,5.832837224511538,1.0010019975576263,1.0031666460705981,7,10,9.947311401367188,7.386396884918213,9,6
2038,32,4.2743636176688895,5.799061953225718,1.0024841313620794,1.0061666382192174,14,23,10.514442443847656,7.386396884918213,18,9
2038,64,3.447079501517892,5.559788379688791,1.0041790962176518,1.0150423020764863,32,53,11.178766250610352,7.386396884918213,32,11
2038,128,2.148262526962781,5.552656255090357,1.0024831046750846,1.0163503817482797,61,114,11.816357612609863,7.386396884918213,67,14
2039,1,8.851131375570372,8.85113137557037,0.9649261013687467,0.9649261013687498,0,0,8.911730766296387,8.911730766296387,1,1
2039,2,7.61073074599778,7.610730745997778,0.9855944061533918,0.985594406153393,0,0,9.616090774536133,8.911730766296387,2,2
2039,3,6.568947652506969,6.568947652506969,1.0091257842162864,1.0091257842162857,0,0,10.371885299682617,8.911730766296387,3,3
2039,4,5.954908413807715,5.954908413807716,1.0186531280714703,1.018653128071469,0,0,10.494295120239258,8.911730766296387,4,4
2039,8,5.587573005390802,5.587714276866411,1.0259432676088382,1.0259835740294654,1,1,11.12687873840332,8.911730766296387,7,7
2039,16,5.290172867027526,5.36977146938836,1.0320074990166097,1.031881421354755,4,5,11.608654022216797,8.911730766296387,12,11
2039,32,4.650588280392107,5.343726318886514,1.0247248506299027,1.032873449109958,14,19,11.974687576293945,8.911730766296387,18,13
2039,64,3.6913561536568076,5.27580222141076,1.0126359019612732,1.0366778263948564,28,48,12.654415130615234,8.911730766296387,36,16
2039,128,2.44869163695054,5.23794059051644,1.0049991273604375,1.04047675596338,64,113,13.541094779968262,8.911730766296387,64,15
2040,1,10.330725304300742,10.330725304300746,0.9371318727336597,0.9371318727336612,0,0,10.499619483947754,10.499619483947754,1,1
2040,2,8.73714016877794,8.73714016877794,0.9786417362240284,0.97864173622403,0,0,11.1903715133667,10.499619483947754,2,2
2040,3,8.552002439619905,8.552002439619905,0.9852515130778056,0.9852515130778062,0,0,11.628802299499512,10.499619483947754,3,3
2040,4,7.837730667334359,7.83773066733436,1.004441045843181,1.0044410458431812,0,0,12.01340103149414,10.499619483947754,4,4
2040,8,7.703630405652813,7.728996107007321,1.0098762480005647,1.0102588128122427,1,2,12.601354598999023,10.499619483947754,7,6
2040,16,6.514872949037747,7.413456269720116,1.0248511654213677,1.0226211239699152,7,7,13.016134262084961,10.499619483947754,9,9
2040,32,5.797281901718668,7.261520888031131,1.0222864293435219,1.0278205261590136,17,22,14.178823471069336,10.499619483947754,15,10
2040,64,4.138255045846274,7.069478353179354,1.0115908962157318,1.0376962193479335,28,50,14.795783042907715,10.499619483947754,36,14
2040,128,2.549796928200964,6.975631250417507,1.0036753149014006,1.040217437719346,62,115,15.580509185791016,10.499619483947754,66,13
2041,1,11.19685040713049,11.196850407130489,0.9233653738296742,0.9233653738296775,0,0,11.424448013305664,11.424448013305664,1,1
2041,2,9.866813837581818,9.86681383758182,0.9618895090861138,0.9618895090861161,0,0,12.930173873901367,11.424448013305664,2,2
2041,3,9.016136149486469,9.01613614948647,0.9831189503934009,0.9831189503934035,0,0,12.974321365356445,11.424448013305664,3,3
2041,4,8.84203545992045,8.842035459920451,0.9872472060380347,0.9872472060380371,0,0,12.981710433959961,11.424448013305664,4,4
2041,8,7.4903808180079965,7.508348471771001,1.026155200156697,1.025857287892816,1,1,13.287389755249023,11.424448013305664,7,7
2041,16,7.013387949082588,7.087923681764064,1.0367179035940415,1.038189014458999,5,7,13.984353065490723,11.424448013305664,11,9
2041,32,6.257236528466239,6.951637838842782,1.0414804003401603,1.0469079840185218,15,19,14.573835372924805,11.424448013305664,17,13
2041,64,4.605090543030532,6.938025328741945,1.0085767575912126,1.0478963427637986,33,50,15.401924133300781,11.424448013305664,31,14
2041,128,3.29904996660147,6.936281750124381,1.0030418143092783,1.0483614239025958,66,113,16.050086975097656,11.424448013305664,62,15
2042,1,9.89310384849289,9.89310384849289,0.9406439528272343,0.9406439528272361,0,0,10.048583030700684,10.048583030700684,1,1
2042,2,8.644434483131754,8.644434483131752,0.9697749157563719,0.9697749157563726,0,0,10.403035163879395,10.048583030700684,2,2
2042,3,8.393039412253586,8.393039412253586,0.9754432976385229,0.9754432976385226,0,0,10.622673988342285,10.048583030700684,3,3
2042,4,8.38475941524513,8.393039412253586,0.9754441592908836,0.9754432976385226,1,1,10.671814918518066,10.048583030700684,3,3
2042,8,7.569246955738603,7.717228532127669,0.9970087745418932,0.9939914083367702,1,1,11.226597785949707,10.048583030700684,7,7
2042,16,5.959493642625066,6.130490105574572,1.0295034959044738,1.0279279365039313,5,8,11.545648574829102,10.048583030700684,11,8
2042,32,5.271538247581225,6.060425708874294,1.034870353313298,1.030750012855557,13,22,12.059656143188477,10.048583030700684,19,10
2042,64,4.275424005119664,5.987371082565608,1.0298254046651982,1.0345962238958564,28,50,12.544114112854004,10.048583030700684,36,14
2042,128,2.5011118949942426,5.884909561301517,1.0096799632718414,1.0392511459632723,64,116,13.189127922058105,10.048583030700684,64,12
2043,1,7.395891437410301,7.3958914374103015,0.9643744355656794,0.9643744355656823,0,0,7.47044563293457,7.47044563293457,1,1
2043,2,7.251997913172128,7.2519979131721275,0.9696812984892784,0.9696812984892804,0,0,8.92041015625,7.47044563293457,2,2
2043,3,7.247553016008696,7.247553016008695,0.9702715691625602,0.9702715691625627,0,0,9.384960174560547,7.47044563293457,3,3
2043,4,6.579817803821249,6.597606992414756,0.9834005001348273,0.9841501329475768,2,2,9.5850248336792,7.47044563293457,2,2
2043,8,5.751655708625682,5.982489354467249,0.9997134766614635,0.9988610668285636,2,3,10.069866180419922,7.47044563293457,6,5
2043,16,4.829024750948436,5.407965619068306,1.0142076623983385,1.0130542009020493,7,8,10.832764625549316,7.47044563293457,9,8
2043,32,4.186446211491146,5.356144395121726,1.0130735570677012,1.015871544788899,14,22,11.771491050720215,7.47044563293457,18,10
2043,64,3.37763839714993,5.065624332702459,1.0123017461739099,1.0285111342148134,29,52,12.692484855651855,7.47044563293457,35,12
2043,128,2.146423703464246,5.048456279313644,1.0038902143656936,1.0314325044006147,58,111,13.438375473022461,7.47044563293457,70,17
2044,1,9.197361998363178,9.197361998363181,0.943239299964866,0.9432392999648685,0,0,9.351308822631836,9.351308822631836,1,1
2044,2,8.258103006606575,8.258103006606577,0.9657331065680532,0.9657331065680546,0,0,9.685117721557617,9.351308822631836,2,2
2044,3,8.122961906111827,8.12296190611183,0.9683016195147836,0.9683016195147853,0,0,9.812501907348633,9.351308822631836,3,3
2044,4,8.115376196131061,8.12296190611183,0.967563168309839,0.9683016195147853,1,1,10.169652938842773,9.351308822631836,3,3
2044,8,7.571703234784019,7.673189151228844,0.9835038329204757,0.9849454225906702,2,2,10.991569519042969,9.351308822631836,6,6
2044,16,6.974264724105304,7.4473698521081495,0.9914024726711502,0.9964515018336868,6,7,11.625313758850098,9.351308822631836,10,9
2044,32,6.157285334207471,6.944758293799474,1.0024798973164666,1.012017204456662,13,20,12.118874549865723,9.351308822631836,19,12
2044,64,5.010900569395178,6.736425757049387,0.9934639345260066,1.019949736637606,31,48,12.76301097869873,9.351308822631836,33,16
2044,128,3.9495494168864207,6.566725336171959,0.9911318477643525,1.0291307621289842,62,108,13.528594970703125,9.351308822631836,66,20
2045,1,10.399640552541857,10.399640552541857,0.9373051250051853,0.9373051250051871,0,0,10.569543838500977,10.569543838500977,1,1
2045,2,9.452180033012628,9.452180033012628,0.964164022443381,0.964164022443383,0,0,10.896965026855469,10.569543838500977,2,2
2045,3,9.09336686256191,9.09336686256191,0.9720104379249415,0.972010437924943,0,0,11.063560485839844,10.569543838500977,3,3
2045,4,8.196314086137363,8.204575563250023,0.992907086258835,0.992598163473407,1,1,11.109552383422852,10.569543838500977,3,3
2045,8,7.850718800704767,7.8751019092722325,1.0034424672707385,1.0031011127917693,1,1,11.613133430480957,10.569543838500977,7,7
2045,16,6.990763641903017,7.3573425394325325,1.0158671594394548,1.0139029317344481,5,7,12.061307907104492,10.569543838500977,11,9
2045,32,6.231696295173424,6.992488411149743,1.0344733920066052,1.02904476971558,17,22,12.649046897888184,10.569543838500977,15,10
2045,64,4.90541890219825,6.803958335883406,1.0173815666015644,1.0361677532953055,31,51,13.254500389099121,10.569543838500977,33,13
2045,128,3.082933048003812,6.593698154385857,1.0015496325074966,1.0430145645309787,67,114,13.928267478942871,10.569543838500977,61,14
2046,1,9.144475485937066,9.144475485937066,0.9469185203719876,0.9469185203719916,0,0,9.28123950958252,9.28123950958252,1,1
2046,2,7.548893204227533,7.548893204227533,0.9785069300715827,0.9785069300715852,0,0,9.580182075500488,9.28123950958252,2,2
2046,3,6.766938309684598,6.766938309684598,0.9984511690506419,0.9984511690506446,0,0,9.817283630371094,9.28123950958252,3,3
2046,4,6.699204819939288,6.699204819939288,1.0008355881516884,1.0008355881516906,0,0,9.964399337768555,9.28123950958252,4,4
2046,8,6.171134683929065,6.18354640091791,1.013013014003667,1.012299182478247,2,2,11.079429626464844,9.28123950958252,6,6
2046,16,5.469944076355852,5.5580253226512655,1.0313927089447437,1.0292692833759742,4,5,11.544692039489746,9.28123950958252,12,11
2046,32,4.70376853029191,5.35533925950823,1.0263276549344735,1.033275556565847,13,18,12.126554489135742,9.28123950958252,19,14
2046,64,3.626214001632012,5.268093261266218,1.0161279946793802,1.0370871218101265,28,48,13.158466339111328,9.28123950958252,36,16
2046,128,2.5747354823669726,5.099186824906789,1.0068203925900723,1.0438124643745443,60,107,14.018351554870605,9.28123950958252,68,21
2047,1,11.466515537902067,11.466515537902069,0.9019492125149685,0.9019492125149713,0,0,11.825270652770996,11.825270652770996,1,1
2047,2,11.046911130090944,11.046911130090944,0.917498310214525,0.9174983102145267,0,0,12.120829582214355,11.825270652770996,2,2
2047,3,8.72463361883564,8.72463361883564,0.9832842903418559,0.9832842903418559,0,0,12.445271492004395,11.825270652770996,3,3
2047,4,8.245985388851004,8.245985388851006,0.9954772332619338,0.9954772332619344,0,0,12.455101013183594,11.825270652770996,4,4
2047,8,8.062279272147022,8.091201122373691,0.9999837377735321,1.0006315330455011,2,2,12.806888580322266,11.825270652770996,6,6
2047,16,6.97013058772906,7.34744571780137,1.0262442773083862,1.0231162886573877,3,8,13.321784019470215,11.825270652770996,13,8
2047,32,6.22206896089769,7.117110630738142,1.0322493097731624,1.0313728735385466,12,22,13.804710388183594,11.825270652770996,20,10
2047,64,5.1053617701400835,7.104117989411537,1.0221745571398044,1.0325790938464166,31,52,14.407434463500977,11.825270652770996,33,12
2047,128,3.2344618550146227,6.86479998017904,1.0071107975843945,1.0454511958928694,65,115,15.341693878173828,11.825270652770996,63,13
